,Account Number,Transaction Date,Value,Current Balance
0,10005367,2023-01-31,0.0,728.25
2482,10005367,2023-02-02,-1097.6,-369.3499999999999
2483,10005367,2023-02-04,-67.01,-436.3599999999999
5088,10005367,2023-02-04,144.75,-291.6099999999999
2484,10005367,2023-02-05,-108.26,-399.8699999999999
2485,10005367,2023-02-08,-65.49,-465.3599999999999
5089,10005367,2023-02-08,941.0,475.6400000000001
2486,10005367,2023-02-10,-27.61,448.0300000000001
5090,10005367,2023-02-11,137.25,585.2800000000001
1,10011977,2023-01-31,0.0,676.54
2459,10011977,2023-02-02,-51.0,625.54
3774,10011977,2023-02-03,120.88,746.42
2461,10011977,2023-02-04,-189.38,557.04
2460,10011977,2023-02-04,-170.56,386.47999999999996
3775,10011977,2023-02-04,58.05,444.53
2462,10011977,2023-02-05,-124.61,319.91999999999996
3776,10011977,2023-02-08,133.74,453.65999999999997
2463,10011977,2023-02-10,-103.55,350.10999999999996
2464,10011977,2023-02-11,-43.89,306.21999999999997
3777,10011977,2023-02-14,1100.7,1406.92
2,10024680,2023-01-31,0.0,567.46
772,10024680,2023-02-01,-153.43,414.03000000000003
4707,10024680,2023-02-03,676.5,1090.53
773,10024680,2023-02-07,-127.45,963.0799999999999
774,10024680,2023-02-07,-91.92,871.16
775,10024680,2023-02-08,-138.18,732.98
3,10031238,2023-01-31,0.0,576.52
6485,10031238,2023-02-05,-110.07,466.45
6046,10031238,2023-02-05,121.7,588.15
6486,10031238,2023-02-09,-35.39,552.76
6487,10031238,2023-02-10,-160.6,392.15999999999997
6047,10031238,2023-02-10,65.02,457.18
6488,10031238,2023-02-11,-157.96,299.21999999999997
4,10034341,2023-01-31,0.0,390.39
5037,10034341,2023-02-03,1566.6,1956.9899999999998
6297,10034341,2023-02-05,-217.15,1739.8399999999997
6298,10034341,2023-02-08,-110.25,1629.5899999999997
5038,10034341,2023-02-12,123.13,1752.7199999999998
6299,10034341,2023-02-14,-74.72,1678.0
5,10079965,2023-01-31,0.0,799.27
4095,10079965,2023-02-03,156.35,955.62
7719,10079965,2023-02-08,-442.3,513.3199999999999
7720,10079965,2023-02-08,-132.2,381.12
7718,10079965,2023-02-08,-63.9,317.22
6,10091076,2023-01-31,0.0,831.83
328,10091076,2023-02-01,-83.96,747.87
329,10091076,2023-02-01,-18.77,729.1
1520,10091076,2023-02-01,75.45,804.5500000000001
1521,10091076,2023-02-05,53.92,858.47
330,10091076,2023-02-14,-10.22,848.25
1522,10091076,2023-02-14,53.72,901.97
7,10231977,2023-01-31,0.0,61.63
489,10231977,2023-02-01,116.0,177.63
7739,10231977,2023-02-08,-68.31,109.32
7740,10231977,2023-02-09,-1410.1,-1300.7799999999997
7741,10231977,2023-02-14,-723.4,-2024.1799999999998
490,10231977,2023-02-14,78.92,-1945.2599999999998
8,10232603,2023-01-31,0.0,732.55
756,10232603,2023-02-01,125.68,858.23
3325,10232603,2023-02-02,-1190.9,-332.6700000000001
3326,10232603,2023-02-04,-888.9,-1221.57
757,10232603,2023-02-06,88.22,-1133.3500000000001
3327,10232603,2023-02-07,-185.47,-1318.82
3328,10232603,2023-02-10,-1128.4,-2447.2200000000003
758,10232603,2023-02-10,85.03,-2362.1899999999996
9,10243581,2023-01-31,0.0,104.27
5193,10243581,2023-02-04,-109.65,-5.38000000000001
5194,10243581,2023-02-06,-78.93,-84.31000000000002
8316,10243581,2023-02-10,83.3,-1.0100000000000193
5195,10243581,2023-02-12,-1482.9,-1483.91
5196,10243581,2023-02-13,-20.17,-1504.0800000000002
5197,10243581,2023-02-14,-134.51,-1638.5900000000001
10,10271519,2023-01-31,0.0,50.02
3765,10271519,2023-02-03,-100.99,-50.96999999999999
4346,10271519,2023-02-03,17.57,-33.399999999999984
4344,10271519,2023-02-03,95.05,61.65
4345,10271519,2023-02-03,2285.6,2347.25
3766,10271519,2023-02-11,-89.55,2257.7
4348,10271519,2023-02-12,76.71,2334.41
4347,10271519,2023-02-12,98.81,2433.22
11,10273387,2023-01-31,0.0,581.83
4949,10273387,2023-02-03,-556.5,25.33000000000004
4657,10273387,2023-02-03,113.03,138.36
4658,10273387,2023-02-06,181.24,319.6
4950,10273387,2023-02-07,-38.41,281.19000000000005
4951,10273387,2023-02-08,-140.45,140.74000000000007
4952,10273387,2023-02-10,-71.11,69.63000000000011
4659,10273387,2023-02-10,138.8,208.43000000000006
4660,10273387,2023-02-12,130.68,339.11000000000007
4661,10273387,2023-02-14,278.4,617.51
12,10288821,2023-01-31,0.0,642.41
7520,10288821,2023-02-07,-151.7,490.71
8414,10288821,2023-02-11,85.41,576.12
8415,10288821,2023-02-12,228.52,804.64
8416,10288821,2023-02-14,94.21,898.8499999999999
13,10295384,2023-01-31,0.0,153.85
4168,10295384,2023-02-03,10.64,164.49
5202,10295384,2023-02-04,-96.09,68.39999999999999
4169,10295384,2023-02-04,55.98,124.38
4170,10295384,2023-02-06,87.57,211.95
4171,10295384,2023-02-06,100.34,312.28999999999996
4172,10295384,2023-02-07,133.09,445.38
4173,10295384,2023-02-07,186.15,631.53
5203,10295384,2023-02-09,-110.01,521.52
5204,10295384,2023-02-11,-62.52,459.0
4174,10295384,2023-02-13,128.0,587.0
14,10350324,2023-01-31,0.0,861.81
4021,10350324,2023-02-03,247.64,1109.4499999999998
4022,10350324,2023-02-04,47.39,1156.84
4023,10350324,2023-02-04,81.35,1238.19
7244,10350324,2023-02-07,-42.19,1196.0
7245,10350324,2023-02-10,-91.04,1104.96
4024,10350324,2023-02-11,119.75,1224.71
4025,10350324,2023-02-11,132.19,1356.8999999999999
7246,10350324,2023-02-13,-142.63,1214.27
15,10437896,2023-01-31,0.0,661.08
5688,10437896,2023-02-04,-51.84,609.24
5725,10437896,2023-02-04,55.24,664.48
5726,10437896,2023-02-06,68.72,733.2
5727,10437896,2023-02-09,116.34,849.5400000000001
5728,10437896,2023-02-11,1107.1,1956.6399999999999
5729,10437896,2023-02-13,73.97,2030.6100000000001
16,10449180,2023-01-31,0.0,228.24
1277,10449180,2023-02-01,48.99,277.23
1278,10449180,2023-02-02,25.81,303.04
1279,10449180,2023-02-06,784.3,1087.34
1280,10449180,2023-02-11,75.88,1163.2199999999998
17,10464544,2023-01-31,0.0,755.99
483,10464544,2023-02-01,-89.56,666.4300000000001
7582,10464544,2023-02-07,135.77,802.2
7583,10464544,2023-02-08,132.1,934.3
484,10464544,2023-02-12,-463.1,471.2
485,10464544,2023-02-14,-81.26,389.94
7584,10464544,2023-02-14,987.9,1377.84
18,10473116,2023-01-31,0.0,387.7
838,10473116,2023-02-01,-94.91,292.78999999999996
4625,10473116,2023-02-03,87.46,380.25
839,10473116,2023-02-06,-1194.9,-814.6500000000001
4626,10473116,2023-02-08,103.49,-711.1600000000001
4627,10473116,2023-02-10,28.23,-682.9300000000001
840,10473116,2023-02-12,-108.51,-791.44
19,10521885,2023-01-31,0.0,54.87
1013,10521885,2023-02-01,-83.86,-28.990000000000002
286,10521885,2023-02-01,127.41,98.41999999999999
287,10521885,2023-02-03,120.33,218.75
288,10521885,2023-02-09,37.14,255.89
289,10521885,2023-02-12,70.6,326.49
291,10521885,2023-02-14,53.35,379.84
290,10521885,2023-02-14,150.19,530.03
20,10553619,2023-01-31,0.0,756.2
1457,10553619,2023-02-01,-112.77,643.4300000000001
403,10553619,2023-02-01,72.18,715.61
404,10553619,2023-02-03,133.94,849.5500000000001
1458,10553619,2023-02-04,-1263.9,-414.35000000000014
1459,10553619,2023-02-05,-89.62,-503.97
1460,10553619,2023-02-06,-1085.4,-1589.3700000000001
405,10553619,2023-02-11,873.9,-715.47
1461,10553619,2023-02-14,-43.02,-758.4900000000002
406,10553619,2023-02-14,1485.6,727.1099999999997
21,10554116,2023-01-31,0.0,243.95
1823,10554116,2023-02-01,-121.83,122.11999999999999
22,10586481,2023-01-31,0.0,73.83
4829,10586481,2023-02-03,100.42,174.25
4830,10586481,2023-02-11,142.56,316.81
8560,10586481,2023-02-12,-49.53,267.28000000000003
4831,10586481,2023-02-12,128.32,395.59999999999997
8561,10586481,2023-02-14,-24.89,370.71
23,10608220,2023-01-31,0.0,632.92
1731,10608220,2023-02-01,-89.41,543.51
2072,10608220,2023-02-01,33.49,577.0
1732,10608220,2023-02-04,-117.26,459.73999999999995
2073,10608220,2023-02-05,78.8,538.54
1733,10608220,2023-02-10,-55.88,482.65999999999997
1734,10608220,2023-02-11,-142.56,340.09999999999997
1735,10608220,2023-02-13,-118.5,221.59999999999997
1736,10608220,2023-02-13,-98.19,123.40999999999997
2074,10608220,2023-02-13,86.79,210.2
24,10631690,2023-01-31,0.0,947.45
4303,10631690,2023-02-03,-41.04,906.4100000000001
5029,10631690,2023-02-03,165.39,1071.8
4304,10631690,2023-02-11,-151.02,920.78
25,10675607,2023-01-31,0.0,284.84
675,10675607,2023-02-01,-114.21,170.63
676,10675607,2023-02-08,-19.11,151.51999999999998
677,10675607,2023-02-14,-908.4,-756.8800000000001
26,10725127,2023-01-31,0.0,984.69
5129,10725127,2023-02-04,-1268.7,-284.01
8134,10725127,2023-02-09,148.39,-135.6199999999999
8135,10725127,2023-02-11,102.03,-33.59000000000003
5130,10725127,2023-02-12,-228.52,-262.1100000000001
5131,10725127,2023-02-13,-157.99,-420.0999999999999
27,10769769,2023-01-31,0.0,906.91
1849,10769769,2023-02-01,-93.28,813.63
1850,10769769,2023-02-02,-1502.2,-688.57
1852,10769769,2023-02-02,-96.8,-785.37
1851,10769769,2023-02-02,-20.72,-806.09
2164,10769769,2023-02-02,38.78,-767.3100000000001
1853,10769769,2023-02-03,-89.51,-856.82
1854,10769769,2023-02-05,-59.15,-915.9700000000001
2165,10769769,2023-02-05,145.08,-770.89
1855,10769769,2023-02-08,-143.57,-914.4599999999999
2166,10769769,2023-02-09,58.86,-855.6
1857,10769769,2023-02-10,-85.7,-941.3000000000001
1856,10769769,2023-02-10,-51.82,-993.12
2167,10769769,2023-02-11,172.32,-820.8000000000001
2168,10769769,2023-02-11,666.5,-154.30000000000007
28,10783139,2023-01-31,0.0,992.98
5100,10783139,2023-02-04,103.81,1096.79
6477,10783139,2023-02-05,-92.78,1004.01
6478,10783139,2023-02-08,-96.33,907.6800000000001
6479,10783139,2023-02-09,-129.76,777.9200000000001
5101,10783139,2023-02-09,9.69,787.61
5102,10783139,2023-02-10,72.06,859.6700000000001
5103,10783139,2023-02-12,109.08,968.75
29,10799356,2023-01-31,0.0,915.04
6687,10799356,2023-02-06,127.85,1042.8899999999999
6686,10799356,2023-02-06,138.24,1181.13
8397,10799356,2023-02-11,-259.39,921.74
8398,10799356,2023-02-11,-120.98,800.76
8399,10799356,2023-02-12,-94.16,706.6
8400,10799356,2023-02-14,-1314.7,-608.0999999999999
30,10819898,2023-01-31,0.0,750.25
1715,10819898,2023-02-01,103.68,853.9300000000001
1716,10819898,2023-02-02,15.52,869.45
3845,10819898,2023-02-03,-91.02,778.4300000000001
3846,10819898,2023-02-05,-36.13,742.3
1717,10819898,2023-02-08,123.29,865.59
3847,10819898,2023-02-10,-104.75,760.84
1718,10819898,2023-02-12,98.15,858.99
1719,10819898,2023-02-14,47.83,906.82
1720,10819898,2023-02-14,114.54,1021.36
31,10842511,2023-01-31,0.0,651.77
2874,10842511,2023-02-02,-155.92,495.85
8650,10842511,2023-02-13,102.44,598.29
32,10847941,2023-01-31,0.0,40.25
6691,10847941,2023-02-06,-64.29,-24.040000000000006
6692,10847941,2023-02-07,-143.62,-167.66000000000003
7880,10847941,2023-02-08,92.54,-75.12000000000002
6693,10847941,2023-02-10,-146.12,-221.24
7881,10847941,2023-02-11,1094.0,872.76
33,10864084,2023-01-31,0.0,119.98
2204,10864084,2023-02-02,-179.69,-59.709999999999994
2203,10864084,2023-02-02,-150.75,-210.45999999999998
2205,10864084,2023-02-05,-39.08,-249.53999999999996
6674,10864084,2023-02-06,72.7,-176.83999999999997
6673,10864084,2023-02-06,114.81,-62.02999999999999
6672,10864084,2023-02-06,154.92,92.89
6675,10864084,2023-02-10,98.32,191.20999999999998
6676,10864084,2023-02-11,65.15,256.36
2206,10864084,2023-02-13,-1545.5,-1289.1399999999999
34,10942334,2023-01-31,0.0,55.42
6126,10942334,2023-02-05,-92.89,-37.47
6127,10942334,2023-02-07,-33.98,-71.45
8288,10942334,2023-02-10,116.67,45.22000000000001
8289,10942334,2023-02-11,84.45,129.67000000000002
35,10949168,2023-01-31,0.0,471.8
5502,10949168,2023-02-04,-127.73,344.07
5503,10949168,2023-02-04,-105.89,238.18
7593,10949168,2023-02-07,71.99,310.17
5504,10949168,2023-02-09,-214.76,95.41000000000003
7594,10949168,2023-02-11,146.95,242.36
7595,10949168,2023-02-12,52.81,295.17
5505,10949168,2023-02-14,-13.43,281.74
36,10989769,2023-01-31,0.0,334.18
4861,10989769,2023-02-03,854.4,1188.58
8573,10989769,2023-02-12,-154.56,1034.02
8574,10989769,2023-02-13,-66.55,967.47
4862,10989769,2023-02-13,102.22,1069.69
37,11008868,2023-01-31,0.0,271.3
2887,11008868,2023-02-02,-0.91,270.39
2888,11008868,2023-02-07,-207.86,62.53
8616,11008868,2023-02-13,93.56,156.09
8617,11008868,2023-02-13,96.98,253.07
8618,11008868,2023-02-14,131.58,384.65000000000003
38,11026937,2023-01-31,0.0,303.44
2838,11026937,2023-02-02,-47.72,255.72
2864,11026937,2023-02-02,90.91,346.63
2839,11026937,2023-02-06,-85.44,261.19
2840,11026937,2023-02-07,-92.55,168.64
2841,11026937,2023-02-07,-75.08,93.56
2842,11026937,2023-02-13,-42.26,51.30000000000001
2865,11026937,2023-02-14,67.47,118.77000000000001
39,11061291,2023-01-31,0.0,72.7
150,11061291,2023-02-01,-162.41,-89.71
151,11061291,2023-02-03,-149.54,-239.25
152,11061291,2023-02-03,-53.42,-292.67
5121,11061291,2023-02-04,186.95,-105.72000000000001
5123,11061291,2023-02-08,5.73,-99.99000000000002
5122,11061291,2023-02-08,61.41,-38.58000000000001
153,11061291,2023-02-09,-119.17,-157.75
5124,11061291,2023-02-12,121.86,-35.890000000000015
154,11061291,2023-02-14,-78.98,-114.87000000000002
40,11067879,2023-01-31,0.0,481.56
1705,11067879,2023-02-01,-812.6,-331.04
573,11067879,2023-02-01,187.01,-144.03000000000003
1706,11067879,2023-02-02,-15.52,-159.55
574,11067879,2023-02-04,81.63,-77.92000000000002
575,11067879,2023-02-06,97.09,19.16999999999996
1707,11067879,2023-02-07,-123.45,-104.28000000000003
1708,11067879,2023-02-07,-96.93,-201.20999999999998
576,11067879,2023-02-07,151.33,-49.88000000000005
1709,11067879,2023-02-08,-66.39,-116.27000000000004
1710,11067879,2023-02-11,-87.16,-203.43
577,11067879,2023-02-11,172.57,-30.86000000000007
1711,11067879,2023-02-13,-78.91,-109.77000000000004
41,11110085,2023-01-31,0.0,861.29
4273,11110085,2023-02-03,107.9,969.1899999999999
4274,11110085,2023-02-05,1712.2,2681.3900000000003
4275,11110085,2023-02-06,97.33,2778.7200000000003
4276,11110085,2023-02-11,109.66,2888.38
8541,11110085,2023-02-12,-66.27,2822.11
4277,11110085,2023-02-12,122.36,2944.4700000000003
8542,11110085,2023-02-13,-147.67,2796.8
8543,11110085,2023-02-14,-152.84,2643.96
4278,11110085,2023-02-14,1397.8,4041.76
42,11150945,2023-01-31,0.0,858.83
622,11150945,2023-02-01,-345.3,513.53
1776,11150945,2023-02-01,240.2,753.73
623,11150945,2023-02-03,-189.03,564.7
1777,11150945,2023-02-03,32.07,596.77
1778,11150945,2023-02-06,43.59,640.36
1779,11150945,2023-02-09,98.03,738.39
1780,11150945,2023-02-09,133.16,871.55
624,11150945,2023-02-13,-126.72,744.83
1781,11150945,2023-02-13,763.2,1508.0300000000002
43,11228111,2023-01-31,0.0,130.36
1161,11228111,2023-02-01,-142.2,-11.839999999999975
1162,11228111,2023-02-02,-1501.3,-1513.1399999999999
8130,11228111,2023-02-09,179.65,-1333.4899999999998
8131,11228111,2023-02-10,169.47,-1164.02
8133,11228111,2023-02-11,69.11,-1094.9099999999999
8132,11228111,2023-02-11,77.54,-1017.37
44,11242986,2023-01-31,0.0,344.68
130,11242986,2023-02-01,-160.4,184.28
131,11242986,2023-02-06,-21.12,163.16
132,11242986,2023-02-08,-93.77,69.38999999999999
8006,11242986,2023-02-09,55.87,125.25999999999999
133,11242986,2023-02-11,-102.16,23.099999999999966
45,11251776,2023-01-31,0.0,504.02
4371,11251776,2023-02-03,88.94,592.96
4372,11251776,2023-02-04,84.15,677.11
4373,11251776,2023-02-09,150.22,827.3299999999999
8317,11251776,2023-02-10,-67.69,759.64
4374,11251776,2023-02-11,79.08,838.72
8318,11251776,2023-02-14,-950.7,-111.98000000000002
46,11302888,2023-01-31,0.0,458.83
5339,11302888,2023-02-04,117.6,576.43
6483,11302888,2023-02-05,-80.56,495.87
5340,11302888,2023-02-06,182.96,678.8299999999999
6484,11302888,2023-02-10,-19.72,659.11
47,11306584,2023-01-31,0.0,522.4
1729,11306584,2023-02-01,52.0,574.4
4850,11306584,2023-02-03,-432.2,142.2
1730,11306584,2023-02-07,45.38,187.57999999999998
1731,11306584,2023-02-07,1198.9,1386.48
1732,11306584,2023-02-09,151.14,1537.6200000000001
4851,11306584,2023-02-10,-30.61,1507.0100000000002
1733,11306584,2023-02-11,63.83,1570.8400000000001
4852,11306584,2023-02-12,-71.74,1499.1000000000001
1734,11306584,2023-02-12,1681.9,3181.0000000000005
4853,11306584,2023-02-14,-701.1,2479.9000000000005
48,11333185,2023-01-31,0.0,693.23
2267,11333185,2023-02-02,99.58,792.8100000000001
7092,11333185,2023-02-06,-676.7,116.11000000000001
2268,11333185,2023-02-06,113.2,229.31
7093,11333185,2023-02-07,-1440.9,-1211.5900000000001
2269,11333185,2023-02-07,186.08,-1025.5100000000002
7094,11333185,2023-02-10,-67.29,-1092.8000000000002
7095,11333185,2023-02-11,-138.48,-1231.2800000000002
2271,11333185,2023-02-11,88.41,-1142.8700000000001
2270,11333185,2023-02-11,155.81,-987.0600000000002
2272,11333185,2023-02-13,1582.4,595.3399999999999
49,11346696,2023-01-31,0.0,661.99
5015,11346696,2023-02-04,-91.69,570.3
5016,11346696,2023-02-06,-75.77,494.53000000000003
5017,11346696,2023-02-09,-113.15,381.38
5018,11346696,2023-02-10,-812.8,-431.41999999999985
5019,11346696,2023-02-13,-1487.7,-1919.1200000000001
50,11359678,2023-01-31,0.0,837.17
7365,11359678,2023-02-07,-67.04,770.13
7652,11359678,2023-02-07,65.16,835.29
7653,11359678,2023-02-11,62.24,897.53
7366,11359678,2023-02-14,-74.53,823.0
51,11360263,2023-01-31,0.0,136.79
1890,11360263,2023-02-01,100.02,236.81
1891,11360263,2023-02-03,101.8,338.61
1892,11360263,2023-02-03,130.53,469.14
1893,11360263,2023-02-06,80.15,549.29
1894,11360263,2023-02-06,173.03,722.3199999999999
8129,11360263,2023-02-09,-68.25,654.0699999999999
8130,11360263,2023-02-12,-47.25,606.8199999999999
52,11368995,2023-01-31,0.0,565.8
600,11368995,2023-02-01,-63.48,502.31999999999994
601,11368995,2023-02-02,-140.61,361.7099999999999
2119,11368995,2023-02-02,150.75,512.4599999999999
602,11368995,2023-02-04,-121.49,390.96999999999997
603,11368995,2023-02-05,-92.6,298.36999999999995
2120,11368995,2023-02-06,52.22,350.59
2121,11368995,2023-02-08,65.06,415.65
53,11437275,2023-01-31,0.0,115.34
6540,11437275,2023-02-05,98.47,213.81
7649,11437275,2023-02-07,-144.5,69.31
6541,11437275,2023-02-07,112.5,181.81
6542,11437275,2023-02-09,94.06,275.87
7650,11437275,2023-02-10,-112.61,163.26
7651,11437275,2023-02-10,-100.43,62.83
54,11438427,2023-01-31,0.0,484.08
7089,11438427,2023-02-06,123.77,607.85
7335,11438427,2023-02-07,-23.9,583.95
7336,11438427,2023-02-08,-1686.0,-1102.0500000000002
7337,11438427,2023-02-08,-190.12,-1292.17
55,11463412,2023-01-31,0.0,342.53
7426,11463412,2023-02-07,-97.82,244.70999999999998
8172,11463412,2023-02-09,1582.3,1827.01
56,11475827,2023-01-31,0.0,363.88
1206,11475827,2023-02-01,48.39,412.27
1207,11475827,2023-02-07,89.09,501.36
7872,11475827,2023-02-08,-45.54,455.82
1209,11475827,2023-02-11,86.86,542.6800000000001
1208,11475827,2023-02-11,1129.9,1672.58
1210,11475827,2023-02-12,106.02,1778.6
57,11522216,2023-01-31,0.0,590.37
3820,11522216,2023-02-03,43.61,633.98
3821,11522216,2023-02-04,199.41,833.39
3822,11522216,2023-02-10,82.97,916.36
3823,11522216,2023-02-10,106.62,1022.98
3824,11522216,2023-02-14,81.37,1104.35
58,11662506,2023-01-31,0.0,573.89
1890,11662506,2023-02-01,-167.85,406.03999999999996
6401,11662506,2023-02-05,89.72,495.76
6402,11662506,2023-02-05,102.96,598.72
1891,11662506,2023-02-09,-134.78,463.94
1892,11662506,2023-02-09,-38.09,425.84999999999997
1893,11662506,2023-02-11,-84.35,341.5
1894,11662506,2023-02-14,-1397.8,-1056.3000000000002
1895,11662506,2023-02-14,-77.33,-1133.6299999999997
59,11694020,2023-01-31,0.0,379.2
5212,11694020,2023-02-04,-189.72,189.48
7158,11694020,2023-02-06,44.43,233.91
5213,11694020,2023-02-09,-1363.6,-1129.6899999999998
7159,11694020,2023-02-12,1.29,-1128.3999999999999
7160,11694020,2023-02-14,725.0,-403.3999999999999
60,11717885,2023-01-31,0.0,6.06
6480,11717885,2023-02-05,-72.53,-66.47
6481,11717885,2023-02-13,-86.51,-152.98000000000002
61,11728970,2023-01-31,0.0,711.65
7059,11728970,2023-02-06,84.79,796.4399999999999
7060,11728970,2023-02-06,123.61,920.05
8122,11728970,2023-02-09,-135.18,784.87
7061,11728970,2023-02-14,93.35,878.22
62,11736814,2023-01-31,0.0,381.51
4634,11736814,2023-02-03,-133.06,248.45
4635,11736814,2023-02-05,-790.5,-542.05
7081,11736814,2023-02-06,98.86,-443.18999999999994
4636,11736814,2023-02-11,-1851.4,-2294.59
63,11744491,2023-01-31,0.0,105.92
363,11744491,2023-02-01,112.17,218.09
364,11744491,2023-02-01,142.98,361.07
365,11744491,2023-02-03,656.3,1017.3699999999999
5073,11744491,2023-02-04,-144.75,872.6199999999999
5074,11744491,2023-02-06,-92.39,780.2299999999999
5075,11744491,2023-02-09,-176.85,603.3799999999999
366,11744491,2023-02-09,87.15,690.5299999999999
5076,11744491,2023-02-10,-39.7,650.8299999999999
367,11744491,2023-02-11,85.89,736.7199999999999
5077,11744491,2023-02-12,-55.81,680.9099999999999
5078,11744491,2023-02-13,-121.39,559.5199999999999
368,11744491,2023-02-13,115.86,675.3799999999999
64,11764022,2023-01-31,0.0,286.66
479,11764022,2023-02-01,-117.24,169.42000000000002
3760,11764022,2023-02-03,3.65,173.07000000000005
3761,11764022,2023-02-10,86.61,259.68000000000006
65,11778031,2023-01-31,0.0,514.7
7914,11778031,2023-02-08,-37.69,477.01000000000005
7915,11778031,2023-02-09,-64.44,412.57000000000005
8425,11778031,2023-02-11,102.08,514.6500000000001
8426,11778031,2023-02-13,569.6,1084.25
66,11790056,2023-01-31,0.0,49.7
1830,11790056,2023-02-01,-95.49,-45.78999999999999
213,11790056,2023-02-01,119.97,74.18
214,11790056,2023-02-03,12.0,86.18
1831,11790056,2023-02-05,-91.81,-5.6299999999999955
1832,11790056,2023-02-06,-688.5,-694.13
1833,11790056,2023-02-06,-47.78,-741.91
1834,11790056,2023-02-08,-41.57,-783.48
215,11790056,2023-02-08,90.7,-692.78
1835,11790056,2023-02-09,-969.7,-1662.48
67,11804173,2023-01-31,0.0,353.62
2208,11804173,2023-02-02,119.36,472.98
5114,11804173,2023-02-04,-159.42,313.56
2209,11804173,2023-02-04,100.25,413.81
5115,11804173,2023-02-11,-53.59,360.22
68,11826060,2023-01-31,0.0,782.13
6360,11826060,2023-02-05,63.32,845.45
6361,11826060,2023-02-07,81.64,927.09
6362,11826060,2023-02-09,38.13,965.22
8489,11826060,2023-02-11,-63.83,901.39
6363,11826060,2023-02-13,93.04,994.4300000000001
6364,11826060,2023-02-13,118.67,1113.1
69,11831265,2023-01-31,0.0,292.14
370,11831265,2023-02-01,-140.67,151.47
371,11831265,2023-02-01,-103.4,48.06999999999999
372,11831265,2023-02-01,-91.77,-43.69999999999999
373,11831265,2023-02-09,-98.31,-142.01
8201,11831265,2023-02-10,89.98,-52.02999999999997
8202,11831265,2023-02-13,157.99,105.96000000000001
374,11831265,2023-02-14,-85.67,20.29000000000002
70,11836917,2023-01-31,0.0,650.14
738,11836917,2023-02-01,-138.19,511.95
8525,11836917,2023-02-12,90.66,602.61
8527,11836917,2023-02-14,87.88,690.49
8526,11836917,2023-02-14,165.55,856.04
71,11846043,2023-01-31,0.0,915.59
2372,11846043,2023-02-02,69.49,985.08
2373,11846043,2023-02-06,87.82,1072.9
7665,11846043,2023-02-07,-56.28,1016.62
7666,11846043,2023-02-10,-1640.4,-623.7800000000001
2374,11846043,2023-02-12,139.76,-484.0200000000001
72,11882775,2023-01-31,0.0,299.41
661,11882775,2023-02-01,-1058.7,-759.29
660,11882775,2023-02-01,-105.63,-864.9199999999998
662,11882775,2023-02-03,-753.5,-1618.4199999999998
4158,11882775,2023-02-03,118.76,-1499.6599999999999
4159,11882775,2023-02-05,84.05,-1415.61
663,11882775,2023-02-06,-1791.9,-3207.51
664,11882775,2023-02-06,-90.05,-3297.5600000000004
4160,11882775,2023-02-08,209.73,-3087.8300000000004
4161,11882775,2023-02-09,1202.9,-1884.93
73,11910409,2023-01-31,0.0,241.22
691,11910409,2023-02-01,-80.43,160.79
692,11910409,2023-02-04,-78.93,81.85999999999999
693,11910409,2023-02-05,-118.22,-36.36000000000004
6377,11910409,2023-02-05,78.36,41.99999999999997
694,11910409,2023-02-06,-53.53,-11.530000000000001
6378,11910409,2023-02-12,103.79,92.25999999999999
6379,11910409,2023-02-13,112.31,204.57
74,11928523,2023-01-31,0.0,818.51
6282,11928523,2023-02-05,-149.91,668.6
6283,11928523,2023-02-07,-76.58,592.02
6284,11928523,2023-02-08,-74.38,517.64
8395,11928523,2023-02-11,99.31,616.95
8396,11928523,2023-02-12,2208.4,2825.3500000000004
8397,11928523,2023-02-13,68.67,2894.0200000000004
75,12035637,2023-01-31,0.0,461.35
2365,12035637,2023-02-02,-1138.0,-676.65
2364,12035637,2023-02-02,-779.9,-1456.5500000000002
2366,12035637,2023-02-03,-36.14,-1492.69
7394,12035637,2023-02-07,230.31,-1262.38
7393,12035637,2023-02-07,260.82,-1001.5599999999998
7392,12035637,2023-02-07,1190.8,189.2399999999999
2369,12035637,2023-02-08,-1169.6,-980.36
2367,12035637,2023-02-08,-143.15,-1123.5100000000002
2368,12035637,2023-02-08,-90.52,-1214.0300000000002
7395,12035637,2023-02-10,551.6,-662.43
2370,12035637,2023-02-11,-137.31,-799.7399999999999
2371,12035637,2023-02-12,-123.5,-923.2399999999999
76,12042151,2023-01-31,0.0,336.44
4825,12042151,2023-02-03,-89.74,246.7
6269,12042151,2023-02-05,97.45,344.15
6270,12042151,2023-02-07,101.5,445.65
4826,12042151,2023-02-09,-64.03,381.62
4827,12042151,2023-02-11,-32.04,349.58
6271,12042151,2023-02-11,1271.5,1621.0800000000002
4828,12042151,2023-02-13,-61.53,1559.5500000000002
77,12088180,2023-01-31,0.0,656.51
8470,12088180,2023-02-11,22.62,679.13
8471,12088180,2023-02-12,190.9,870.03
8663,12088180,2023-02-14,-45.9,824.13
78,12099406,2023-01-31,0.0,681.11
2079,12099406,2023-02-01,-94.97,586.14
2080,12099406,2023-02-07,-934.2,-348.06000000000006
2081,12099406,2023-02-10,-143.73,-491.7900000000001
8562,12099406,2023-02-12,1201.1,709.3099999999998
8563,12099406,2023-02-13,112.0,821.3099999999998
79,12111805,2023-01-31,0.0,890.99
469,12111805,2023-02-01,110.9,1001.89
3996,12111805,2023-02-03,-79.35,922.54
470,12111805,2023-02-06,128.91,1051.45
3997,12111805,2023-02-10,-185.21,866.24
3998,12111805,2023-02-11,-77.84,788.4
3999,12111805,2023-02-13,-202.54,585.86
4000,12111805,2023-02-14,-94.45,491.41
80,12172627,2023-01-31,0.0,550.41
2812,12172627,2023-02-02,137.03,687.4399999999999
5991,12172627,2023-02-05,-116.16,571.28
5992,12172627,2023-02-12,-76.51,494.77
81,12185627,2023-01-31,0.0,873.23
2228,12185627,2023-02-02,-30.52,842.71
4057,12185627,2023-02-03,225.89,1068.6
2229,12185627,2023-02-04,-50.19,1018.41
2230,12185627,2023-02-05,-80.67,937.74
4058,12185627,2023-02-10,206.97,1144.71
4059,12185627,2023-02-11,100.94,1245.65
4060,12185627,2023-02-11,193.89,1439.54
2231,12185627,2023-02-12,-72.94,1366.6
2232,12185627,2023-02-13,-91.8,1274.8
82,12198380,2023-01-31,0.0,445.46
4439,12198380,2023-02-03,145.97,591.43
4440,12198380,2023-02-04,134.24,725.6700000000001
6166,12198380,2023-02-05,-171.75,553.92
6167,12198380,2023-02-05,-144.38,409.53999999999996
4441,12198380,2023-02-05,100.05,509.59
6168,12198380,2023-02-07,-34.47,475.12
4442,12198380,2023-02-09,145.71,620.8299999999999
4443,12198380,2023-02-12,67.66,688.49
6169,12198380,2023-02-14,-85.37,603.12
83,12199229,2023-01-31,0.0,804.0
8418,12199229,2023-02-11,-31.4,772.6
8419,12199229,2023-02-11,-30.47,742.13
84,12233762,2023-01-31,0.0,386.05
6300,12233762,2023-02-05,-114.97,271.08000000000004
6301,12233762,2023-02-06,-102.35,168.73000000000002
6303,12233762,2023-02-07,-134.62,34.110000000000014
6302,12233762,2023-02-07,-110.05,-75.94
8297,12233762,2023-02-10,83.93,7.990000000000009
6304,12233762,2023-02-11,-370.4,-362.41
8298,12233762,2023-02-12,150.86,-211.5499999999999
6305,12233762,2023-02-14,-176.37,-387.92
85,12240007,2023-01-31,0.0,894.48
2557,12240007,2023-02-02,93.98,988.46
5105,12240007,2023-02-04,-2.44,986.02
5106,12240007,2023-02-05,-64.41,921.61
2558,12240007,2023-02-05,1748.6,2670.21
5107,12240007,2023-02-12,-127.13,2543.08
5108,12240007,2023-02-13,-562.4,1980.68
86,12241820,2023-01-31,0.0,207.29
87,12388837,2023-01-31,0.0,463.31
4612,12388837,2023-02-03,55.47,518.78
6422,12388837,2023-02-05,-183.42,335.36
4613,12388837,2023-02-07,65.45,400.81
4614,12388837,2023-02-13,111.37,512.1800000000001
4615,12388837,2023-02-14,87.61,599.79
88,12420291,2023-01-31,0.0,578.47
4508,12420291,2023-02-03,-1223.8,-645.3299999999999
4509,12420291,2023-02-08,-796.3,-1441.6299999999999
4510,12420291,2023-02-11,-105.46,-1547.09
4511,12420291,2023-02-12,-70.05,-1617.1399999999996
89,12423613,2023-01-31,0.0,459.18
3105,12423613,2023-02-02,-1805.5,-1346.32
5574,12423613,2023-02-04,95.13,-1251.1899999999998
5575,12423613,2023-02-14,73.71,-1177.48
90,12440230,2023-01-31,0.0,842.67
7550,12440230,2023-02-07,-197.12,645.55
7665,12440230,2023-02-07,16.27,661.8199999999999
7551,12440230,2023-02-14,-175.06,486.76
91,12493067,2023-01-31,0.0,404.61
4692,12493067,2023-02-03,86.49,491.1
4693,12493067,2023-02-06,114.74,605.84
7923,12493067,2023-02-08,-105.32,500.52
7924,12493067,2023-02-13,-93.04,407.48
4694,12493067,2023-02-14,44.96,452.44
92,12494185,2023-01-31,0.0,762.16
5792,12494185,2023-02-04,-97.26,664.9
5360,12494185,2023-02-04,71.39,736.29
5794,12494185,2023-02-07,-117.32,618.97
5793,12494185,2023-02-07,-97.29,521.68
93,12499656,2023-01-31,0.0,96.27
739,12499656,2023-02-01,75.09,171.36
738,12499656,2023-02-01,168.84,340.2
740,12499656,2023-02-02,140.57,480.77
4213,12499656,2023-02-03,-111.35,369.41999999999996
741,12499656,2023-02-05,147.75,517.17
4214,12499656,2023-02-06,-88.22,428.95
4215,12499656,2023-02-07,-38.62,390.33
742,12499656,2023-02-10,152.92,543.25
743,12499656,2023-02-13,98.34,641.5899999999999
4216,12499656,2023-02-14,-156.27,485.31999999999994
94,12560453,2023-01-31,0.0,85.03
1507,12560453,2023-02-01,147.6,232.63
1508,12560453,2023-02-05,71.33,303.96000000000004
1509,12560453,2023-02-05,152.02,455.98
7888,12560453,2023-02-08,-55.71,400.27
1510,12560453,2023-02-08,47.58,447.85
7889,12560453,2023-02-13,-49.05,398.79999999999995
95,12583269,2023-01-31,0.0,910.46
3495,12583269,2023-02-02,125.46,1035.92
4837,12583269,2023-02-03,-118.33,917.59
4838,12583269,2023-02-04,-129.11,788.48
3496,12583269,2023-02-05,80.89,869.37
3497,12583269,2023-02-14,63.34,932.71
96,12666385,2023-01-31,0.0,554.24
1548,12666385,2023-02-01,106.46,660.7
1549,12666385,2023-02-01,246.14,906.8399999999999
1550,12666385,2023-02-04,1593.8,2500.64
1551,12666385,2023-02-12,149.57,2650.21
97,12680102,2023-01-31,0.0,674.64
6663,12680102,2023-02-05,-41.65,632.99
7938,12680102,2023-02-08,603.0,1235.99
6664,12680102,2023-02-09,-97.29,1138.7
6665,12680102,2023-02-11,-1010.6,128.10000000000002
7939,12680102,2023-02-12,94.03,222.12999999999988
6666,12680102,2023-02-13,-851.7,-629.57
98,12725274,2023-01-31,0.0,26.19
1810,12725274,2023-02-01,167.85,194.04
1811,12725274,2023-02-04,125.11,319.15
6321,12725274,2023-02-05,-58.28,260.87
6322,12725274,2023-02-14,-162.9,97.96999999999997
1812,12725274,2023-02-14,412.8,510.77
99,12859818,2023-01-31,0.0,151.06
18,12859818,2023-02-01,89.22,240.28
3753,12859818,2023-02-03,-129.38,110.9
3755,12859818,2023-02-04,-110.3,0.6000000000000227
3754,12859818,2023-02-04,-81.01,-80.41
3756,12859818,2023-02-07,-106.24,-186.64999999999998
3757,12859818,2023-02-10,-131.38,-318.03
3758,12859818,2023-02-10,-36.91,-354.94
3759,12859818,2023-02-13,-203.37,-558.31
19,12859818,2023-02-14,24.89,-533.4200000000001
100,12899540,2023-01-31,0.0,957.2
456,12899540,2023-02-01,-83.35,873.85
5299,12899540,2023-02-04,125.25,999.1
457,12899540,2023-02-06,-78.47,920.6300000000001
5300,12899540,2023-02-06,159.04,1079.67
458,12899540,2023-02-10,-85.03,994.6400000000001
101,12964138,2023-01-31,0.0,557.04
1971,12964138,2023-02-01,-55.49,501.54999999999995
211,12964138,2023-02-01,101.62,603.17
212,12964138,2023-02-06,104.0,707.17
1972,12964138,2023-02-13,-357.3,349.86999999999995
102,12985543,2023-01-31,0.0,402.94
1717,12985543,2023-02-01,-140.27,262.66999999999996
1718,12985543,2023-02-07,-99.51,163.15999999999997
8100,12985543,2023-02-09,118.41,281.57
8101,12985543,2023-02-11,57.3,338.87
1719,12985543,2023-02-13,-62.13,276.74
103,13058003,2023-01-31,0.0,218.0
2499,13058003,2023-02-02,-35.9,182.1
2500,13058003,2023-02-09,-1246.4,-1064.3000000000002
2501,13058003,2023-02-11,-96.36,-1160.66
8619,13058003,2023-02-13,565.6,-595.0600000000002
104,13076932,2023-01-31,0.0,419.47
3549,13076932,2023-02-02,-125.46,294.01000000000005
3550,13076932,2023-02-08,-94.91,199.10000000000002
8465,13076932,2023-02-11,146.03,345.13000000000005
8466,13076932,2023-02-13,136.72,481.85
105,13117442,2023-01-31,0.0,799.69
2991,13117442,2023-02-02,-46.31,753.3800000000001
2992,13117442,2023-02-05,-164.35,589.0300000000001
6325,13117442,2023-02-05,59.8,648.83
6324,13117442,2023-02-05,101.84,750.6700000000001
2993,13117442,2023-02-08,-109.72,640.95
6326,13117442,2023-02-11,1828.9,2469.8500000000004
2994,13117442,2023-02-12,-132.28,2337.57
106,13167285,2023-01-31,0.0,301.93
1046,13167285,2023-02-01,-199.99,101.94
1047,13167285,2023-02-01,-3.89,98.05000000000001
1048,13167285,2023-02-03,-529.6,-431.55
4512,13167285,2023-02-03,139.6,-291.95
1049,13167285,2023-02-05,-21.67,-313.62000000000006
4513,13167285,2023-02-06,204.86,-108.75999999999999
1050,13167285,2023-02-07,-78.2,-186.95999999999998
1051,13167285,2023-02-09,-20.1,-207.06
1052,13167285,2023-02-13,-136.9,-343.96
1053,13167285,2023-02-13,-99.54,-443.50000000000006
4514,13167285,2023-02-14,38.92,-404.58
107,13176075,2023-01-31,0.0,67.3
5382,13176075,2023-02-04,127.96,195.26
7886,13176075,2023-02-08,-167.77,27.48999999999998
7887,13176075,2023-02-12,-149.27,-121.78000000000004
108,13182613,2023-01-31,0.0,384.42
6311,13182613,2023-02-05,220.0,604.4200000000001
6312,13182613,2023-02-06,63.49,667.9100000000001
7713,13182613,2023-02-08,-113.46,554.45
7714,13182613,2023-02-09,-79.45,475.0
6313,13182613,2023-02-09,55.88,530.88
109,13197335,2023-01-31,0.0,625.71
157,13197335,2023-02-01,85.83,711.5400000000001
156,13197335,2023-02-01,98.45,809.99
3471,13197335,2023-02-02,-93.5,716.49
158,13197335,2023-02-02,100.61,817.1
159,13197335,2023-02-08,79.86,896.96
160,13197335,2023-02-09,1043.8,1940.76
161,13197335,2023-02-10,1812.5,3753.26
3472,13197335,2023-02-11,-215.83,3537.43
110,13267945,2023-01-31,0.0,299.77
4908,13267945,2023-02-03,102.35,402.12
4909,13267945,2023-02-04,1080.2,1482.32
4910,13267945,2023-02-07,81.75,1564.07
4911,13267945,2023-02-08,154.6,1718.6699999999998
4912,13267945,2023-02-10,71.11,1789.78
111,13274987,2023-01-31,0.0,902.06
833,13274987,2023-02-01,-33.51,868.55
834,13274987,2023-02-03,-111.04,757.51
835,13274987,2023-02-03,-53.43,704.0799999999999
836,13274987,2023-02-04,-93.78,610.3
6591,13274987,2023-02-05,101.16,711.4599999999999
6592,13274987,2023-02-08,1290.2,2001.66
837,13274987,2023-02-12,-117.48,1884.18
6593,13274987,2023-02-12,118.61,2002.79
112,13277127,2023-01-31,0.0,793.22
4470,13277127,2023-02-03,17.26,810.48
6233,13277127,2023-02-05,-17.93,792.5500000000001
6234,13277127,2023-02-06,-1037.3,-244.75
4472,13277127,2023-02-08,251.9,7.149999999999977
4471,13277127,2023-02-08,714.2,721.35
113,13322659,2023-01-31,0.0,690.27
1248,13322659,2023-02-01,-153.9,536.37
1249,13322659,2023-02-02,-145.27,391.09999999999997
5653,13322659,2023-02-04,123.49,514.5899999999999
1250,13322659,2023-02-05,-53.92,460.66999999999996
5654,13322659,2023-02-05,36.77,497.43999999999994
1251,13322659,2023-02-09,-106.38,391.05999999999995
1252,13322659,2023-02-09,-85.8,305.26
1253,13322659,2023-02-14,-113.46,191.79999999999995
114,13388069,2023-01-31,0.0,13.45
7413,13388069,2023-02-07,134.99,148.44
7414,13388069,2023-02-08,27.53,175.97
8569,13388069,2023-02-12,-69.99,105.98000000000002
115,13426667,2023-01-31,0.0,70.47
6137,13426667,2023-02-05,-121.7,-51.230000000000004
7888,13426667,2023-02-08,32.44,-18.790000000000006
7889,13426667,2023-02-12,1224.6,1205.81
6138,13426667,2023-02-13,-902.0,303.80999999999995
116,13459523,2023-01-31,0.0,814.31
4336,13459523,2023-02-03,-952.0,-137.69000000000005
4122,13459523,2023-02-03,135.59,-2.1000000000000227
4337,13459523,2023-02-06,-171.67,-173.76999999999998
4123,13459523,2023-02-07,57.31,-116.46000000000004
4124,13459523,2023-02-08,898.2,781.74
4338,13459523,2023-02-10,-132.35,649.39
4125,13459523,2023-02-10,166.54,815.9300000000001
4126,13459523,2023-02-13,162.92,978.85
117,13474543,2023-01-31,0.0,438.36
1501,13474543,2023-02-01,120.92,559.28
6493,13474543,2023-02-05,-107.87,451.41
1502,13474543,2023-02-06,87.33,538.74
1503,13474543,2023-02-09,264.6,803.34
1505,13474543,2023-02-14,76.83,880.1700000000001
1504,13474543,2023-02-14,159.08,1039.25
118,13537427,2023-01-31,0.0,556.98
481,13537427,2023-02-01,52.56,609.54
482,13537427,2023-02-07,164.7,774.24
483,13537427,2023-02-11,246.42,1020.66
8524,13537427,2023-02-12,-172.13,848.53
119,13551717,2023-01-31,0.0,26.95
2059,13551717,2023-02-01,-1361.0,-1334.05
2060,13551717,2023-02-05,-627.1,-1961.1499999999999
2061,13551717,2023-02-11,-42.85,-2004.0
2062,13551717,2023-02-14,-115.32,-2119.32
120,13558846,2023-01-31,0.0,598.45
760,13558846,2023-02-01,-94.06,504.39000000000004
1129,13558846,2023-02-01,50.33,554.72
1130,13558846,2023-02-04,148.08,702.8000000000001
761,13558846,2023-02-05,-148.46,554.34
762,13558846,2023-02-09,-115.1,439.24000000000007
763,13558846,2023-02-13,-112.18,327.06000000000006
121,13563384,2023-01-31,0.0,952.65
2716,13563384,2023-02-02,39.75,992.4
2717,13563384,2023-02-11,54.28,1046.68
2718,13563384,2023-02-12,70.05,1116.73
8684,13563384,2023-02-14,-860.1,256.63
122,13584908,2023-01-31,0.0,162.0
3531,13584908,2023-02-02,-75.16,86.84
3532,13584908,2023-02-05,-85.05,1.7900000000000205
3533,13584908,2023-02-10,-81.43,-79.63999999999999
8320,13584908,2023-02-10,135.21,55.56999999999999
123,13610259,2023-01-31,0.0,587.73
8084,13610259,2023-02-09,33.72,621.45
8085,13610259,2023-02-10,655.8,1277.25
8086,13610259,2023-02-11,91.03,1368.28
8534,13610259,2023-02-12,-100.74,1267.54
124,13687711,2023-01-31,0.0,757.76
2768,13687711,2023-02-02,-75.11,682.65
2769,13687711,2023-02-04,-135.11,547.54
2770,13687711,2023-02-11,-73.61,473.92999999999995
8628,13687711,2023-02-13,734.3,1208.23
2771,13687711,2023-02-14,-76.83,1131.3999999999999
125,13713704,2023-01-31,0.0,1.48
2666,13713704,2023-02-02,91.84,93.32000000000001
5765,13713704,2023-02-04,-184.38,-91.05999999999999
5766,13713704,2023-02-10,-97.03,-188.09
2667,13713704,2023-02-10,122.82,-65.27
2668,13713704,2023-02-11,78.2,12.930000000000003
5767,13713704,2023-02-13,-14.09,-1.159999999999997
126,13788234,2023-01-31,0.0,302.78
7150,13788234,2023-02-06,-100.59,202.18999999999997
7151,13788234,2023-02-07,-163.8,38.389999999999986
7152,13788234,2023-02-07,-140.37,-101.98000000000002
7153,13788234,2023-02-08,-33.64,-135.62000000000006
8249,13788234,2023-02-10,147.03,11.409999999999968
8250,13788234,2023-02-14,90.07,101.47999999999996
8251,13788234,2023-02-14,112.47,213.94999999999996
127,13945841,2023-01-31,0.0,339.81
1944,13945841,2023-02-01,473.7,813.51
1945,13945841,2023-02-14,43.02,856.53
128,13965360,2023-01-31,0.0,299.46
8405,13965360,2023-02-11,-1655.3,-1355.84
129,13997603,2023-01-31,0.0,516.79
3847,13997603,2023-02-03,34.72,551.51
3848,13997603,2023-02-07,52.55,604.06
3849,13997603,2023-02-07,788.3,1392.36
8309,13997603,2023-02-10,-155.28,1237.08
8310,13997603,2023-02-10,-69.88,1167.1999999999998
130,14000447,2023-01-31,0.0,443.94
993,14000447,2023-02-01,97.79,541.73
6994,14000447,2023-02-06,-154.42,387.31
6995,14000447,2023-02-09,-74.98,312.33000000000004
994,14000447,2023-02-10,26.87,339.20000000000005
6996,14000447,2023-02-13,-55.26,283.94
995,14000447,2023-02-13,147.67,431.61
131,14014401,2023-01-31,0.0,554.46
7222,14014401,2023-02-06,185.73,740.19
7223,14014401,2023-02-08,40.08,780.27
8197,14014401,2023-02-09,-1549.1,-768.8299999999999
7224,14014401,2023-02-10,73.16,-695.6699999999998
132,14039438,2023-01-31,0.0,94.52
2728,14039438,2023-02-02,248.7,343.21999999999997
2729,14039438,2023-02-03,117.17,460.39
2730,14039438,2023-02-05,35.3,495.68999999999994
6828,14039438,2023-02-06,-155.88,339.81
2731,14039438,2023-02-09,141.4,481.21
133,14045416,2023-01-31,0.0,265.63
1173,14045416,2023-02-01,-53.46,212.17
2870,14045416,2023-02-02,152.95,365.12
1174,14045416,2023-02-03,-89.03,276.09
2871,14045416,2023-02-03,67.35,343.43999999999994
1175,14045416,2023-02-08,-42.88,300.55999999999995
134,14052052,2023-01-31,0.0,915.74
6191,14052052,2023-02-05,-89.52,826.22
6192,14052052,2023-02-08,-192.5,633.72
6194,14052052,2023-02-09,-666.4,-32.67999999999995
6193,14052052,2023-02-09,-512.3,-544.9799999999998
8603,14052052,2023-02-12,117.55,-427.42999999999984
6195,14052052,2023-02-14,-137.73,-565.1599999999999
135,14086187,2023-01-31,0.0,340.59
2602,14086187,2023-02-02,551.2,891.79
2603,14086187,2023-02-03,166.13,1057.92
2604,14086187,2023-02-04,146.29,1204.21
6414,14086187,2023-02-05,-98.2,1106.01
2605,14086187,2023-02-06,135.77,1241.78
6415,14086187,2023-02-08,-42.56,1199.22
2606,14086187,2023-02-08,58.95,1258.17
136,14103210,2023-01-31,0.0,369.01
5330,14103210,2023-02-04,-111.88,257.13
5331,14103210,2023-02-06,-1144.5,-887.3700000000001
5332,14103210,2023-02-06,-1.14,-888.5100000000002
7763,14103210,2023-02-08,116.37,-772.1400000000001
5333,14103210,2023-02-09,-6.19,-778.3300000000002
5334,14103210,2023-02-11,-151.17,-929.5000000000002
7764,14103210,2023-02-11,130.19,-799.3100000000002
7765,14103210,2023-02-13,1406.7,607.3899999999999
137,14136082,2023-01-31,0.0,219.84
514,14136082,2023-02-01,82.18,302.02
515,14136082,2023-02-02,526.8,828.82
516,14136082,2023-02-03,89.93,918.7500000000001
517,14136082,2023-02-07,49.76,968.5100000000001
518,14136082,2023-02-09,125.63,1094.1399999999999
8473,14136082,2023-02-11,-169.33,924.8100000000001
8472,14136082,2023-02-11,-39.58,885.23
519,14136082,2023-02-12,351.6,1236.83
520,14136082,2023-02-14,140.8,1377.6299999999999
138,14144267,2023-01-31,0.0,97.69
7145,14144267,2023-02-06,44.47,142.16
7146,14144267,2023-02-08,114.12,256.28
7147,14144267,2023-02-09,89.43,345.71000000000004
139,14183437,2023-01-31,0.0,779.47
2455,14183437,2023-02-02,-95.08,684.39
2459,14183437,2023-02-02,30.01,714.4000000000001
2460,14183437,2023-02-03,99.07,813.47
2461,14183437,2023-02-10,1975.6,2789.0699999999997
2456,14183437,2023-02-11,-90.85,2698.2200000000003
2462,14183437,2023-02-11,43.17,2741.39
2463,14183437,2023-02-14,120.06,2861.45
140,14253152,2023-01-31,0.0,43.85
3946,14253152,2023-02-03,81.28,125.13
5099,14253152,2023-02-04,-111.13,14.000000000000007
3947,14253152,2023-02-06,176.53,190.53
3948,14253152,2023-02-08,215.14,405.67
5100,14253152,2023-02-09,-157.13,248.54
5101,14253152,2023-02-11,-130.43,118.10999999999999
5102,14253152,2023-02-14,-963.5,-845.39
3949,14253152,2023-02-14,100.16,-745.23
141,14337606,2023-01-31,0.0,561.8
5031,14337606,2023-02-04,-79.62,482.17999999999995
5032,14337606,2023-02-04,-53.8,428.37999999999994
5033,14337606,2023-02-06,-1792.7,-1364.3200000000002
5034,14337606,2023-02-08,-160.99,-1525.3100000000002
5035,14337606,2023-02-09,-158.61,-1683.9200000000003
5036,14337606,2023-02-11,-170.72,-1854.64
8497,14337606,2023-02-11,175.69,-1678.95
5037,14337606,2023-02-12,-132.03,-1810.9800000000002
8498,14337606,2023-02-14,76.49,-1734.49
142,14355869,2023-01-31,0.0,329.16
1846,14355869,2023-02-01,-1052.6,-723.4399999999998
4832,14355869,2023-02-03,123.39,-600.05
1847,14355869,2023-02-04,-515.6,-1115.6499999999999
1848,14355869,2023-02-12,-19.96,-1135.61
143,14397662,2023-01-31,0.0,363.51
5458,14397662,2023-02-04,61.88,425.39
5459,14397662,2023-02-08,37.69,463.08
5461,14397662,2023-02-08,54.11,517.19
5462,14397662,2023-02-08,126.11,643.3
5460,14397662,2023-02-08,1800.8,2444.1000000000004
8504,14397662,2023-02-11,-74.51,2369.59
144,14421453,2023-01-31,0.0,813.76
1525,14421453,2023-02-01,150.38,964.14
5123,14421453,2023-02-04,-183.25,780.89
1526,14421453,2023-02-04,44.06,824.95
1527,14421453,2023-02-06,67.0,891.95
1528,14421453,2023-02-08,35.51,927.46
5124,14421453,2023-02-11,-102.02,825.44
145,14448009,2023-01-31,0.0,958.46
685,14448009,2023-02-01,-107.97,850.49
684,14448009,2023-02-01,-102.39,748.1
3081,14448009,2023-02-02,122.38,870.48
3082,14448009,2023-02-02,144.05,1014.5300000000001
686,14448009,2023-02-04,-1367.4,-352.8700000000001
687,14448009,2023-02-08,-1779.2,-2132.07
689,14448009,2023-02-09,-1300.7,-3432.7700000000004
688,14448009,2023-02-09,-139.36,-3572.13
690,14448009,2023-02-14,-14.98,-3587.1100000000006
3083,14448009,2023-02-14,78.98,-3508.13
146,14505806,2023-01-31,0.0,689.25
260,14505806,2023-02-01,974.4,1663.65
261,14505806,2023-02-08,121.72,1785.37
8149,14505806,2023-02-09,-102.41,1682.96
263,14505806,2023-02-11,38.37,1721.33
262,14505806,2023-02-11,130.43,1851.76
8150,14505806,2023-02-13,-71.51,1780.25
264,14505806,2023-02-14,956.2,2736.45
147,14564252,2023-01-31,0.0,263.39
2219,14564252,2023-02-02,-133.0,130.39
2220,14564252,2023-02-14,-158.38,-27.99000000000001
148,14592080,2023-01-31,0.0,245.22
2564,14592080,2023-02-02,-113.73,131.49
2565,14592080,2023-02-02,-70.88,60.609999999999985
2828,14592080,2023-02-02,149.36,209.97
2566,14592080,2023-02-04,-213.8,-3.8300000000000125
2829,14592080,2023-02-05,99.57,95.73999999999998
2567,14592080,2023-02-06,-93.76,1.9799999999999898
2830,14592080,2023-02-07,50.0,51.97999999999999
149,14594928,2023-01-31,0.0,470.64
4008,14594928,2023-02-03,-145.32,325.32
7303,14594928,2023-02-07,123.7,449.02
7304,14594928,2023-02-10,75.71,524.73
4009,14594928,2023-02-12,-140.65,384.08
150,14600288,2023-01-31,0.0,622.77
3354,14600288,2023-02-02,-147.71,475.05999999999995
3355,14600288,2023-02-02,-140.31,334.75
2342,14600288,2023-02-02,43.55,378.29999999999995
2343,14600288,2023-02-03,88.58,466.88
2344,14600288,2023-02-05,110.92,577.8
2345,14600288,2023-02-08,93.19,670.99
3356,14600288,2023-02-13,-138.07,532.92
2346,14600288,2023-02-14,83.11,616.03
151,14648004,2023-01-31,0.0,236.67
1187,14648004,2023-02-01,-77.41,159.26
986,14648004,2023-02-01,92.2,251.45999999999998
988,14648004,2023-02-04,72.87,324.33
987,14648004,2023-02-04,100.53,424.86
1188,14648004,2023-02-05,-16.24,408.62
1189,14648004,2023-02-07,-111.26,297.36
990,14648004,2023-02-07,21.02,318.38
989,14648004,2023-02-07,114.81,433.19
1190,14648004,2023-02-08,-1330.7,-897.5100000000001
1191,14648004,2023-02-12,-1808.9,-2706.41
1192,14648004,2023-02-13,-113.24,-2819.65
152,14685853,2023-01-31,0.0,45.2
609,14685853,2023-02-01,-142.37,-97.17
5625,14685853,2023-02-04,109.08,11.909999999999997
5626,14685853,2023-02-06,79.32,91.22999999999999
5627,14685853,2023-02-07,26.93,118.15999999999998
5628,14685853,2023-02-11,370.4,488.55999999999995
153,14723713,2023-01-31,0.0,378.07
8332,14723713,2023-02-10,-113.36,264.71
8280,14723713,2023-02-10,67.56,332.27
8281,14723713,2023-02-11,126.78,459.05
8282,14723713,2023-02-13,149.91,608.96
154,14749214,2023-01-31,0.0,194.54
4820,14749214,2023-02-03,49.32,243.85999999999999
7562,14749214,2023-02-07,-145.52,98.33999999999997
4821,14749214,2023-02-12,207.81,306.15
155,14780986,2023-01-31,0.0,180.2
464,14780986,2023-02-01,105.85,286.04999999999995
465,14780986,2023-02-04,164.38,450.43
7154,14780986,2023-02-06,-965.2,-514.77
7155,14780986,2023-02-07,-168.78,-683.55
466,14780986,2023-02-07,132.81,-550.74
156,14812157,2023-01-31,0.0,534.54
874,14812157,2023-02-01,645.5,1180.04
5561,14812157,2023-02-04,-134.48,1045.56
5562,14812157,2023-02-06,-473.7,571.86
5563,14812157,2023-02-09,-117.1,454.76
5564,14812157,2023-02-14,-120.54,334.22
157,14840078,2023-01-31,0.0,584.16
1509,14840078,2023-02-01,-118.24,465.91999999999996
6300,14840078,2023-02-05,62.37,528.29
1510,14840078,2023-02-06,-188.27,340.02
1511,14840078,2023-02-07,-87.19,252.82999999999993
1512,14840078,2023-02-09,-102.32,150.51
1513,14840078,2023-02-10,-144.1,6.409999999999968
6301,14840078,2023-02-10,210.07,216.47999999999996
1514,14840078,2023-02-13,-82.99,133.48999999999995
6302,14840078,2023-02-14,75.98,209.46999999999997
158,14866733,2023-01-31,0.0,249.35
1666,14866733,2023-02-01,-77.78,171.57
2713,14866733,2023-02-02,16.74,188.31
2714,14866733,2023-02-03,68.61,256.91999999999996
2715,14866733,2023-02-07,83.68,340.6
1668,14866733,2023-02-14,-93.66,246.94
1667,14866733,2023-02-14,-38.4,208.54
159,14897645,2023-01-31,0.0,89.0
1281,14897645,2023-02-01,113.69,202.69
8060,14897645,2023-02-09,-69.51,133.18
8061,14897645,2023-02-11,-51.73,81.44999999999999
1282,14897645,2023-02-12,106.92,188.37
1283,14897645,2023-02-14,143.79,332.15999999999997
160,14907946,2023-01-31,0.0,845.72
4062,14907946,2023-02-03,66.37,912.09
7503,14907946,2023-02-07,-150.1,761.99
7502,14907946,2023-02-07,-84.76,677.23
4063,14907946,2023-02-08,129.86,807.09
4064,14907946,2023-02-10,11.73,818.82
4065,14907946,2023-02-12,115.04,933.86
7505,14907946,2023-02-14,-161.34,772.52
7504,14907946,2023-02-14,-67.7,704.82
4066,14907946,2023-02-14,98.03,802.85
4067,14907946,2023-02-14,190.15,993.0
161,15033812,2023-01-31,0.0,504.58
162,15044055,2023-01-31,0.0,204.3
5532,15044055,2023-02-04,93.78,298.08000000000004
6851,15044055,2023-02-06,-78.94,219.14000000000001
6852,15044055,2023-02-09,-1434.1,-1214.96
6853,15044055,2023-02-10,-181.71,-1396.67
5534,15044055,2023-02-14,52.78,-1343.89
5533,15044055,2023-02-14,161.91,-1181.98
163,15052808,2023-01-31,0.0,786.05
3186,15052808,2023-02-02,936.1,1722.15
3188,15052808,2023-02-09,127.23,1849.3799999999999
3187,15052808,2023-02-09,953.9,2803.2799999999997
8668,15052808,2023-02-14,-1288.0,1515.28
8667,15052808,2023-02-14,-71.18,1444.1
164,15055504,2023-01-31,0.0,339.94
6496,15055504,2023-02-05,-170.82,169.12
6497,15055504,2023-02-07,-106.77,62.35000000000002
7784,15055504,2023-02-08,22.97,85.32
6498,15055504,2023-02-11,-126.14,-40.81999999999999
6499,15055504,2023-02-11,-107.49,-148.31
165,15077298,2023-01-31,0.0,507.62
1233,15077298,2023-02-01,-81.02,426.6
1232,15077298,2023-02-01,-77.55,349.05
1234,15077298,2023-02-04,-150.76,198.29000000000002
5690,15077298,2023-02-04,75.48,273.77000000000004
1235,15077298,2023-02-07,-46.51,227.26000000000005
1236,15077298,2023-02-09,-56.29,170.97000000000003
5691,15077298,2023-02-09,88.16,259.13
5692,15077298,2023-02-11,124.08,383.21000000000004
166,15100785,2023-01-31,0.0,934.1
3337,15100785,2023-02-02,25.61,959.71
3338,15100785,2023-02-05,54.49,1014.2
6709,15100785,2023-02-06,-149.07,865.13
6708,15100785,2023-02-06,-114.3,750.83
3339,15100785,2023-02-07,166.29,917.12
3340,15100785,2023-02-09,1038.5,1955.62
6710,15100785,2023-02-11,-178.01,1777.6100000000001
3341,15100785,2023-02-12,128.81,1906.42
167,15163829,2023-01-31,0.0,458.6
5623,15163829,2023-02-04,120.19,578.79
7667,15163829,2023-02-07,-97.64,481.15000000000003
7668,15163829,2023-02-08,-141.03,340.12
7669,15163829,2023-02-12,-98.23,241.89000000000001
5624,15163829,2023-02-13,43.56,285.45000000000005
168,15258886,2023-01-31,0.0,689.34
1365,15258886,2023-02-01,-124.86,564.48
1366,15258886,2023-02-05,-155.76,408.72
1367,15258886,2023-02-08,-134.18,274.54
1368,15258886,2023-02-08,-103.03,171.51
8360,15258886,2023-02-10,47.01,218.52000000000004
8361,15258886,2023-02-11,1733.6,1952.12
1369,15258886,2023-02-12,-135.05,1817.0700000000002
1370,15258886,2023-02-13,-87.58,1729.4899999999998
169,15265650,2023-01-31,0.0,147.72
1350,15265650,2023-02-01,146.1,293.82
4128,15265650,2023-02-03,-81.73,212.08999999999997
4129,15265650,2023-02-04,-63.54,148.54999999999998
4130,15265650,2023-02-05,-98.03,50.51999999999998
4131,15265650,2023-02-08,-10.58,39.93999999999998
4132,15265650,2023-02-11,-105.66,-65.72
4133,15265650,2023-02-11,-100.86,-166.58
1351,15265650,2023-02-12,64.01,-102.57000000000002
4134,15265650,2023-02-13,-25.57,-128.14000000000001
4135,15265650,2023-02-14,-118.21,-246.35
170,15265700,2023-01-31,0.0,829.86
1169,15265700,2023-02-01,19.88,849.74
3736,15265700,2023-02-02,-83.44,766.3
1170,15265700,2023-02-02,77.04,843.34
3737,15265700,2023-02-08,-898.2,-54.860000000000014
1171,15265700,2023-02-12,91.07,36.20999999999992
171,15290238,2023-01-31,0.0,93.23
338,15290238,2023-02-01,83.96,177.19
5858,15290238,2023-02-04,-59.13,118.06
5859,15290238,2023-02-09,-119.77,-1.7099999999999937
5860,15290238,2023-02-13,-103.44,-105.14999999999999
172,15296624,2023-01-31,0.0,731.68
18,15296624,2023-02-01,-80.86,650.8199999999999
19,15296624,2023-02-01,-58.05,592.77
7189,15296624,2023-02-06,152.83,745.5999999999999
20,15296624,2023-02-09,-141.82,603.78
7190,15296624,2023-02-09,104.33,708.11
7191,15296624,2023-02-14,120.42,828.53
173,15324178,2023-01-31,0.0,833.62
6034,15324178,2023-02-05,91.78,925.4
7311,15324178,2023-02-07,-82.91,842.49
6035,15324178,2023-02-08,157.76,1000.25
7312,15324178,2023-02-09,-898.1,102.14999999999998
7313,15324178,2023-02-13,-134.6,-32.450000000000045
7314,15324178,2023-02-13,-96.04,-128.49
174,15334737,2023-01-31,0.0,197.12
299,15334737,2023-02-01,102.21,299.33
298,15334737,2023-02-01,115.14,414.47
5937,15334737,2023-02-04,-91.7,322.77
300,15334737,2023-02-04,91.69,414.46
5938,15334737,2023-02-06,-176.53,237.93
301,15334737,2023-02-07,63.12,301.05
302,15334737,2023-02-12,86.27,387.32
175,15377274,2023-01-31,0.0,902.14
5430,15377274,2023-02-04,-124.14,778.0
5431,15377274,2023-02-07,-56.42,721.5799999999999
7559,15377274,2023-02-07,150.1,871.68
7560,15377274,2023-02-12,102.73,974.41
7561,15377274,2023-02-14,135.14,1109.55
176,15428008,2023-01-31,0.0,131.02
7538,15428008,2023-02-07,-199.86,-68.84
7539,15428008,2023-02-09,-548.3,-617.14
7540,15428008,2023-02-12,-1077.3,-1694.44
7541,15428008,2023-02-13,-47.89,-1742.33
7542,15428008,2023-02-14,-161.91,-1904.2399999999998
177,15468532,2023-01-31,0.0,819.87
4624,15468532,2023-02-03,-141.04,678.83
4623,15468532,2023-02-03,-40.13,638.7
7973,15468532,2023-02-09,132.75,771.45
178,15522788,2023-01-31,0.0,154.26
194,15522788,2023-02-01,-101.62,52.639999999999986
3582,15522788,2023-02-02,117.73,170.37
3583,15522788,2023-02-04,81.01,251.38
3584,15522788,2023-02-04,109.65,361.03
195,15522788,2023-02-05,-23.13,337.9
196,15522788,2023-02-06,-99.27,238.63
3585,15522788,2023-02-08,66.05,304.68
179,15529292,2023-01-31,0.0,382.95
2102,15529292,2023-02-01,-117.6,265.35
6711,15529292,2023-02-06,76.0,341.35
6712,15529292,2023-02-12,154.74,496.09000000000003
180,15563919,2023-01-31,0.0,492.34
178,15563919,2023-02-01,-90.71,401.63
3091,15563919,2023-02-02,46.46,448.09
3092,15563919,2023-02-04,174.55,622.64
3093,15563919,2023-02-05,65.68,688.3199999999999
3094,15563919,2023-02-06,178.82,867.14
3095,15563919,2023-02-10,36.91,904.05
3096,15563919,2023-02-14,1083.0,1987.05
181,15665459,2023-01-31,0.0,68.94
3509,15665459,2023-02-02,-74.71,-5.769999999999996
4483,15665459,2023-02-03,534.6,528.83
4484,15665459,2023-02-05,67.95,596.78
4485,15665459,2023-02-07,161.73,758.51
3510,15665459,2023-02-13,-66.23,692.28
182,15668160,2023-01-31,0.0,810.02
6611,15668160,2023-02-05,179.02,989.04
8102,15668160,2023-02-09,-156.67,832.37
6612,15668160,2023-02-13,201.95,1034.32
183,15732629,2023-01-31,0.0,975.81
3212,15732629,2023-02-02,191.44,1167.25
5443,15732629,2023-02-04,-362.7,804.55
3213,15732629,2023-02-05,78.82,883.3699999999999
3214,15732629,2023-02-08,143.15,1026.52
3215,15732629,2023-02-08,144.78,1171.3
3216,15732629,2023-02-12,76.86,1248.1599999999999
5444,15732629,2023-02-13,-1393.1,-144.94000000000005
184,15768459,2023-01-31,0.0,997.4
2577,15768459,2023-02-02,-154.06,843.3399999999999
2578,15768459,2023-02-03,-44.0,799.3399999999999
7859,15768459,2023-02-08,118.54,917.88
7858,15768459,2023-02-08,120.35,1038.23
2579,15768459,2023-02-13,-131.61,906.62
7860,15768459,2023-02-13,139.76,1046.3799999999999
185,15779976,2023-01-31,0.0,129.01
4715,15779976,2023-02-03,-120.76,8.249999999999986
4716,15779976,2023-02-12,-127.27,-119.02000000000001
4718,15779976,2023-02-14,-128.39,-247.40999999999997
4717,15779976,2023-02-14,-100.83,-348.24
186,15793232,2023-01-31,0.0,45.88
2901,15793232,2023-02-02,-120.7,-74.82
6458,15793232,2023-02-05,1580.8,1505.98
6459,15793232,2023-02-12,57.42,1563.4
6460,15793232,2023-02-14,20.41,1583.81
187,15796180,2023-01-31,0.0,755.58
7569,15796180,2023-02-07,-113.23,642.35
7568,15796180,2023-02-07,-105.97,536.3800000000001
8224,15796180,2023-02-10,114.59,650.97
8225,15796180,2023-02-12,133.04,784.01
188,15801209,2023-01-31,0.0,8.84
1803,15801209,2023-02-01,-695.3,-686.4599999999999
1804,15801209,2023-02-05,-45.42,-731.8799999999999
7882,15801209,2023-02-08,126.03,-605.8499999999999
1805,15801209,2023-02-13,-80.6,-686.4499999999999
7884,15801209,2023-02-13,46.32,-640.1299999999999
7883,15801209,2023-02-13,134.72,-505.41
189,15805500,2023-01-31,0.0,230.39
2207,15805500,2023-02-02,170.79,401.17999999999995
7204,15805500,2023-02-06,-175.36,225.81999999999996
7205,15805500,2023-02-09,-71.12,154.69999999999996
190,15810455,2023-01-31,0.0,81.69
7107,15810455,2023-02-06,110.66,192.35
7109,15810455,2023-02-08,100.19,292.53999999999996
7108,15810455,2023-02-08,238.9,531.44
7110,15810455,2023-02-11,112.23,643.6700000000001
7111,15810455,2023-02-11,165.48,809.1500000000001
8553,15810455,2023-02-12,-145.1,664.05
7112,15810455,2023-02-13,80.87,744.9200000000001
191,15826579,2023-01-31,0.0,596.77
999,15826579,2023-02-01,-948.2,-351.43000000000006
8149,15826579,2023-02-09,255.62,-95.81000000000006
1000,15826579,2023-02-10,-1662.6,-1758.4099999999999
8150,15826579,2023-02-11,1137.9,-620.5099999999998
8151,15826579,2023-02-13,128.09,-492.41999999999985
192,15830962,2023-01-31,0.0,570.89
3830,15830962,2023-02-03,50.42,621.31
3831,15830962,2023-02-07,65.97,687.28
8308,15830962,2023-02-10,-97.09,590.1899999999999
193,15841031,2023-01-31,0.0,579.98
6667,15841031,2023-02-05,-61.09,518.89
7798,15841031,2023-02-08,124.32,643.21
7799,15841031,2023-02-14,133.19,776.4
194,15899774,2023-01-31,0.0,773.38
7187,15899774,2023-02-06,151.33,924.71
7188,15899774,2023-02-08,1382.5,2307.21
8203,15899774,2023-02-09,-64.55,2242.66
195,15914466,2023-01-31,0.0,436.62
7952,15914466,2023-02-08,157.06,593.6800000000001
8119,15914466,2023-02-09,-1208.0,-614.32
8120,15914466,2023-02-09,-109.67,-723.9900000000001
8121,15914466,2023-02-11,-125.01,-849.0000000000001
196,15918861,2023-01-31,0.0,781.97
4105,15918861,2023-02-03,122.97,904.94
5397,15918861,2023-02-04,-22.38,882.5600000000001
5398,15918861,2023-02-09,-103.16,779.4000000000001
4106,15918861,2023-02-14,125.82,905.22
197,15922706,2023-01-31,0.0,478.87
2467,15922706,2023-02-02,150.2,629.0699999999999
4991,15922706,2023-02-04,-44.55,584.52
2468,15922706,2023-02-04,104.07,688.5899999999999
4992,15922706,2023-02-06,-124.41,564.18
2469,15922706,2023-02-06,64.62,628.8
2470,15922706,2023-02-06,77.22,706.02
2471,15922706,2023-02-08,80.77,786.79
2472,15922706,2023-02-09,88.92,875.71
2473,15922706,2023-02-11,1370.2,2245.91
2474,15922706,2023-02-14,29.41,2275.32
198,15944303,2023-01-31,0.0,977.44
6128,15944303,2023-02-05,-108.31,869.1300000000001
6129,15944303,2023-02-06,-100.18,768.95
8140,15944303,2023-02-09,181.01,949.96
8141,15944303,2023-02-12,1267.9,2217.86
8142,15944303,2023-02-13,107.16,2325.0200000000004
199,15960008,2023-01-31,0.0,455.42
7482,15960008,2023-02-07,-132.81,322.61
7483,15960008,2023-02-10,-43.52,279.09000000000003
7484,15960008,2023-02-13,-47.03,232.06
200,15980710,2023-01-31,0.0,955.7
4463,15980710,2023-02-03,158.58,1114.28
4464,15980710,2023-02-04,97.86,1212.14
8415,15980710,2023-02-11,-58.0,1154.14
4465,15980710,2023-02-13,134.36,1288.5
4466,15980710,2023-02-14,79.89,1368.39
201,16013218,2023-01-31,0.0,322.63
2375,16013218,2023-02-02,83.89,406.52
6977,16013218,2023-02-06,-111.41,295.11
2376,16013218,2023-02-06,1436.4,1731.5100000000002
6978,16013218,2023-02-10,-77.1,1654.4100000000003
2377,16013218,2023-02-10,26.43,1680.8400000000001
6979,16013218,2023-02-12,-228.38,1452.46
2378,16013218,2023-02-12,115.11,1567.5700000000002
202,16026987,2023-01-31,0.0,772.57
3382,16026987,2023-02-02,-96.85,675.72
4329,16026987,2023-02-03,56.34,732.0600000000001
4330,16026987,2023-02-07,101.07,833.1300000000001
4331,16026987,2023-02-08,95.14,928.27
4332,16026987,2023-02-13,1678.8,2607.07
203,16030234,2023-01-31,0.0,174.55
402,16030234,2023-02-01,-189.32,-14.769999999999982
403,16030234,2023-02-01,-92.81,-107.57999999999998
404,16030234,2023-02-06,-170.43,-278.01
7904,16030234,2023-02-08,129.99,-148.01999999999998
405,16030234,2023-02-09,-97.62,-245.64
406,16030234,2023-02-10,-86.54,-332.18
407,16030234,2023-02-12,-80.58,-412.75999999999993
204,16063411,2023-01-31,0.0,896.73
8638,16063411,2023-02-13,-77.8,818.9300000000001
8665,16063411,2023-02-14,17.11,836.04
8666,16063411,2023-02-14,128.86,964.9000000000001
205,16067516,2023-01-31,0.0,494.33
7090,16067516,2023-02-06,-646.5,-152.17000000000002
7091,16067516,2023-02-08,-1044.7,-1196.8700000000001
8543,16067516,2023-02-12,168.73,-1028.14
206,16087504,2023-01-31,0.0,56.65
407,16087504,2023-02-01,144.25,200.9
408,16087504,2023-02-03,147.01,347.90999999999997
8546,16087504,2023-02-12,-895.2,-547.2900000000001
409,16087504,2023-02-13,18.85,-528.44
8547,16087504,2023-02-14,-93.61,-622.0500000000001
207,16093178,2023-01-31,0.0,96.62
2790,16093178,2023-02-02,-136.28,-39.66
4410,16093178,2023-02-03,114.47,74.81
4411,16093178,2023-02-05,57.87,132.68
2791,16093178,2023-02-11,-159.21,-26.53
4412,16093178,2023-02-11,87.08,60.55
2792,16093178,2023-02-13,-118.36,-57.81
208,16118153,2023-01-31,0.0,829.58
3876,16118153,2023-02-03,173.01,1002.59
6310,16118153,2023-02-05,-49.78,952.8100000000001
6311,16118153,2023-02-05,-45.9,906.9100000000001
3878,16118153,2023-02-09,113.36,1020.27
3877,16118153,2023-02-09,125.98,1146.25
6312,16118153,2023-02-10,-59.44,1086.81
3879,16118153,2023-02-13,1827.6,2914.41
209,16124993,2023-01-31,0.0,148.14
5974,16124993,2023-02-05,25.75,173.89
6751,16124993,2023-02-06,-97.34,76.54999999999998
5975,16124993,2023-02-06,46.33,122.87999999999998
6752,16124993,2023-02-08,-167.59,-44.710000000000036
5976,16124993,2023-02-08,1668.5,1623.79
5977,16124993,2023-02-11,124.32,1748.1100000000001
5978,16124993,2023-02-11,245.04,1993.15
6753,16124993,2023-02-12,-643.6,1349.5500000000002
6754,16124993,2023-02-14,-143.07,1206.48
6755,16124993,2023-02-14,-104.78,1101.7
210,16152779,2023-01-31,0.0,65.09
898,16152779,2023-02-01,96.26,161.35000000000002
897,16152779,2023-02-01,131.11,292.46000000000004
2836,16152779,2023-02-02,-135.95,156.51000000000002
899,16152779,2023-02-04,173.9,330.4100000000001
2837,16152779,2023-02-12,-117.51,212.9
211,16157014,2023-01-31,0.0,858.73
784,16157014,2023-02-01,99.09,957.82
4766,16157014,2023-02-03,-76.11,881.71
785,16157014,2023-02-08,103.69,985.4
786,16157014,2023-02-11,58.0,1043.4
4767,16157014,2023-02-13,-111.36,932.04
212,16181964,2023-01-31,0.0,979.44
449,16181964,2023-02-01,-49.69,929.75
450,16181964,2023-02-03,-121.15,808.6
7221,16181964,2023-02-06,59.73,868.33
451,16181964,2023-02-07,-80.36,787.97
452,16181964,2023-02-13,-763.2,24.769999999999982
213,16191280,2023-01-31,0.0,825.86
3508,16191280,2023-02-02,666.0,1491.8600000000001
3509,16191280,2023-02-03,21.47,1513.33
3510,16191280,2023-02-07,113.55,1626.88
3511,16191280,2023-02-08,138.88,1765.76
3512,16191280,2023-02-09,69.51,1835.27
8339,16191280,2023-02-10,-121.81,1713.46
3513,16191280,2023-02-12,86.65,1800.1100000000001
8340,16191280,2023-02-13,-77.77,1722.3400000000001
3514,16191280,2023-02-14,173.04,1895.38
214,16223952,2023-01-31,0.0,222.18
4154,16223952,2023-02-03,197.64,419.82
4155,16223952,2023-02-05,1174.8,1594.6200000000001
4156,16223952,2023-02-08,83.5,1678.12
4157,16223952,2023-02-09,168.19,1846.31
8500,16223952,2023-02-11,-94.59,1751.7199999999998
215,16229373,2023-01-31,0.0,256.89
2122,16229373,2023-02-01,-96.26,160.63
2123,16229373,2023-02-03,-1131.6,-970.9699999999999
6124,16229373,2023-02-05,161.01,-809.9599999999999
6125,16229373,2023-02-09,127.53,-682.43
2124,16229373,2023-02-13,-153.16,-835.59
6126,16229373,2023-02-13,83.84,-751.7499999999999
216,16270746,2023-01-31,0.0,904.31
1347,16270746,2023-02-01,49.84,954.15
1348,16270746,2023-02-07,227.16,1181.31
1349,16270746,2023-02-14,110.13,1291.44
217,16306280,2023-01-31,0.0,921.83
5680,16306280,2023-02-04,139.51,1061.3400000000001
5681,16306280,2023-02-06,136.49,1197.83
5682,16306280,2023-02-08,70.15,1267.98
5683,16306280,2023-02-13,79.84,1347.8200000000002
5684,16306280,2023-02-14,143.03,1490.85
218,16312979,2023-01-31,0.0,833.92
3169,16312979,2023-02-02,-57.84,776.0799999999999
6563,16312979,2023-02-05,47.51,823.5899999999999
6564,16312979,2023-02-06,155.04,978.6299999999999
3170,16312979,2023-02-07,-100.4,878.2299999999999
6565,16312979,2023-02-08,2113.3,2991.53
219,16334793,2023-01-31,0.0,297.75
3377,16334793,2023-02-02,-126.12,171.63
3378,16334793,2023-02-08,-77.8,93.82999999999998
3379,16334793,2023-02-09,-88.92,4.909999999999968
3380,16334793,2023-02-11,-1991.3,-1986.3899999999999
3381,16334793,2023-02-12,-81.87,-2068.26
220,16453812,2023-01-31,0.0,356.9
5676,16453812,2023-02-04,63.26,420.15999999999997
5677,16453812,2023-02-09,146.33,566.49
8591,16453812,2023-02-13,-159.89,406.6
8592,16453812,2023-02-14,-47.25,359.35
221,16506904,2023-01-31,0.0,602.17
1937,16506904,2023-02-01,-106.68,495.48999999999995
4935,16506904,2023-02-03,125.04,620.53
1938,16506904,2023-02-06,-22.66,597.87
1939,16506904,2023-02-07,-134.11,463.75999999999993
1940,16506904,2023-02-09,-164.72,299.03999999999996
4936,16506904,2023-02-12,77.47,376.50999999999993
1941,16506904,2023-02-13,-53.69,322.81999999999994
1942,16506904,2023-02-14,-278.4,44.41999999999996
222,16584745,2023-01-31,0.0,129.46
304,16584745,2023-02-01,-136.51,-7.049999999999983
5246,16584745,2023-02-04,109.21,102.16000000000001
305,16584745,2023-02-05,-62.34,39.82000000000001
306,16584745,2023-02-06,-76.04,-36.22
307,16584745,2023-02-09,-912.8,-949.02
5247,16584745,2023-02-10,55.02,-894.0
308,16584745,2023-02-11,-184.5,-1078.5
5248,16584745,2023-02-12,170.0,-908.5
309,16584745,2023-02-13,-111.37,-1019.8699999999999
223,16628269,2023-01-31,0.0,27.11
5024,16628269,2023-02-04,-53.03,-25.92
5147,16628269,2023-02-04,155.79,129.87
5148,16628269,2023-02-05,55.52,185.39
5149,16628269,2023-02-05,88.27,273.65999999999997
5025,16628269,2023-02-11,-79.06,194.59999999999997
5150,16628269,2023-02-12,151.34,345.94
5151,16628269,2023-02-13,41.75,387.69
224,16633794,2023-01-31,0.0,263.05
3673,16633794,2023-02-02,75.84,338.89
3674,16633794,2023-02-08,113.42,452.31
3675,16633794,2023-02-09,89.39,541.7
3676,16633794,2023-02-10,86.39,628.09
3677,16633794,2023-02-13,61.69,689.78
225,16676577,2023-01-31,0.0,407.24
1211,16676577,2023-02-01,77.41,484.65
5145,16676577,2023-02-04,-77.7,406.95
5146,16676577,2023-02-06,-1436.4,-1029.45
5147,16676577,2023-02-09,-105.57,-1135.02
5148,16676577,2023-02-10,-103.59,-1238.6100000000001
226,16927652,2023-01-31,0.0,637.58
678,16927652,2023-02-01,-14.22,623.36
5429,16927652,2023-02-04,153.96,777.32
5430,16927652,2023-02-05,122.62,899.94
227,16977372,2023-01-31,0.0,675.5
1703,16977372,2023-02-01,-181.11,494.39
7731,16977372,2023-02-08,195.9,690.29
1704,16977372,2023-02-10,-89.47,600.8199999999999
7732,16977372,2023-02-14,302.9,903.72
228,16984772,2023-01-31,0.0,823.43
2894,16984772,2023-02-02,1351.2,2174.63
5995,16984772,2023-02-05,-179.34,1995.29
5993,16984772,2023-02-05,-113.3,1881.9899999999998
5994,16984772,2023-02-05,-76.23,1805.76
5996,16984772,2023-02-07,-93.07,1712.69
2896,16984772,2023-02-07,62.17,1774.8600000000001
2895,16984772,2023-02-07,151.91,1926.77
5997,16984772,2023-02-08,-209.9,1716.87
5998,16984772,2023-02-10,-93.29,1623.58
229,17024652,2023-01-31,0.0,918.84
3128,17024652,2023-02-02,101.39,1020.23
3129,17024652,2023-02-07,11.35,1031.58
3130,17024652,2023-02-09,1558.7,2590.28
3131,17024652,2023-02-13,30.37,2620.65
230,17039422,2023-01-31,0.0,941.44
3313,17039422,2023-02-02,124.23,1065.67
4066,17039422,2023-02-03,-208.56,857.11
4065,17039422,2023-02-03,-199.09,658.02
4067,17039422,2023-02-06,-1053.5,-395.48
231,17051223,2023-01-31,0.0,558.16
7860,17051223,2023-02-08,-61.41,496.75
7802,17051223,2023-02-08,125.79,622.54
232,17085651,2023-01-31,0.0,945.51
6616,17085651,2023-02-05,119.48,1064.99
7867,17085651,2023-02-08,-81.34,983.65
7869,17085651,2023-02-11,-1635.6,-651.9499999999998
7868,17085651,2023-02-11,-1168.2,-1820.1499999999999
7870,17085651,2023-02-12,-159.82,-1979.97
7871,17085651,2023-02-14,-1583.4,-3563.37
233,17138963,2023-01-31,0.0,131.95
1969,17138963,2023-02-01,-1500.7,-1368.75
6452,17138963,2023-02-05,110.72,-1258.03
6453,17138963,2023-02-06,58.79,-1199.24
1970,17138963,2023-02-08,-35.48,-1234.72
6454,17138963,2023-02-14,63.85,-1170.87
234,17144855,2023-01-31,0.0,355.14
638,17144855,2023-02-01,112.98,468.12
637,17144855,2023-02-01,182.36,650.48
2238,17144855,2023-02-02,-96.07,554.4100000000001
2237,17144855,2023-02-02,-51.28,503.13
639,17144855,2023-02-03,51.41,554.54
640,17144855,2023-02-04,129.7,684.24
2239,17144855,2023-02-06,-104.58,579.6600000000001
2240,17144855,2023-02-09,-140.26,439.40000000000003
2242,17144855,2023-02-13,-165.67,273.73
2241,17144855,2023-02-13,-59.04,214.69000000000005
235,17191420,2023-01-31,0.0,717.28
457,17191420,2023-02-01,130.78,848.06
2547,17191420,2023-02-02,-98.15,749.91
458,17191420,2023-02-14,118.21,868.1199999999999
236,17228160,2023-01-31,0.0,567.87
1078,17228160,2023-02-01,-780.9,-213.02999999999997
1077,17228160,2023-02-01,-105.61,-318.64
1079,17228160,2023-02-02,-54.57,-373.2099999999999
2907,17228160,2023-02-02,1556.9,1183.69
2908,17228160,2023-02-05,123.79,1307.48
2909,17228160,2023-02-05,179.42,1486.9
1080,17228160,2023-02-08,-35.2,1451.7000000000003
1081,17228160,2023-02-10,-190.65,1261.0500000000002
1082,17228160,2023-02-11,-200.58,1060.4700000000003
237,17264146,2023-01-31,0.0,345.33
7488,17264146,2023-02-07,171.45,516.78
8250,17264146,2023-02-10,-38.88,477.9
8251,17264146,2023-02-11,-151.65,326.25
8252,17264146,2023-02-12,-76.94,249.30999999999997
8253,17264146,2023-02-14,-163.39,85.92000000000002
7489,17264146,2023-02-14,58.68,144.6
238,17284705,2023-01-31,0.0,145.59
1280,17284705,2023-02-01,-81.56,64.03
1281,17284705,2023-02-03,-138.68,-74.65
1282,17284705,2023-02-04,-66.05,-140.70000000000002
1283,17284705,2023-02-10,-47.4,-188.1
8478,17284705,2023-02-11,62.52,-125.58000000000001
8477,17284705,2023-02-11,157.96,32.380000000000024
8479,17284705,2023-02-13,12.26,44.64000000000003
239,17301178,2023-01-31,0.0,311.47
2435,17301178,2023-02-02,-120.32,191.15000000000003
4787,17301178,2023-02-03,152.95,344.1
2436,17301178,2023-02-07,-1147.4,-803.3
4788,17301178,2023-02-07,106.77,-696.53
4789,17301178,2023-02-08,55.71,-640.8199999999999
2437,17301178,2023-02-10,-24.85,-665.67
2438,17301178,2023-02-13,-127.43,-793.0999999999999
240,17434670,2023-01-31,0.0,148.92
5233,17434670,2023-02-04,-99.5,49.41999999999999
6282,17434670,2023-02-05,44.51,93.92999999999998
5234,17434670,2023-02-07,-48.65,45.27999999999999
6283,17434670,2023-02-07,80.47,125.74999999999999
6284,17434670,2023-02-07,169.25,295.0
5235,17434670,2023-02-10,-737.2,-442.20000000000016
5236,17434670,2023-02-10,-705.9,-1148.1
6285,17434670,2023-02-11,215.83,-932.2700000000001
6286,17434670,2023-02-12,43.72,-888.5500000000001
6287,17434670,2023-02-12,139.56,-748.9900000000001
6288,17434670,2023-02-14,106.21,-642.7800000000001
241,17469776,2023-01-31,0.0,443.18
6220,17469776,2023-02-05,-94.95,348.23
5914,17469776,2023-02-05,89.23,437.46000000000004
5915,17469776,2023-02-07,60.73,498.19
6221,17469776,2023-02-08,-61.39,436.8
5916,17469776,2023-02-12,76.6,513.4
242,17483941,2023-01-31,0.0,483.81
1362,17483941,2023-02-01,-164.06,319.75
1363,17483941,2023-02-01,-110.45,209.3
142,17483941,2023-02-01,48.78,258.08
143,17483941,2023-02-02,102.4,360.48
145,17483941,2023-02-03,76.66,437.14
144,17483941,2023-02-03,120.86,558.0
1364,17483941,2023-02-05,-161.01,396.99
146,17483941,2023-02-08,145.66,542.65
147,17483941,2023-02-11,9.21,551.86
243,17533114,2023-01-31,0.0,274.53
6423,17533114,2023-02-05,-94.53,179.99999999999997
6424,17533114,2023-02-07,-35.98,144.01999999999998
7870,17533114,2023-02-08,105.32,249.33999999999997
6425,17533114,2023-02-13,-123.27,126.07
6426,17533114,2023-02-14,-133.43,-7.360000000000014
244,17534364,2023-01-31,0.0,758.41
6362,17534364,2023-02-05,-120.48,637.93
7769,17534364,2023-02-08,42.56,680.49
6363,17534364,2023-02-10,-153.84,526.65
7770,17534364,2023-02-11,102.43,629.0799999999999
6364,17534364,2023-02-14,-59.8,569.28
245,17543122,2023-01-31,0.0,681.64
5448,17543122,2023-02-04,-48.4,633.24
5450,17543122,2023-02-05,-193.92,439.32
5451,17543122,2023-02-05,-135.04,304.28
5449,17543122,2023-02-05,-37.98,266.3
5452,17543122,2023-02-06,-19.45,246.85000000000002
7846,17543122,2023-02-08,118.77,365.62
5453,17543122,2023-02-10,-149.61,216.01
7847,17543122,2023-02-13,183.79,399.79999999999995
246,17644586,2023-01-31,0.0,222.45
1844,17644586,2023-02-01,-148.34,74.10999999999999
1139,17644586,2023-02-01,92.85,166.95999999999998
1845,17644586,2023-02-02,-122.21,44.75
1140,17644586,2023-02-03,146.39,191.14
1141,17644586,2023-02-04,109.76,300.9
1142,17644586,2023-02-09,50.02,350.91999999999996
1143,17644586,2023-02-11,125.33,476.25
1144,17644586,2023-02-13,110.34,586.5899999999999
247,17648252,2023-01-31,0.0,75.02
712,17648252,2023-02-01,-570.3,-495.28
1375,17648252,2023-02-01,646.2,150.92000000000007
713,17648252,2023-02-05,-18.13,132.79000000000008
1376,17648252,2023-02-05,124.83,257.62000000000006
714,17648252,2023-02-06,-84.46,173.16000000000008
1377,17648252,2023-02-06,95.31,268.4700000000001
1378,17648252,2023-02-13,132.3,400.7700000000001
1379,17648252,2023-02-14,553.6,954.3700000000001
248,17669623,2023-01-31,0.0,163.19
6499,17669623,2023-02-05,142.97,306.15999999999997
6500,17669623,2023-02-07,171.17,477.33
8192,17669623,2023-02-09,-125.94,351.39
8193,17669623,2023-02-14,-64.22,287.16999999999996
6501,17669623,2023-02-14,106.34,393.51
249,17692892,2023-01-31,0.0,457.79
4342,17692892,2023-02-03,-88.94,368.85
4790,17692892,2023-02-03,22.26,391.11
4343,17692892,2023-02-06,-45.55,345.56000000000006
4791,17692892,2023-02-09,174.92,520.48
250,17722231,2023-01-31,0.0,944.22
351,17722231,2023-02-01,-67.01,877.21
3644,17722231,2023-02-02,22.39,899.6
352,17722231,2023-02-06,-462.2,437.40000000000003
3645,17722231,2023-02-09,105.04,542.44
251,17749893,2023-01-31,0.0,889.45
1569,17749893,2023-02-01,-143.83,745.62
1942,17749893,2023-02-01,176.41,922.03
1570,17749893,2023-02-07,-211.2,710.83
1572,17749893,2023-02-12,-1267.9,-557.0699999999999
1571,17749893,2023-02-12,-28.42,-585.49
1573,17749893,2023-02-13,-88.79,-674.28
1943,17749893,2023-02-13,90.8,-583.48
252,17810734,2023-01-31,0.0,348.22
8217,17810734,2023-02-09,-138.8,209.42000000000002
253,17840180,2023-01-31,0.0,557.56
1855,17840180,2023-02-01,0.96,558.52
1856,17840180,2023-02-04,124.14,682.66
8648,17840180,2023-02-14,-81.15,601.51
254,17868317,2023-01-31,0.0,706.58
1901,17868317,2023-02-01,-172.78,533.8000000000001
1902,17868317,2023-02-07,-52.36,481.44000000000005
8173,17868317,2023-02-09,72.19,553.6300000000001
8174,17868317,2023-02-13,124.33,677.96
8175,17868317,2023-02-14,110.14,788.1
255,17881363,2023-01-31,0.0,415.27
3269,17881363,2023-02-02,-46.77,368.5
3270,17881363,2023-02-03,-64.03,304.46999999999997
5392,17881363,2023-02-04,22.38,326.84999999999997
5393,17881363,2023-02-05,125.17,452.02
3271,17881363,2023-02-13,-817.7,-365.68000000000006
256,17925406,2023-01-31,0.0,393.37
2563,17925406,2023-02-02,160.62,553.99
3919,17925406,2023-02-03,-51.41,502.58000000000004
3920,17925406,2023-02-06,-81.99,420.59000000000003
2564,17925406,2023-02-06,109.52,530.11
2565,17925406,2023-02-08,87.59,617.7
3921,17925406,2023-02-10,-74.72,542.98
2566,17925406,2023-02-13,112.38,655.36
2567,17925406,2023-02-14,116.9,772.26
257,17933377,2023-01-31,0.0,189.05
2544,17933377,2023-02-02,95.27,284.32
2546,17933377,2023-02-07,24.33,308.65
2545,17933377,2023-02-07,145.52,454.17
7856,17933377,2023-02-08,-109.29,344.88
258,17938672,2023-01-31,0.0,904.99
686,17938672,2023-02-01,102.95,1007.94
2976,17938672,2023-02-02,-93.88,914.0600000000001
2977,17938672,2023-02-07,-46.29,867.77
687,17938672,2023-02-08,39.85,907.62
688,17938672,2023-02-11,77.84,985.46
689,17938672,2023-02-11,129.67,1115.13
259,17939571,2023-01-31,0.0,396.93
3432,17939571,2023-02-02,68.63,465.56
7630,17939571,2023-02-07,-53.14,412.42
3434,17939571,2023-02-07,108.09,520.51
3433,17939571,2023-02-07,149.48,669.99
7631,17939571,2023-02-09,-43.87,626.12
3437,17939571,2023-02-12,50.65,676.77
3436,17939571,2023-02-12,77.02,753.79
3435,17939571,2023-02-12,78.98,832.77
260,17983851,2023-01-31,0.0,849.24
136,17983851,2023-02-01,160.4,1009.64
138,17983851,2023-02-02,200.43,1210.0700000000002
137,17983851,2023-02-02,794.9,2004.97
5867,17983851,2023-02-04,-26.48,1978.49
5868,17983851,2023-02-06,-154.69,1823.8000000000002
139,17983851,2023-02-07,99.73,1923.53
5869,17983851,2023-02-09,-67.11,1856.42
5870,17983851,2023-02-12,-76.82,1779.6
141,17983851,2023-02-12,37.05,1816.65
140,17983851,2023-02-12,89.62,1906.27
261,18046225,2023-01-31,0.0,205.83
4148,18046225,2023-02-03,-96.51,109.32000000000001
7630,18046225,2023-02-07,151.4,260.72
7631,18046225,2023-02-10,63.32,324.04
262,18052851,2023-01-31,0.0,672.09
3346,18052851,2023-02-02,-177.51,494.58000000000004
3347,18052851,2023-02-08,-115.63,378.95000000000005
8652,18052851,2023-02-13,48.19,427.14000000000004
8653,18052851,2023-02-14,159.03,586.1700000000001
263,18095448,2023-01-31,0.0,73.28
3868,18095448,2023-02-03,-164.36,-91.08000000000001
4997,18095448,2023-02-03,159.69,68.60999999999999
4998,18095448,2023-02-05,92.4,161.01
4999,18095448,2023-02-12,16.68,177.69
5000,18095448,2023-02-12,797.7,975.39
264,18133554,2023-01-31,0.0,733.1
2221,18133554,2023-02-02,-114.29,618.8100000000001
2222,18133554,2023-02-03,-168.82,449.99
6699,18133554,2023-02-06,100.05,550.04
6700,18133554,2023-02-06,676.7,1226.74
6702,18133554,2023-02-07,109.2,1335.94
6701,18133554,2023-02-07,207.86,1543.8000000000002
6703,18133554,2023-02-07,1277.4,2821.2000000000003
6705,18133554,2023-02-09,118.62,2939.82
6704,18133554,2023-02-09,176.85,3116.67
2223,18133554,2023-02-10,-75.3,3041.37
6707,18133554,2023-02-11,107.81,3149.18
6706,18133554,2023-02-11,1104.0,4253.18
2224,18133554,2023-02-14,-18.54,4234.64
265,18179400,2023-01-31,0.0,768.78
4034,18179400,2023-02-03,18.62,787.4
6914,18179400,2023-02-06,-131.6,655.8
6915,18179400,2023-02-08,-197.96,457.84
4035,18179400,2023-02-11,560.2,1018.04
266,18185362,2023-01-31,0.0,609.36
2489,18185362,2023-02-02,-117.9,491.46000000000004
5678,18185362,2023-02-04,124.08,615.54
2490,18185362,2023-02-11,-10.99,604.55
2491,18185362,2023-02-12,-1955.6,-1351.0499999999997
5679,18185362,2023-02-14,91.78,-1259.27
267,18198770,2023-01-31,0.0,108.23
3156,18198770,2023-02-02,76.14,184.37
3157,18198770,2023-02-04,146.89,331.26
8674,18198770,2023-02-14,-44.96,286.29999999999995
268,18305932,2023-01-31,0.0,834.42
7721,18305932,2023-02-08,-129.7,704.72
7722,18305932,2023-02-11,-120.95,583.77
7723,18305932,2023-02-14,-18.23,565.54
8672,18305932,2023-02-14,79.12,644.66
269,18308848,2023-01-31,0.0,570.65
7437,18308848,2023-02-07,147.36,718.01
8665,18308848,2023-02-14,-27.68,690.3299999999999
270,18346988,2023-01-31,0.0,450.36
2875,18346988,2023-02-02,-131.15,319.21000000000004
2876,18346988,2023-02-03,-36.94,282.27
2877,18346988,2023-02-04,-436.5,-154.23000000000002
2878,18346988,2023-02-07,-856.5,-1010.7300000000001
2879,18346988,2023-02-14,-73.19,-1083.92
271,18348734,2023-01-31,0.0,579.93
1776,18348734,2023-02-01,-147.58,432.3499999999999
1777,18348734,2023-02-02,-950.2,-517.85
1779,18348734,2023-02-06,-152.83,-670.6800000000002
1778,18348734,2023-02-06,-111.94,-782.6200000000002
1780,18348734,2023-02-07,-211.77,-994.3900000000002
1783,18348734,2023-02-08,-1032.4,-2026.7900000000004
1782,18348734,2023-02-08,-68.73,-2095.5200000000004
1781,18348734,2023-02-08,-56.83,-2152.3500000000004
1784,18348734,2023-02-09,-76.46,-2228.8100000000004
8155,18348734,2023-02-09,1045.1,-1183.7100000000005
1785,18348734,2023-02-11,-1669.7,-2853.4100000000003
8156,18348734,2023-02-11,148.74,-2704.6700000000005
1786,18348734,2023-02-13,-98.15,-2802.8200000000006
8157,18348734,2023-02-14,2010.0,-792.8200000000005
272,18447548,2023-01-31,0.0,574.24
1493,18447548,2023-02-01,99.41,673.65
7996,18447548,2023-02-08,-180.39,493.26
7997,18447548,2023-02-10,-88.61,404.65000000000003
1494,18447548,2023-02-10,133.0,537.6500000000001
1495,18447548,2023-02-12,44.09,581.74
7998,18447548,2023-02-13,-1370.8,-789.06
7999,18447548,2023-02-13,-104.27,-893.3299999999999
1496,18447548,2023-02-13,75.56,-817.77
8000,18447548,2023-02-14,-101.91,-919.6799999999998
273,18451683,2023-01-31,0.0,501.75
4012,18451683,2023-02-03,102.01,603.76
4011,18451683,2023-02-03,157.43,761.19
6600,18451683,2023-02-05,-103.38,657.81
4013,18451683,2023-02-05,112.34,770.15
6601,18451683,2023-02-06,-159.49,610.66
6602,18451683,2023-02-06,-56.08,554.58
4014,18451683,2023-02-10,143.3,697.88
6603,18451683,2023-02-11,-65.22,632.66
6604,18451683,2023-02-12,-985.9,-353.24
4015,18451683,2023-02-13,62.08,-291.15999999999997
274,18517970,2023-01-31,0.0,709.95
3112,18517970,2023-02-02,142.95,852.9000000000001
4742,18517970,2023-02-03,-510.1,342.8
3113,18517970,2023-02-04,127.73,470.53000000000003
4743,18517970,2023-02-08,-31.2,439.33000000000004
3114,18517970,2023-02-09,54.57,493.90000000000003
3115,18517970,2023-02-10,95.98,589.88
4744,18517970,2023-02-12,-92.12,497.76
4745,18517970,2023-02-14,-91.78,405.98
275,18563743,2023-01-31,0.0,649.46
5284,18563743,2023-02-04,34.82,684.2800000000001
7486,18563743,2023-02-07,-124.7,559.58
7487,18563743,2023-02-09,-36.49,523.09
5285,18563743,2023-02-11,137.26,660.35
7488,18563743,2023-02-12,-102.95,557.4
7489,18563743,2023-02-12,-58.63,498.77
276,18582171,2023-01-31,0.0,732.99
4705,18582171,2023-02-03,-109.86,623.13
5991,18582171,2023-02-05,122.01,745.14
5992,18582171,2023-02-06,105.34,850.48
5993,18582171,2023-02-09,136.48,986.96
4706,18582171,2023-02-11,-147.31,839.65
5994,18582171,2023-02-11,72.82,912.47
5995,18582171,2023-02-13,123.86,1036.33
4707,18582171,2023-02-14,-85.38,950.95
5996,18582171,2023-02-14,45.9,996.85
277,18584434,2023-01-31,0.0,877.81
2570,18584434,2023-02-02,-103.88,773.93
2571,18584434,2023-02-03,-94.83,679.0999999999999
2572,18584434,2023-02-05,-122.62,556.48
6188,18584434,2023-02-05,78.62,635.0999999999999
2573,18584434,2023-02-08,-96.34,538.76
278,18645136,2023-01-31,0.0,554.87
1558,18645136,2023-02-01,120.09,674.96
1559,18645136,2023-02-03,111.0,785.96
1560,18645136,2023-02-04,199.43,985.39
6239,18645136,2023-02-05,-2.25,983.14
1561,18645136,2023-02-13,61.15,1044.29
6240,18645136,2023-02-14,-116.52,927.77
279,18685463,2023-01-31,0.0,476.02
8111,18685463,2023-02-09,-37.65,438.37
8203,18685463,2023-02-10,73.39,511.76
8205,18685463,2023-02-14,80.0,591.76
8204,18685463,2023-02-14,118.69,710.45
280,18718399,2023-01-31,0.0,716.22
5040,18718399,2023-02-04,119.96,836.1800000000001
5041,18718399,2023-02-06,374.5,1210.68
5042,18718399,2023-02-10,1800.7,3011.38
281,18850031,2023-01-31,0.0,191.3
3730,18850031,2023-02-03,100.99,292.29
3731,18850031,2023-02-05,120.48,412.77
3732,18850031,2023-02-05,181.42,594.19
7413,18850031,2023-02-07,-171.4,422.78999999999996
7414,18850031,2023-02-11,-34.52,388.27
3733,18850031,2023-02-11,172.5,560.77
3734,18850031,2023-02-13,105.74,666.51
282,18859451,2023-01-31,0.0,441.04
3487,18859451,2023-02-02,-469.3,-28.25999999999999
3488,18859451,2023-02-06,-102.2,-130.45999999999998
7104,18859451,2023-02-06,110.47,-19.99000000000001
7105,18859451,2023-02-13,46.16,26.170000000000016
7106,18859451,2023-02-14,92.17,118.33999999999997
283,18899132,2023-01-31,0.0,244.46
6023,18899132,2023-02-05,-69.58,174.88
6716,18899132,2023-02-06,97.34,272.22
6024,18899132,2023-02-08,-63.18,209.04000000000002
284,18928638,2023-01-31,0.0,150.95
2720,18928638,2023-02-02,-192.77,-41.82000000000002
2721,18928638,2023-02-02,-162.41,-204.23000000000002
2722,18928638,2023-02-10,-184.75,-388.9800000000001
285,19001745,2023-01-31,0.0,507.55
4687,19001745,2023-02-03,76.42,583.97
4688,19001745,2023-02-04,55.54,639.51
4690,19001745,2023-02-10,99.66,739.1700000000001
4689,19001745,2023-02-10,344.3,1083.47
8485,19001745,2023-02-11,-173.15,910.3199999999999
8486,19001745,2023-02-13,-82.89,827.4300000000001
8487,19001745,2023-02-14,-181.24,646.19
4691,19001745,2023-02-14,102.06,748.25
286,19094015,2023-01-31,0.0,548.65
1307,19094015,2023-02-01,74.43,623.0799999999999
3314,19094015,2023-02-02,-224.1,398.98
3316,19094015,2023-02-06,-1695.0,-1296.02
3315,19094015,2023-02-06,-186.65,-1482.67
1308,19094015,2023-02-12,1761.1,278.4299999999997
3317,19094015,2023-02-13,-767.3,-488.87000000000023
287,19154395,2023-01-31,0.0,274.06
632,19154395,2023-02-01,173.96,448.02
633,19154395,2023-02-01,456.2,904.22
6053,19154395,2023-02-05,-25.75,878.47
634,19154395,2023-02-05,185.3,1063.77
6054,19154395,2023-02-06,-23.13,1040.64
288,19160862,2023-01-31,0.0,211.53
3385,19160862,2023-02-02,-110.38,101.15
3386,19160862,2023-02-11,-137.25,-36.099999999999994
289,19201987,2023-01-31,0.0,624.55
5209,19201987,2023-02-04,-107.38,517.17
5208,19201987,2023-02-04,-54.37,462.79999999999995
5210,19201987,2023-02-06,-140.78,322.02
8099,19201987,2023-02-09,80.63,402.65
5211,19201987,2023-02-11,-62.24,340.40999999999997
290,19216744,2023-01-31,0.0,123.53
4745,19216744,2023-02-03,79.86,203.39
291,19220216,2023-01-31,0.0,628.89
5801,19220216,2023-02-04,-148.35,480.53999999999996
5367,19220216,2023-02-04,50.19,530.73
5802,19220216,2023-02-05,-71.33,459.4
5368,19220216,2023-02-05,108.31,567.71
5803,19220216,2023-02-06,-162.13,405.58
5369,19220216,2023-02-06,833.9,1239.48
5804,19220216,2023-02-11,-102.26,1137.22
5370,19220216,2023-02-12,51.02,1188.24
5371,19220216,2023-02-13,187.8,1376.04
5805,19220216,2023-02-14,-190.15,1185.8899999999999
292,19242274,2023-01-31,0.0,65.28
411,19242274,2023-02-01,-107.29,-42.010000000000005
336,19242274,2023-02-01,116.71,74.69999999999999
412,19242274,2023-02-08,-94.16,-19.460000000000008
413,19242274,2023-02-09,-32.83,-52.290000000000006
414,19242274,2023-02-10,-98.85,-151.14000000000001
337,19242274,2023-02-10,1324.9,1173.76
293,19283264,2023-01-31,0.0,301.31
7535,19283264,2023-02-07,-126.94,174.37
7536,19283264,2023-02-07,-85.44,88.93
7537,19283264,2023-02-10,-96.34,-7.410000000000025
8228,19283264,2023-02-10,103.62,96.21000000000001
8229,19283264,2023-02-12,39.42,135.63
294,19315124,2023-01-31,0.0,447.16
8412,19315124,2023-02-11,-93.58,353.58000000000004
8440,19315124,2023-02-11,64.7,418.28000000000003
8413,19315124,2023-02-14,-90.11,328.17
8441,19315124,2023-02-14,634.0,962.1700000000001
295,19317267,2023-01-31,0.0,51.87
4057,19317267,2023-02-03,-113.25,-61.38
4058,19317267,2023-02-14,-198.2,-259.58
8681,19317267,2023-02-14,33.66,-225.91999999999996
8682,19317267,2023-02-14,1191.7,965.7800000000001
296,19334563,2023-01-31,0.0,525.45
758,19334563,2023-02-01,-774.6,-249.14999999999998
7852,19334563,2023-02-08,130.38,-118.76999999999998
7853,19334563,2023-02-12,41.59,-77.17999999999995
759,19334563,2023-02-13,-107.17,-184.35000000000002
7854,19334563,2023-02-14,1773.6,1589.2499999999998
297,19387921,2023-01-31,0.0,927.28
1930,19387921,2023-02-01,-86.97,840.31
3678,19387921,2023-02-02,124.34,964.65
3679,19387921,2023-02-06,144.74,1109.3899999999999
1931,19387921,2023-02-11,-58.94,1050.45
1932,19387921,2023-02-14,-125.82,924.63
3680,19387921,2023-02-14,70.52,995.15
3681,19387921,2023-02-14,162.9,1158.05
298,19429964,2023-01-31,0.0,694.43
5721,19429964,2023-02-04,220.77,915.1999999999999
5722,19429964,2023-02-05,200.2,1115.4
7980,19429964,2023-02-08,-58.6,1056.8
5723,19429964,2023-02-13,202.54,1259.34
5724,19429964,2023-02-14,97.35,1356.69
299,19432211,2023-01-31,0.0,24.19
2743,19432211,2023-02-02,-124.78,-100.59
3697,19432211,2023-02-02,114.87,14.280000000000005
2744,19432211,2023-02-07,-107.2,-92.92
3698,19432211,2023-02-08,76.6,-16.320000000000004
300,19524427,2023-01-31,0.0,579.16
4476,19524427,2023-02-03,-772.8,-193.64
7150,19524427,2023-02-06,151.44,-42.19999999999993
7151,19524427,2023-02-09,287.8,245.60000000000002
7152,19524427,2023-02-13,148.89,394.49
301,19530097,2023-01-31,0.0,960.21
6102,19530097,2023-02-05,44.78,1004.99
6103,19530097,2023-02-06,105.81,1110.8
8351,19530097,2023-02-10,-100.23,1010.57
6104,19530097,2023-02-10,79.86,1090.43
6105,19530097,2023-02-13,151.84,1242.27
302,19559937,2023-01-31,0.0,727.4
1099,19559937,2023-02-01,-86.72,640.68
1912,19559937,2023-02-01,1500.7,2141.38
1100,19559937,2023-02-05,-114.03,2027.35
1101,19559937,2023-02-09,-50.41,1976.94
1102,19559937,2023-02-10,-88.53,1888.4099999999999
1913,19559937,2023-02-10,64.28,1952.69
1103,19559937,2023-02-11,-157.4,1795.29
1914,19559937,2023-02-12,1025.1,2820.39
303,19574610,2023-01-31,0.0,104.29
3217,19574610,2023-02-02,91.54,195.83
5464,19574610,2023-02-04,-133.61,62.22
3218,19574610,2023-02-04,186.59,248.81
3219,19574610,2023-02-05,815.7,1064.51
5465,19574610,2023-02-07,-186.15,878.36
5466,19574610,2023-02-10,-28.58,849.78
5467,19574610,2023-02-11,-182.68,667.0999999999999
5468,19574610,2023-02-13,-62.72,604.38
3220,19574610,2023-02-13,68.69,673.0699999999999
5469,19574610,2023-02-14,-77.33,595.74
304,19647966,2023-01-31,0.0,849.89
6289,19647966,2023-02-05,176.88,1026.77
6290,19647966,2023-02-08,128.8,1155.57
6291,19647966,2023-02-10,106.72,1262.29
6292,19647966,2023-02-12,164.29,1426.58
8673,19647966,2023-02-14,-94.55,1332.03
6293,19647966,2023-02-14,83.33,1415.3600000000001
305,19686460,2023-01-31,0.0,416.7
1003,19686460,2023-02-01,818.4,1235.1
1004,19686460,2023-02-07,115.39,1350.49
1005,19686460,2023-02-08,1379.8,2730.29
1006,19686460,2023-02-11,754.3,3484.5899999999997
8680,19686460,2023-02-14,-72.93,3411.66
306,19705767,2023-01-31,0.0,997.48
5786,19705767,2023-02-04,-134.22,863.26
5787,19705767,2023-02-08,-136.38,726.88
8269,19705767,2023-02-10,101.58,828.46
8270,19705767,2023-02-11,132.19,960.6500000000001
8271,19705767,2023-02-13,46.08,1006.73
5788,19705767,2023-02-14,-7.09,999.64
307,19789505,2023-01-31,0.0,893.9
2062,19789505,2023-02-01,1041.9,1935.8000000000002
2063,19789505,2023-02-04,44.55,1980.35
7891,19789505,2023-02-08,-14.65,1965.7000000000003
2064,19789505,2023-02-08,118.76,2084.46
2065,19789505,2023-02-10,40.02,2124.48
2066,19789505,2023-02-11,117.67,2242.15
7892,19789505,2023-02-13,-1665.4,576.7499999999999
308,19836996,2023-01-31,0.0,245.14
2157,19836996,2023-02-02,114.29,359.43
2158,19836996,2023-02-04,165.75,525.1800000000001
6964,19836996,2023-02-06,-104.32,420.86
6965,19836996,2023-02-07,-1159.5,-738.64
6966,19836996,2023-02-07,-65.16,-803.8000000000001
309,19876635,2023-01-31,0.0,883.25
2069,19876635,2023-02-01,-101.28,781.97
2068,19876635,2023-02-01,-81.16,700.81
2070,19876635,2023-02-02,-236.79,464.02
2071,19876635,2023-02-03,-135.59,328.43000000000006
4342,19876635,2023-02-03,128.62,457.05
2072,19876635,2023-02-10,-128.06,328.99
4343,19876635,2023-02-11,147.81,476.8
2073,19876635,2023-02-14,-135.7,341.1
310,19920990,2023-01-31,0.0,70.95
4521,19920990,2023-02-03,-145.14,-74.18999999999998
4522,19920990,2023-02-07,-1370.6,-1444.7899999999997
4523,19920990,2023-02-08,-90.7,-1535.4899999999998
7967,19920990,2023-02-09,53.56,-1481.9299999999998
7968,19920990,2023-02-13,871.5,-610.4299999999997
7969,19920990,2023-02-14,38.18,-572.2499999999998
311,19931073,2023-01-31,0.0,404.96
8627,19931073,2023-02-13,40.02,444.97999999999996
312,19956941,2023-01-31,0.0,723.33
4712,19956941,2023-02-03,1121.6,1844.9299999999998
6390,19956941,2023-02-05,-173.68,1671.25
6391,19956941,2023-02-08,-133.65,1537.6
4713,19956941,2023-02-08,1010.6,2548.2
6392,19956941,2023-02-09,-69.39,2478.81
6393,19956941,2023-02-14,-69.01,2409.7999999999997
313,19980716,2023-01-31,0.0,432.98
3426,19980716,2023-02-02,-114.87,318.11
2790,19980716,2023-02-02,1774.7,2092.81
3427,19980716,2023-02-03,-159.69,1933.1200000000001
2791,19980716,2023-02-07,20.07,1953.1900000000003
2793,19980716,2023-02-09,114.01,2067.2000000000003
2792,19980716,2023-02-09,125.68,2192.88
3428,19980716,2023-02-10,-682.2,1510.6800000000003
2794,19980716,2023-02-11,75.65,1586.3300000000002
314,20015298,2023-01-31,0.0,953.82
1802,20015298,2023-02-01,158.51,1112.33
7807,20015298,2023-02-08,-128.42,983.9100000000001
1803,20015298,2023-02-08,42.88,1026.79
7808,20015298,2023-02-11,-590.6,436.19000000000005
7809,20015298,2023-02-13,-50.67,385.5200000000001
315,20067958,2023-01-31,0.0,38.05
7690,20067958,2023-02-07,85.23,123.28
7691,20067958,2023-02-07,122.02,245.3
7692,20067958,2023-02-08,974.3,1219.6
7693,20067958,2023-02-11,102.26,1321.86
7694,20067958,2023-02-12,94.36,1416.22
316,20090784,2023-01-31,0.0,482.62
3811,20090784,2023-02-03,12.53,495.15
3812,20090784,2023-02-04,1263.9,1759.0500000000002
3813,20090784,2023-02-09,85.8,1844.85
8280,20090784,2023-02-10,-8.29,1836.56
3814,20090784,2023-02-13,710.9,2547.46
317,20117480,2023-01-31,0.0,70.97
1435,20117480,2023-02-01,-86.68,-15.710000000000008
6743,20117480,2023-02-06,186.65,170.94
6744,20117480,2023-02-07,188.36,359.30000000000007
1436,20117480,2023-02-08,-154.2,205.10000000000002
6745,20117480,2023-02-11,75.16,280.26
318,20129535,2023-01-31,0.0,446.41
1928,20129535,2023-02-01,143.85,590.26
1929,20129535,2023-02-05,172.62,762.8800000000001
1930,20129535,2023-02-06,45.01,807.8900000000001
1931,20129535,2023-02-07,6.03,813.9200000000001
8389,20129535,2023-02-10,-99.74,714.1800000000001
8390,20129535,2023-02-11,-30.14,684.04
1932,20129535,2023-02-13,113.24,797.28
319,20176338,2023-01-31,0.0,289.57
1943,20176338,2023-02-01,-100.02,189.55
1944,20176338,2023-02-04,-186.95,2.6000000000000227
6237,20176338,2023-02-05,62.88,65.48000000000002
6236,20176338,2023-02-05,108.33,173.81000000000003
6238,20176338,2023-02-08,96.42,270.23
6239,20176338,2023-02-09,188.14,458.37
1945,20176338,2023-02-10,-121.7,336.67
320,20242626,2023-01-31,0.0,701.08
4327,20242626,2023-02-03,85.48,786.5600000000001
4328,20242626,2023-02-09,82.05,868.61
321,20248053,2023-01-31,0.0,565.28
3667,20248053,2023-02-02,-77.43,487.84999999999997
4987,20248053,2023-02-03,127.48,615.3299999999999
4988,20248053,2023-02-04,110.05,725.38
3668,20248053,2023-02-11,-179.27,546.1099999999999
3669,20248053,2023-02-14,-114.98,431.12999999999994
322,20263437,2023-01-31,0.0,789.09
5144,20263437,2023-02-04,141.31,930.4000000000001
5989,20263437,2023-02-05,-99.42,830.98
5988,20263437,2023-02-05,-41.33,789.6500000000001
5145,20263437,2023-02-08,107.41,897.0600000000001
5146,20263437,2023-02-12,48.67,945.73
323,20280759,2023-01-31,0.0,838.7
4068,20280759,2023-02-03,-66.37,772.33
4069,20280759,2023-02-04,-110.37,661.96
4071,20280759,2023-02-12,-110.26,551.7
4070,20280759,2023-02-12,-66.4,485.3
8578,20280759,2023-02-12,118.8,604.1
8579,20280759,2023-02-13,110.74,714.84
324,20287993,2023-01-31,0.0,616.17
4620,20287993,2023-02-03,125.34,741.51
4621,20287993,2023-02-04,614.0,1355.51
4622,20287993,2023-02-06,876.5,2232.01
7434,20287993,2023-02-07,-756.5,1475.51
4623,20287993,2023-02-09,81.5,1557.01
7435,20287993,2023-02-13,-91.78,1465.23
4624,20287993,2023-02-13,203.37,1668.6
325,20316429,2023-01-31,0.0,697.84
3130,20316429,2023-02-02,-94.92,602.9200000000001
3131,20316429,2023-02-09,-166.7,436.22
326,20345467,2023-01-31,0.0,852.5
672,20345467,2023-02-01,-72.35,780.15
673,20345467,2023-02-02,-100.36,679.79
6455,20345467,2023-02-05,115.08,794.87
6456,20345467,2023-02-08,154.63,949.5
674,20345467,2023-02-09,-154.98,794.52
6457,20345467,2023-02-14,102.53,897.05
327,20369153,2023-01-31,0.0,293.78
781,20369153,2023-02-01,387.9,681.68
782,20369153,2023-02-03,142.86,824.54
5880,20369153,2023-02-04,-111.47,713.0699999999999
5881,20369153,2023-02-05,-144.17,568.9
5882,20369153,2023-02-07,-979.3,-410.4
783,20369153,2023-02-07,605.2,194.80000000000007
5884,20369153,2023-02-11,-146.56,48.240000000000066
5883,20369153,2023-02-11,-132.19,-83.94999999999993
5885,20369153,2023-02-11,-59.3,-143.24999999999994
328,20372310,2023-01-31,0.0,366.41
2255,20372310,2023-02-02,-123.8,242.61
2256,20372310,2023-02-05,-104.74,137.87000000000003
6194,20372310,2023-02-05,142.33,280.20000000000005
2259,20372310,2023-02-10,-144.36,135.84000000000003
2257,20372310,2023-02-10,-74.87,60.97000000000003
2258,20372310,2023-02-10,-26.87,34.10000000000002
2260,20372310,2023-02-11,-1293.9,-1259.8
6195,20372310,2023-02-11,123.03,-1136.77
329,20413037,2023-01-31,0.0,235.79
2549,20413037,2023-02-02,-119.55,116.24
2548,20413037,2023-02-02,-93.56,22.67999999999998
3710,20413037,2023-02-02,98.09,120.77
3711,20413037,2023-02-07,65.9,186.67000000000002
2550,20413037,2023-02-11,-48.78,137.89
3712,20413037,2023-02-11,121.47,259.36
2551,20413037,2023-02-14,-56.12,203.24
330,20425065,2023-01-31,0.0,866.77
2496,20425065,2023-02-02,-62.78,803.99
2497,20425065,2023-02-04,-165.75,638.24
2498,20425065,2023-02-14,-2134.6,-1496.3600000000001
331,20464830,2023-01-31,0.0,181.25
4710,20464830,2023-02-03,-166.13,15.120000000000005
5554,20464830,2023-02-04,121.04,136.16000000000003
5555,20464830,2023-02-08,159.45,295.61
332,20632572,2023-01-31,0.0,286.44
3517,20632572,2023-02-02,-20.11,266.33
7134,20632572,2023-02-06,16.08,282.40999999999997
7135,20632572,2023-02-12,175.32,457.73
333,20704613,2023-01-31,0.0,71.59
1161,20704613,2023-02-01,97.11,168.7
7177,20704613,2023-02-06,-11.61,157.09
1162,20704613,2023-02-07,93.91,251.0
1163,20704613,2023-02-08,30.57,281.57
1164,20704613,2023-02-09,130.36,411.93000000000006
7178,20704613,2023-02-10,-200.96,210.97
1165,20704613,2023-02-11,20.99,231.96
7179,20704613,2023-02-13,-154.81,77.15
334,20705548,2023-01-31,0.0,184.81
3376,20705548,2023-02-02,2269.2,2454.0099999999998
3377,20705548,2023-02-03,208.56,2662.5699999999997
5664,20705548,2023-02-04,-125.11,2537.4599999999996
5665,20705548,2023-02-14,-30.74,2506.72
3378,20705548,2023-02-14,46.61,2553.33
3379,20705548,2023-02-14,67.36,2620.6899999999996
335,20720894,2023-01-31,0.0,243.42
6869,20720894,2023-02-06,179.82,423.24
6868,20720894,2023-02-06,462.2,885.4399999999999
8505,20720894,2023-02-11,-107.81,777.63
336,20838578,2023-01-31,0.0,620.7
8056,20838578,2023-02-09,-55.87,564.83
8057,20838578,2023-02-10,-96.87,467.96000000000004
8590,20838578,2023-02-12,56.96,524.9200000000001
337,20849721,2023-01-31,0.0,740.52
7031,20849721,2023-02-06,19.45,759.97
7030,20849721,2023-02-06,70.55,830.52
7032,20849721,2023-02-07,197.62,1028.1399999999999
7898,20849721,2023-02-08,-71.98,956.16
7033,20849721,2023-02-13,117.42,1073.58
338,20851460,2023-01-31,0.0,931.67
4596,20851460,2023-02-03,124.8,1056.47
8259,20851460,2023-02-10,-147.03,909.4399999999999
339,20878023,2023-01-31,0.0,648.19
5361,20878023,2023-02-04,-149.2,498.99000000000007
5362,20878023,2023-02-06,-125.2,373.7900000000001
5363,20878023,2023-02-06,-103.53,270.26000000000005
5364,20878023,2023-02-08,-107.64,162.62000000000006
7740,20878023,2023-02-08,124.5,287.12000000000006
5365,20878023,2023-02-10,-63.58,223.54000000000008
5366,20878023,2023-02-13,-26.71,196.83000000000004
340,20908067,2023-01-31,0.0,607.53
5985,20908067,2023-02-05,179.9,787.43
7197,20908067,2023-02-06,-202.05,585.38
7198,20908067,2023-02-11,-119.75,465.63
7199,20908067,2023-02-14,-2138.0,-1672.3700000000001
341,20991411,2023-01-31,0.0,572.64
6711,20991411,2023-02-06,-111.33,461.31
8179,20991411,2023-02-09,41.77,503.08
6712,20991411,2023-02-10,-114.86,388.22
342,20992354,2023-01-31,0.0,87.26
490,20992354,2023-02-01,-82.18,5.079999999999998
491,20992354,2023-02-03,-5.14,-0.060000000000002274
5600,20992354,2023-02-04,129.11,129.05
492,20992354,2023-02-08,-191.5,-62.449999999999974
493,20992354,2023-02-09,-35.39,-97.83999999999996
5601,20992354,2023-02-12,52.16,-45.67999999999999
494,20992354,2023-02-13,-99.13,-144.81
5602,20992354,2023-02-13,157.55,12.740000000000023
343,21001872,2023-01-31,0.0,31.76
8136,21001872,2023-02-09,12.23,43.99
8291,21001872,2023-02-10,-106.72,-62.72999999999999
8292,21001872,2023-02-12,-98.65,-161.38
8137,21001872,2023-02-14,101.69,-59.69
344,21032760,2023-01-31,0.0,541.33
290,21032760,2023-02-01,-637.1,-95.76999999999998
291,21032760,2023-02-03,-51.58,-147.35000000000002
4424,21032760,2023-02-03,94.5,-52.85000000000002
4425,21032760,2023-02-04,127.8,74.95000000000005
292,21032760,2023-02-09,-993.4,-918.4499999999999
4426,21032760,2023-02-09,78.9,-839.5499999999998
293,21032760,2023-02-10,-932.3,-1771.85
294,21032760,2023-02-11,-1161.1,-2932.95
4427,21032760,2023-02-11,33.32,-2899.6299999999997
4428,21032760,2023-02-13,161.21,-2738.4199999999996
345,21047777,2023-01-31,0.0,699.12
4315,21047777,2023-02-03,40.55,739.67
4316,21047777,2023-02-04,31.07,770.74
6620,21047777,2023-02-05,-128.94,641.8
4317,21047777,2023-02-06,92.39,734.19
4318,21047777,2023-02-07,137.57,871.76
6621,21047777,2023-02-08,-14.52,857.24
4319,21047777,2023-02-08,163.05,1020.29
6622,21047777,2023-02-12,-90.28,930.01
346,21142911,2023-01-31,0.0,714.89
1976,21142911,2023-02-01,-103.99,610.9
1977,21142911,2023-02-02,-156.5,454.4
7097,21142911,2023-02-06,80.92,535.3199999999999
1979,21142911,2023-02-10,-86.61,448.71
1978,21142911,2023-02-10,-52.02,396.69
7098,21142911,2023-02-10,160.6,557.29
347,21293955,2023-01-31,0.0,232.88
6004,21293955,2023-02-05,1110.7,1343.58
6005,21293955,2023-02-08,85.9,1429.48
6006,21293955,2023-02-10,624.8,2054.28
348,21314767,2023-01-31,0.0,438.19
573,21314767,2023-02-01,-130.93,307.26
574,21314767,2023-02-01,-33.36,273.9
575,21314767,2023-02-07,-143.04,130.86
576,21314767,2023-02-11,-134.72,-3.859999999999957
577,21314767,2023-02-12,-1486.8,-1490.6599999999999
578,21314767,2023-02-12,-103.79,-1594.4499999999998
349,21368735,2023-01-31,0.0,281.87
1933,21368735,2023-02-01,-145.77,136.1
1934,21368735,2023-02-02,-786.6,-650.5
4963,21368735,2023-02-03,40.33,-610.17
1935,21368735,2023-02-04,-73.7,-683.87
1936,21368735,2023-02-05,-49.85,-733.72
4964,21368735,2023-02-06,63.43,-670.29
4965,21368735,2023-02-13,118.83,-551.46
350,21392412,2023-01-31,0.0,708.46
2574,21392412,2023-02-02,-192.68,515.78
2554,21392412,2023-02-02,117.9,633.6800000000001
2575,21392412,2023-02-04,-101.75,531.9300000000001
2555,21392412,2023-02-04,1367.4,1899.3300000000002
2556,21392412,2023-02-12,122.81,2022.14
2576,21392412,2023-02-14,-120.31,1901.8300000000002
351,21464772,2023-01-31,0.0,719.8
5693,21464772,2023-02-04,81.91,801.7099999999999
5694,21464772,2023-02-08,52.3,854.01
5696,21464772,2023-02-12,125.47,979.48
5695,21464772,2023-02-12,181.41,1160.8899999999999
352,21475060,2023-01-31,0.0,354.98
6961,21475060,2023-02-06,-431.9,-76.91999999999996
6883,21475060,2023-02-06,39.83,-37.089999999999975
6962,21475060,2023-02-10,-117.25,-154.33999999999997
6963,21475060,2023-02-12,-1061.5,-1215.84
6884,21475060,2023-02-13,158.29,-1057.55
6885,21475060,2023-02-14,25.28,-1032.27
353,21515934,2023-01-31,0.0,543.38
2137,21515934,2023-02-01,-126.75,416.63
2138,21515934,2023-02-02,-212.6,204.02999999999997
3556,21515934,2023-02-02,599.3,803.3299999999999
2139,21515934,2023-02-03,-70.29,733.04
2140,21515934,2023-02-11,-100.88,632.16
3557,21515934,2023-02-14,77.69,709.8499999999999
354,21550631,2023-01-31,0.0,84.96
4366,21550631,2023-02-03,-182.35,-97.39
5239,21550631,2023-02-04,119.53,22.14
4367,21550631,2023-02-08,-88.85,-66.71
5240,21550631,2023-02-11,110.41,43.7
355,21558805,2023-01-31,0.0,586.63
2312,21558805,2023-02-02,68.41,655.04
2313,21558805,2023-02-05,2160.7,2815.74
2314,21558805,2023-02-07,1434.3,4250.04
2315,21558805,2023-02-10,113.82,4363.86
2316,21558805,2023-02-12,934.0,5297.86
8631,21558805,2023-02-13,-117.42,5180.44
2317,21558805,2023-02-13,126.07,5306.509999999999
356,21601747,2023-01-31,0.0,410.62
824,21601747,2023-02-01,-58.18,352.44
7090,21601747,2023-02-06,22.99,375.43
7091,21601747,2023-02-08,597.4,972.83
7092,21601747,2023-02-10,103.91,1076.7399999999998
825,21601747,2023-02-14,-140.0,936.7399999999999
357,21618665,2023-01-31,0.0,291.59
581,21618665,2023-02-01,-223.94,67.64999999999998
582,21618665,2023-02-02,-175.73,-108.07999999999998
2275,21618665,2023-02-02,89.87,-18.20999999999998
2276,21618665,2023-02-04,101.39,83.18
583,21618665,2023-02-05,-142.33,-59.150000000000034
2277,21618665,2023-02-05,63.96,4.809999999999945
584,21618665,2023-02-06,-65.05,-60.240000000000066
2278,21618665,2023-02-06,184.01,123.76999999999995
585,21618665,2023-02-07,-171.64,-47.87000000000006
2279,21618665,2023-02-09,96.36,48.48999999999995
587,21618665,2023-02-13,-148.17,-99.68
586,21618665,2023-02-13,-104.51,-204.19
358,21646418,2023-01-31,0.0,909.55
5415,21646418,2023-02-04,123.43,1032.98
7013,21646418,2023-02-06,-74.78,958.1999999999999
5416,21646418,2023-02-09,64.47,1022.67
359,21655728,2023-01-31,0.0,761.31
8459,21655728,2023-02-11,-106.02,655.29
8510,21655728,2023-02-11,56.37,711.66
360,21675999,2023-01-31,0.0,893.27
41,21675999,2023-02-01,109.32,1002.5899999999999
5919,21675999,2023-02-04,-598.4,404.19
42,21675999,2023-02-09,158.66,562.85
5920,21675999,2023-02-10,-32.99,529.86
43,21675999,2023-02-11,56.7,586.56
44,21675999,2023-02-11,65.4,651.96
361,21694967,2023-01-31,0.0,90.13
2820,21694967,2023-02-02,-616.7,-526.57
2099,21694967,2023-02-02,133.67,-392.9000000000001
2098,21694967,2023-02-02,1019.5,626.5999999999999
2821,21694967,2023-02-03,-33.4,593.1999999999999
2822,21694967,2023-02-06,-1042.0,-448.80000000000007
2100,21694967,2023-02-07,1808.5,1359.6999999999998
2823,21694967,2023-02-08,-159.45,1200.25
2101,21694967,2023-02-09,12.69,1212.94
362,21705004,2023-01-31,0.0,496.88
7849,21705004,2023-02-08,103.7,600.58
8647,21705004,2023-02-13,-48.19,552.39
7850,21705004,2023-02-13,124.45,676.84
363,21711501,2023-01-31,0.0,126.63
1662,21711501,2023-02-01,126.36,252.99
4815,21711501,2023-02-03,-1882.4,-1629.4100000000003
4816,21711501,2023-02-04,-126.27,-1755.6800000000003
364,21716351,2023-01-31,0.0,800.95
3189,21716351,2023-02-02,111.91,912.86
3190,21716351,2023-02-05,219.27,1132.13
3191,21716351,2023-02-08,33.32,1165.45
3192,21716351,2023-02-12,1499.6,2665.05
365,21719977,2023-01-31,0.0,758.81
6505,21719977,2023-02-05,138.9,897.7099999999999
7052,21719977,2023-02-06,-180.89,716.8199999999999
7051,21719977,2023-02-06,-155.92,560.9
6506,21719977,2023-02-10,739.5,1300.4
6507,21719977,2023-02-12,39.77,1340.17
7053,21719977,2023-02-13,-1121.3,218.87
366,21728352,2023-01-31,0.0,733.87
2735,21728352,2023-02-02,-91.84,642.03
5265,21728352,2023-02-04,120.38,762.41
2736,21728352,2023-02-08,-117.08,645.33
5266,21728352,2023-02-10,66.94,712.27
2737,21728352,2023-02-12,-103.32,608.95
5267,21728352,2023-02-12,151.06,760.01
5268,21728352,2023-02-13,51.57,811.58
367,21749252,2023-01-31,0.0,646.27
734,21749252,2023-02-01,50.95,697.22
3272,21749252,2023-02-02,-165.3,531.92
735,21749252,2023-02-03,126.76,658.68
736,21749252,2023-02-07,144.5,803.18
3273,21749252,2023-02-08,-110.15,693.03
3274,21749252,2023-02-10,-1098.2,-405.1700000000001
3275,21749252,2023-02-10,-156.28,-561.45
737,21749252,2023-02-13,53.28,-508.1700000000001
368,21750371,2023-01-31,0.0,329.19
6136,21750371,2023-02-05,-88.55,240.64
7249,21750371,2023-02-06,131.96,372.6
7250,21750371,2023-02-10,72.23,444.83000000000004
369,21816770,2023-01-31,0.0,693.8
4819,21816770,2023-02-03,-56.86,636.9399999999999
3898,21816770,2023-02-03,141.05,777.99
3899,21816770,2023-02-03,182.35,960.3399999999999
3900,21816770,2023-02-05,74.16,1034.5
4820,21816770,2023-02-09,-144.14,890.3599999999999
3901,21816770,2023-02-10,114.24,1004.5999999999999
370,21844169,2023-01-31,0.0,463.51
2026,21844169,2023-02-01,-3.04,460.46999999999997
2027,21844169,2023-02-04,-139.28,321.19
2028,21844169,2023-02-06,-103.37,217.82
7006,21844169,2023-02-06,104.66,322.48
2029,21844169,2023-02-07,-89.6,232.88
7007,21844169,2023-02-08,103.37,336.25
7008,21844169,2023-02-09,67.11,403.36
2030,21844169,2023-02-11,-124.08,279.28
2031,21844169,2023-02-12,-108.81,170.47000000000003
371,21844651,2023-01-31,0.0,525.16
4818,21844651,2023-02-03,-37.02,488.14
4891,21844651,2023-02-03,104.89,593.03
4893,21844651,2023-02-04,45.51,638.54
4892,21844651,2023-02-04,73.5,712.04
4894,21844651,2023-02-13,43.53,755.5699999999999
372,21881168,2023-01-31,0.0,950.62
5489,21881168,2023-02-04,-153.28,797.34
5490,21881168,2023-02-04,-78.39,718.95
5855,21881168,2023-02-04,27.77,746.72
5491,21881168,2023-02-06,-185.73,560.99
5856,21881168,2023-02-06,31.91,592.9000000000001
5492,21881168,2023-02-10,-882.0,-289.1
5857,21881168,2023-02-10,121.44,-167.65999999999997
5493,21881168,2023-02-14,-78.92,-246.58000000000004
373,21898016,2023-01-31,0.0,117.42
8081,21898016,2023-02-09,113.15,230.57
374,21918195,2023-01-31,0.0,510.33
2532,21918195,2023-02-02,-120.93,389.4
2533,21918195,2023-02-08,-105.35,284.04999999999995
2534,21918195,2023-02-14,-150.77,133.27999999999997
375,21966927,2023-01-31,0.0,511.1
2445,21966927,2023-02-02,88.29,599.39
2446,21966927,2023-02-05,75.94,675.33
7127,21966927,2023-02-06,-27.72,647.61
2447,21966927,2023-02-10,69.88,717.49
376,22027757,2023-01-31,0.0,438.85
1348,22027757,2023-02-01,-215.02,223.83
1350,22027757,2023-02-01,-102.21,121.62
1349,22027757,2023-02-01,-20.11,101.50999999999999
1351,22027757,2023-02-05,-505.0,-403.49
7015,22027757,2023-02-06,13.61,-389.88
377,22035411,2023-01-31,0.0,9.55
2123,22035411,2023-02-02,37.84,47.39
2124,22035411,2023-02-02,122.21,169.60000000000002
2122,22035411,2023-02-02,1028.8,1198.3999999999999
2125,22035411,2023-02-06,47.53,1245.9299999999998
7388,22035411,2023-02-07,-132.14,1113.79
7389,22035411,2023-02-09,-15.37,1098.4199999999998
2126,22035411,2023-02-10,97.29,1195.7099999999998
7390,22035411,2023-02-11,-85.02,1110.6899999999998
378,22054113,2023-01-31,0.0,364.66
1658,22054113,2023-02-01,33.36,398.02000000000004
3747,22054113,2023-02-03,-66.09,331.93
1659,22054113,2023-02-04,57.96,389.89000000000004
1660,22054113,2023-02-09,137.79,527.6800000000001
3748,22054113,2023-02-11,-109.76,417.92
1661,22054113,2023-02-11,43.78,461.7
379,22063978,2023-01-31,0.0,387.01
222,22063978,2023-02-01,-989.3,-602.29
1239,22063978,2023-02-01,95.21,-507.0799999999999
1240,22063978,2023-02-02,39.13,-467.94999999999993
1241,22063978,2023-02-02,50.71,-417.24
1242,22063978,2023-02-10,108.81,-308.42999999999995
380,22099256,2023-01-31,0.0,523.78
3714,22099256,2023-02-02,-131.8,391.97999999999996
3715,22099256,2023-02-04,-87.13,304.84999999999997
3716,22099256,2023-02-06,-1003.2,-698.3500000000001
3717,22099256,2023-02-06,-127.87,-826.22
8076,22099256,2023-02-09,85.88,-740.3400000000001
8077,22099256,2023-02-14,1401.8,661.4599999999998
381,22137086,2023-01-31,0.0,410.35
5858,22137086,2023-02-04,2122.7,2533.0499999999997
6117,22137086,2023-02-05,-115.53,2417.52
6118,22137086,2023-02-07,-32.26,2385.2599999999998
6119,22137086,2023-02-08,-1368.6,1016.66
6120,22137086,2023-02-08,-69.06,947.6
5859,22137086,2023-02-08,83.33,1030.9299999999998
6121,22137086,2023-02-09,-1288.6,-257.66999999999996
5860,22137086,2023-02-11,41.86,-215.80999999999995
382,22268314,2023-01-31,0.0,153.05
1412,22268314,2023-02-01,-160.38,-7.329999999999984
1413,22268314,2023-02-05,-65.31,-72.63999999999999
1414,22268314,2023-02-09,-155.69,-228.32999999999998
8387,22268314,2023-02-10,13.9,-214.43
1415,22268314,2023-02-11,-37.8,-252.22999999999996
1416,22268314,2023-02-13,-14.32,-266.55
383,22292682,2023-01-31,0.0,874.32
443,22292682,2023-02-01,-130.44,743.8800000000001
444,22292682,2023-02-05,-201.75,542.1300000000001
6515,22292682,2023-02-05,159.07,701.2
6516,22292682,2023-02-06,122.96,824.1600000000001
6517,22292682,2023-02-07,103.74,927.9000000000001
6518,22292682,2023-02-11,23.58,951.48
6519,22292682,2023-02-12,66.05,1017.53
384,22298371,2023-01-31,0.0,891.16
1151,22298371,2023-02-01,-107.18,783.98
1152,22298371,2023-02-05,-219.27,564.7099999999999
7581,22298371,2023-02-07,86.22,650.93
1153,22298371,2023-02-12,-151.34,499.5899999999999
385,22341160,2023-01-31,0.0,61.07
3579,22341160,2023-02-02,-699.9,-638.8299999999999
386,22374612,2023-01-31,0.0,554.31
5018,22374612,2023-02-03,46.33,600.64
6080,22374612,2023-02-05,-1110.7,-510.0600000000002
6081,22374612,2023-02-07,-134.55,-644.6100000000001
6082,22374612,2023-02-08,-189.92,-834.5300000000002
5019,22374612,2023-02-11,1742.7,908.1699999999998
6083,22374612,2023-02-12,-91.9,816.2699999999999
6084,22374612,2023-02-14,-735.5,80.76999999999987
387,22391508,2023-01-31,0.0,91.32
1562,22391508,2023-02-01,12.31,103.63
1563,22391508,2023-02-02,94.69,198.32
7382,22391508,2023-02-07,-71.61,126.71
388,22393008,2023-01-31,0.0,753.5
7383,22393008,2023-02-07,-1806.9,-1053.4
7384,22393008,2023-02-09,-146.1,-1199.5
8025,22393008,2023-02-09,1260.0,60.5
8026,22393008,2023-02-10,1526.7,1587.2
7385,22393008,2023-02-13,-99.8,1487.4
389,22403299,2023-01-31,0.0,702.95
3912,22403299,2023-02-03,-101.53,601.4200000000001
4851,22403299,2023-02-03,774.8,1376.22
3913,22403299,2023-02-04,-95.64,1280.58
4852,22403299,2023-02-04,90.13,1370.71
3914,22403299,2023-02-05,-57.79,1312.92
4853,22403299,2023-02-08,167.11,1480.03
3915,22403299,2023-02-09,-88.39,1391.6399999999999
4855,22403299,2023-02-09,142.44,1534.08
4854,22403299,2023-02-09,735.1,2269.1800000000003
390,22404690,2023-01-31,0.0,726.06
7742,22404690,2023-02-08,-13.32,712.7399999999999
8572,22404690,2023-02-12,934.7,1647.44
7743,22404690,2023-02-14,-126.71,1520.73
391,22412680,2023-01-31,0.0,637.99
3233,22412680,2023-02-02,-82.9,555.09
3234,22412680,2023-02-03,-84.5,470.59000000000003
7932,22412680,2023-02-08,154.46,625.05
3235,22412680,2023-02-09,-167.25,457.8
7933,22412680,2023-02-09,35.39,493.19
7934,22412680,2023-02-09,119.51,612.7
7936,22412680,2023-02-10,77.1,689.8
7935,22412680,2023-02-10,85.16,774.96
3236,22412680,2023-02-14,-68.51,706.45
3237,22412680,2023-02-14,-38.12,668.33
7937,22412680,2023-02-14,104.53,772.86
392,22483300,2023-01-31,0.0,763.23
6294,22483300,2023-02-05,-52.34,710.89
6295,22483300,2023-02-07,-140.12,570.77
6296,22483300,2023-02-09,-112.76,458.01
8333,22483300,2023-02-10,85.13,543.14
393,22683382,2023-01-31,0.0,987.13
236,22683382,2023-02-01,-92.35,894.78
2284,22683382,2023-02-02,31.64,926.42
237,22683382,2023-02-06,-110.76,815.66
238,22683382,2023-02-07,-104.64,711.02
239,22683382,2023-02-09,-142.61,568.41
394,22696687,2023-01-31,0.0,133.52
4188,22696687,2023-02-03,153.0,286.52
7844,22696687,2023-02-08,-79.86,206.66000000000003
7845,22696687,2023-02-10,-89.12,117.54
7846,22696687,2023-02-10,-62.31,55.230000000000004
7847,22696687,2023-02-12,-38.42,16.810000000000002
4190,22696687,2023-02-12,61.36,78.17
4189,22696687,2023-02-12,1061.5,1139.67
7848,22696687,2023-02-14,-61.16,1078.51
395,22730750,2023-01-31,0.0,473.56
690,22730750,2023-02-01,13.37,486.93
691,22730750,2023-02-01,20.11,507.04
5628,22730750,2023-02-04,-95.05,411.99
692,22730750,2023-02-05,128.78,540.77
5629,22730750,2023-02-07,-104.16,436.61
693,22730750,2023-02-11,132.96,569.57
5630,22730750,2023-02-12,-198.2,371.37
694,22730750,2023-02-12,195.95,567.32
396,22799719,2023-01-31,0.0,481.26
3937,22799719,2023-02-03,-133.85,347.40999999999997
4957,22799719,2023-02-03,51.58,398.99
4959,22799719,2023-02-06,75.9,474.89
4958,22799719,2023-02-06,170.43,645.3199999999999
3938,22799719,2023-02-07,-44.02,601.3
4960,22799719,2023-02-11,26.87,628.17
3939,22799719,2023-02-12,-57.33,570.84
3940,22799719,2023-02-13,-180.81,390.03
4961,22799719,2023-02-13,38.78,428.81
4962,22799719,2023-02-14,53.79,482.59999999999997
397,22830156,2023-01-31,0.0,596.06
3380,22830156,2023-02-02,634.2,1230.26
5408,22830156,2023-02-04,-109.5,1120.76
3381,22830156,2023-02-10,1987.3,3108.06
5409,22830156,2023-02-12,-1153.9,1954.1599999999999
5410,22830156,2023-02-13,-30.92,1923.2399999999998
5411,22830156,2023-02-14,-170.57,1752.6699999999998
398,22833010,2023-01-31,0.0,645.79
1764,22833010,2023-02-01,-58.0,587.79
1765,22833010,2023-02-03,-132.53,455.26
1766,22833010,2023-02-04,-139.7,315.55999999999995
7206,22833010,2023-02-06,110.76,426.32
1767,22833010,2023-02-08,-163.93,262.39
399,22846221,2023-01-31,0.0,868.2
965,22846221,2023-02-01,-179.6,688.6
3277,22846221,2023-02-02,1106.9,1795.5
3278,22846221,2023-02-06,126.83,1922.3300000000002
3279,22846221,2023-02-09,12.71,1935.0400000000002
966,22846221,2023-02-10,-144.27,1790.77
400,22884864,2023-01-31,0.0,521.87
2617,22884864,2023-02-02,108.51,630.38
6073,22884864,2023-02-05,-122.01,508.37
6074,22884864,2023-02-06,-182.28,326.09000000000003
6075,22884864,2023-02-06,-137.14,188.95000000000005
401,22888798,2023-01-31,0.0,326.4
6205,22888798,2023-02-05,39.31,365.71
6206,22888798,2023-02-06,75.81,441.52
6207,22888798,2023-02-07,71.14,512.66
7800,22888798,2023-02-08,-53.66,459.0
6208,22888798,2023-02-08,107.64,566.64
402,22951653,2023-01-31,0.0,414.64
1618,22951653,2023-02-01,17.61,432.25
1619,22951653,2023-02-02,181.62,613.87
7698,22951653,2023-02-08,-13.16,600.71
7699,22951653,2023-02-12,-111.6,489.11
7700,22951653,2023-02-12,-14.26,474.85
1620,22951653,2023-02-13,84.66,559.51
403,23030554,2023-01-31,0.0,196.97
3747,23030554,2023-02-03,148.95,345.91999999999996
6845,23030554,2023-02-06,-147.34,198.57999999999998
6846,23030554,2023-02-10,-67.6,130.98
6847,23030554,2023-02-11,-87.57,43.41
404,23032852,2023-01-31,0.0,475.21
3447,23032852,2023-02-02,832.5,1307.71
3448,23032852,2023-02-04,75.94,1383.65
3449,23032852,2023-02-07,140.72,1524.3700000000001
8125,23032852,2023-02-09,-155.34,1369.03
3450,23032852,2023-02-09,780.7,2149.73
8126,23032852,2023-02-10,-156.63,1993.1
405,23045208,2023-01-31,0.0,359.49
2514,23045208,2023-02-02,-1157.4,-797.9100000000001
2513,23045208,2023-02-02,-794.9,-1592.8100000000002
3398,23045208,2023-02-02,62.04,-1530.77
2515,23045208,2023-02-13,-118.67,-1649.44
406,23093541,2023-01-31,0.0,326.05
5649,23093541,2023-02-04,-55.7,270.35
5650,23093541,2023-02-05,-110.12,160.23000000000002
5651,23093541,2023-02-05,-96.95,63.28000000000003
8184,23093541,2023-02-10,86.54,149.82
407,23124345,2023-01-31,0.0,595.61
4763,23124345,2023-02-03,215.09,810.7
4764,23124345,2023-02-04,126.27,936.97
4765,23124345,2023-02-12,130.79,1067.76
408,23141588,2023-01-31,0.0,281.28
3149,23141588,2023-02-02,-1824.3,-1543.02
3150,23141588,2023-02-14,-64.58,-1607.6
409,23231848,2023-01-31,0.0,27.12
3011,23231848,2023-02-02,-112.23,-85.11
3012,23231848,2023-02-04,-1454.9,-1540.0100000000002
3013,23231848,2023-02-04,-292.64,-1832.65
3014,23231848,2023-02-04,-89.51,-1922.1600000000003
3015,23231848,2023-02-06,-97.52,-2019.6800000000003
8023,23231848,2023-02-09,140.03,-1879.65
3016,23231848,2023-02-11,-95.68,-1975.3300000000002
3017,23231848,2023-02-12,-481.2,-2456.53
3018,23231848,2023-02-13,-134.36,-2590.8900000000003
8024,23231848,2023-02-14,37.37,-2553.5200000000004
410,23269253,2023-01-31,0.0,324.56
450,23269253,2023-02-01,899.8,1224.36
7552,23269253,2023-02-07,-151.91,1072.45
451,23269253,2023-02-08,35.48,1107.93
7553,23269253,2023-02-10,-72.21,1035.72
7554,23269253,2023-02-13,-34.3,1001.4200000000001
7555,23269253,2023-02-14,-98.34,903.0799999999999
411,23271383,2023-01-31,0.0,633.3
4759,23271383,2023-02-03,-101.42,531.88
6508,23271383,2023-02-05,174.13,706.01
6509,23271383,2023-02-06,1176.9,1882.91
6510,23271383,2023-02-07,138.63,2021.5400000000002
4760,23271383,2023-02-09,-134.0,1887.5400000000002
6512,23271383,2023-02-09,4.61,1892.15
6511,23271383,2023-02-09,157.69,2049.84
4761,23271383,2023-02-11,-11.69,2038.15
6513,23271383,2023-02-14,118.38,2156.5299999999997
412,23289647,2023-01-31,0.0,522.8
4849,23289647,2023-02-03,56.86,579.66
7398,23289647,2023-02-07,-125.71,453.94999999999993
7397,23289647,2023-02-07,-87.03,366.91999999999996
7399,23289647,2023-02-10,-154.12,212.79999999999995
4850,23289647,2023-02-10,170.55,383.34999999999997
413,23295106,2023-01-31,0.0,340.16
1222,23295106,2023-02-01,89.15,429.31000000000006
1223,23295106,2023-02-02,103.88,533.19
1224,23295106,2023-02-04,72.72,605.9100000000001
6882,23295106,2023-02-06,-106.03,499.88
1225,23295106,2023-02-11,37.8,537.6800000000001
6883,23295106,2023-02-13,-110.4,427.28000000000003
1226,23295106,2023-02-14,1338.4,1765.68
414,23310842,2023-01-31,0.0,78.85
2329,23310842,2023-02-02,-176.64,-97.78999999999999
2626,23310842,2023-02-02,91.54,-6.249999999999986
2330,23310842,2023-02-05,-135.39,-141.63999999999996
2627,23310842,2023-02-05,12.08,-129.55999999999995
2331,23310842,2023-02-06,-878.3,-1007.8599999999998
2332,23310842,2023-02-06,-90.98,-1098.84
2628,23310842,2023-02-09,103.84,-994.9999999999999
2333,23310842,2023-02-12,-128.4,-1123.4
415,23321929,2023-01-31,0.0,408.3
5836,23321929,2023-02-04,123.51,531.8100000000001
8483,23321929,2023-02-11,-114.34,417.47
8484,23321929,2023-02-13,-214.61,202.86
5837,23321929,2023-02-13,47.15,250.01000000000002
416,23325248,2023-01-31,0.0,49.31
3665,23325248,2023-02-02,-137.59,-88.28
3666,23325248,2023-02-09,-182.37,-270.65000000000003
417,23333877,2023-01-31,0.0,648.46
2158,23333877,2023-02-01,-123.23,525.23
6950,23333877,2023-02-06,78.08,603.3100000000001
6951,23333877,2023-02-06,103.53,706.84
6952,23333877,2023-02-09,166.64,873.48
6953,23333877,2023-02-10,386.8,1260.28
6954,23333877,2023-02-11,85.02,1345.3000000000002
2159,23333877,2023-02-12,-93.16,1252.1399999999999
2160,23333877,2023-02-14,-153.66,1098.48
418,23369902,2023-01-31,0.0,716.79
1303,23369902,2023-02-01,129.91,846.6999999999999
1305,23369902,2023-02-05,118.28,964.98
1304,23369902,2023-02-05,165.04,1130.02
7939,23369902,2023-02-08,-124.8,1005.22
7940,23369902,2023-02-11,-111.88,893.3399999999999
7941,23369902,2023-02-13,-183.79,709.55
1306,23369902,2023-02-13,144.46,854.01
419,23415061,2023-01-31,0.0,71.2
756,23415061,2023-02-01,-102.1,-30.89999999999999
4874,23415061,2023-02-03,90.48,59.58000000000001
757,23415061,2023-02-04,-123.51,-63.92999999999999
4875,23415061,2023-02-04,1702.7,1638.7700000000002
4876,23415061,2023-02-10,1220.5,2859.2699999999995
420,23445508,2023-01-31,0.0,373.43
5765,23445508,2023-02-04,54.57,428.0
7523,23445508,2023-02-07,-85.73,342.27
7524,23445508,2023-02-09,-652.0,-309.72999999999996
7525,23445508,2023-02-11,-82.15,-391.87999999999994
7526,23445508,2023-02-13,-48.38,-440.25999999999993
5767,23445508,2023-02-13,23.17,-417.09
5766,23445508,2023-02-13,169.23,-247.85999999999996
421,23479459,2023-01-31,0.0,176.23
3401,23479459,2023-02-02,-117.71,58.519999999999996
3428,23479459,2023-02-02,121.53,180.05
3402,23479459,2023-02-05,-133.57,46.47999999999999
3429,23479459,2023-02-05,128.65,175.13
3430,23479459,2023-02-06,50.86,225.99
3431,23479459,2023-02-09,43.87,269.86
422,23490922,2023-01-31,0.0,934.35
6992,23490922,2023-02-06,-132.91,801.44
6993,23490922,2023-02-06,-76.95,724.49
7632,23490922,2023-02-07,78.1,802.59
7633,23490922,2023-02-10,75.99,878.58
423,23498368,2023-01-31,0.0,474.93
651,23498368,2023-02-01,101.12,576.05
7207,23498368,2023-02-06,-159.06,416.99
652,23498368,2023-02-06,107.32,524.31
653,23498368,2023-02-07,109.39,633.7
654,23498368,2023-02-11,92.54,726.24
656,23498368,2023-02-12,11.42,737.6600000000001
655,23498368,2023-02-12,98.68,836.34
7208,23498368,2023-02-13,-90.8,745.54
424,23501735,2023-01-31,0.0,562.17
6751,23501735,2023-02-06,107.54,669.7099999999999
7820,23501735,2023-02-08,-150.5,519.2099999999999
7821,23501735,2023-02-09,-42.25,476.96
7822,23501735,2023-02-10,-48.91,428.04999999999995
7823,23501735,2023-02-11,-75.76,352.28999999999996
7824,23501735,2023-02-12,-124.17,228.11999999999995
7825,23501735,2023-02-12,-89.44,138.67999999999995
6752,23501735,2023-02-12,142.78,281.46
425,23580422,2023-01-31,0.0,716.05
8582,23580422,2023-02-12,-67.25,648.8
426,23698615,2023-01-31,0.0,316.68
2831,23698615,2023-02-02,89.17,405.85
2832,23698615,2023-02-05,114.48,520.33
8512,23698615,2023-02-12,-98.68,421.65
427,23736501,2023-01-31,0.0,831.27
5853,23736501,2023-02-04,-157.68,673.5899999999999
5809,23736501,2023-02-04,192.0,865.5899999999999
5854,23736501,2023-02-07,-74.77,790.8199999999999
5855,23736501,2023-02-09,-36.06,754.76
5811,23736501,2023-02-09,57.19,811.9499999999999
5810,23736501,2023-02-09,182.37,994.3199999999999
5856,23736501,2023-02-10,-206.97,787.35
5857,23736501,2023-02-11,-42.47,744.88
5812,23736501,2023-02-14,85.48,830.36
428,23775829,2023-01-31,0.0,771.57
2645,23775829,2023-02-02,65.53,837.1
2646,23775829,2023-02-02,91.57,928.6700000000001
4454,23775829,2023-02-03,-65.94,862.73
4455,23775829,2023-02-03,-28.47,834.26
4456,23775829,2023-02-12,-104.51,729.75
2647,23775829,2023-02-13,101.49,831.24
429,23815822,2023-01-31,0.0,835.0
4768,23815822,2023-02-03,-96.94,738.06
4837,23815822,2023-02-03,1882.4,2620.46
4769,23815822,2023-02-05,-110.97,2509.49
4770,23815822,2023-02-13,-17.83,2491.66
430,23865100,2023-01-31,0.0,201.44
2871,23865100,2023-02-02,-52.86,148.57999999999998
2872,23865100,2023-02-05,-140.22,8.360000000000014
7034,23865100,2023-02-06,65.05,73.40999999999997
7035,23865100,2023-02-07,86.46,159.86999999999998
7037,23865100,2023-02-08,83.2,243.07
7036,23865100,2023-02-08,134.88,377.95
7038,23865100,2023-02-09,64.55,442.5
7039,23865100,2023-02-13,17.92,460.42
7040,23865100,2023-02-14,67.55,527.97
431,23920423,2023-01-31,0.0,221.15
4369,23920423,2023-02-03,-72.77,148.38
4368,23920423,2023-02-03,-48.23,100.15
4370,23920423,2023-02-05,-63.21,36.940000000000026
6440,23920423,2023-02-05,96.05,132.99
4371,23920423,2023-02-08,-161.43,-28.439999999999998
6442,23920423,2023-02-08,12.95,-15.490000000000009
6441,23920423,2023-02-08,38.77,23.28
6443,23920423,2023-02-11,141.71,164.99
432,23931414,2023-01-31,0.0,126.7
4153,23931414,2023-02-03,-32.07,94.63
4154,23931414,2023-02-10,-123.72,-29.08999999999999
8675,23931414,2023-02-14,101.76,72.67000000000002
433,23932793,2023-01-31,0.0,962.8
8594,23932793,2023-02-13,-510.4,452.4
8595,23932793,2023-02-14,-34.96,417.43999999999994
434,23935849,2023-01-31,0.0,888.11
8450,23935849,2023-02-11,103.93,992.04
8451,23935849,2023-02-12,191.46,1183.5
8452,23935849,2023-02-14,42.9,1226.4
435,23942646,2023-01-31,0.0,517.93
1000,23942646,2023-02-01,82.42,600.3499999999999
5514,23942646,2023-02-04,-104.07,496.28
5515,23942646,2023-02-06,-102.01,394.27
1001,23942646,2023-02-07,105.09,499.35999999999996
1002,23942646,2023-02-09,57.45,556.81
436,23959928,2023-01-31,0.0,878.83
3850,23959928,2023-02-03,1569.4,2448.23
5795,23959928,2023-02-04,-3.48,2444.75
5796,23959928,2023-02-07,-69.6,2375.15
3851,23959928,2023-02-14,41.12,2416.27
437,23962863,2023-01-31,0.0,307.07
2153,23962863,2023-02-01,-599.8,-292.72999999999996
2154,23962863,2023-02-03,-43.61,-336.34
2155,23962863,2023-02-04,-535.8,-872.1400000000001
6073,23962863,2023-02-05,171.75,-700.3899999999999
2156,23962863,2023-02-07,-1676.4,-2376.79
6074,23962863,2023-02-11,84.36,-2292.43
2157,23962863,2023-02-13,-92.64,-2385.07
6075,23962863,2023-02-13,123.27,-2261.8
438,23971753,2023-01-31,0.0,170.77
2997,23971753,2023-02-02,-169.64,1.1300000000000239
4082,23971753,2023-02-03,110.05,111.18000000000002
2998,23971753,2023-02-08,-120.67,-9.48999999999998
2999,23971753,2023-02-08,-37.07,-46.559999999999974
4083,23971753,2023-02-08,175.97,129.41000000000003
3001,23971753,2023-02-09,-1658.0,-1528.59
3000,23971753,2023-02-09,-142.67,-1671.26
3002,23971753,2023-02-10,-48.54,-1719.8
3003,23971753,2023-02-14,-194.38,-1914.1799999999998
4084,23971753,2023-02-14,123.69,-1790.4899999999998
439,24010877,2023-01-31,0.0,652.95
435,24010877,2023-02-01,107.29,760.24
2883,24010877,2023-02-02,-89.17,671.07
2884,24010877,2023-02-05,-154.98,516.09
2885,24010877,2023-02-10,-25.31,490.7800000000001
437,24010877,2023-02-10,12.48,503.26000000000005
436,24010877,2023-02-10,139.65,642.9100000000001
438,24010877,2023-02-11,122.96,765.8700000000001
2886,24010877,2023-02-12,-110.81,655.0600000000001
440,24051672,2023-01-31,0.0,429.37
3551,24051672,2023-02-02,-111.58,317.79
3552,24051672,2023-02-03,-208.28,109.50999999999999
3553,24051672,2023-02-03,-122.53,-13.019999999999982
3554,24051672,2023-02-06,-1069.9,-1082.92
6809,24051672,2023-02-06,50.67,-1032.25
6810,24051672,2023-02-08,13.16,-1019.09
6811,24051672,2023-02-08,122.65,-896.4399999999999
441,24076677,2023-01-31,0.0,494.74
5260,24076677,2023-02-04,-162.79,331.95000000000005
5433,24076677,2023-02-04,142.92,474.87
5434,24076677,2023-02-09,59.74,534.61
5435,24076677,2023-02-12,120.78,655.39
442,24085667,2023-01-31,0.0,249.1
1983,24085667,2023-02-01,78.1,327.2
4231,24085667,2023-02-03,-39.9,287.3
1984,24085667,2023-02-07,97.64,384.94
1985,24085667,2023-02-11,72.76,457.7
1986,24085667,2023-02-12,140.52,598.22
4232,24085667,2023-02-13,-102.35,495.87
1987,24085667,2023-02-14,130.66,626.53
443,24113784,2023-01-31,0.0,47.67
4907,24113784,2023-02-03,-965.4,-917.73
4908,24113784,2023-02-04,-1026.7,-1944.4299999999998
5043,24113784,2023-02-04,175.99,-1768.44
5044,24113784,2023-02-09,37.53,-1730.91
4909,24113784,2023-02-10,-55.38,-1786.29
5046,24113784,2023-02-10,98.69,-1687.6000000000001
5045,24113784,2023-02-10,131.38,-1556.22
4910,24113784,2023-02-11,-666.5,-2222.7200000000003
4911,24113784,2023-02-13,-76.07,-2298.79
4912,24113784,2023-02-13,-0.22,-2299.01
5047,24113784,2023-02-13,77.23,-2221.78
444,24122572,2023-01-31,0.0,924.02
4966,24122572,2023-02-03,-78.28,845.74
5310,24122572,2023-02-04,160.27,1006.01
5311,24122572,2023-02-04,362.7,1368.71
5312,24122572,2023-02-06,149.41,1518.12
4967,24122572,2023-02-09,-168.03,1350.09
4968,24122572,2023-02-11,-141.75,1208.34
5313,24122572,2023-02-11,86.77,1295.11
5314,24122572,2023-02-13,97.77,1392.88
5315,24122572,2023-02-13,118.46,1511.34
445,24123707,2023-01-31,0.0,327.69
2340,24123707,2023-02-02,120.26,447.95
2341,24123707,2023-02-09,1386.8,1834.75
446,24125563,2023-01-31,0.0,908.28
859,24125563,2023-02-01,98.33,1006.61
6935,24125563,2023-02-06,-73.5,933.11
860,24125563,2023-02-10,124.46,1057.57
861,24125563,2023-02-11,89.5,1147.07
862,24125563,2023-02-13,17.83,1164.9
447,24149353,2023-01-31,0.0,487.27
4129,24149353,2023-02-03,108.5,595.77
7063,24149353,2023-02-06,-1201.1,-605.3299999999999
4130,24149353,2023-02-06,38.61,-566.72
4131,24149353,2023-02-06,163.65,-403.06999999999994
448,24150990,2023-01-31,0.0,365.31
3498,24150990,2023-02-02,111.58,476.89
5247,24150990,2023-02-04,-47.39,429.5
3499,24150990,2023-02-04,134.81,564.31
5248,24150990,2023-02-05,-84.05,480.26
3500,24150990,2023-02-06,82.1,562.36
5249,24150990,2023-02-13,-185.87,376.49
3501,24150990,2023-02-14,91.7,468.19
449,24178466,2023-01-31,0.0,330.91
6958,24178466,2023-02-06,-114.81,216.10000000000002
6698,24178466,2023-02-06,79.47,295.57000000000005
6959,24178466,2023-02-08,-87.59,207.98000000000002
6960,24178466,2023-02-14,-96.17,111.81
450,24184530,2023-01-31,0.0,37.87
2243,24184530,2023-02-02,-83.33,-45.46
2244,24184530,2023-02-08,-1360.9,-1406.3600000000001
2245,24184530,2023-02-11,-175.16,-1581.5200000000002
8521,24184530,2023-02-12,143.0,-1438.5200000000002
451,24198488,2023-01-31,0.0,578.35
2251,24198488,2023-02-02,-168.98,409.37
5918,24198488,2023-02-05,83.59,492.96000000000004
5920,24198488,2023-02-05,94.38,587.34
5919,24198488,2023-02-05,133.57,720.9100000000001
2252,24198488,2023-02-09,-86.86,634.0500000000001
5921,24198488,2023-02-13,134.6,768.6500000000001
452,24250015,2023-01-31,0.0,592.59
848,24250015,2023-02-01,132.46,725.0500000000001
8393,24250015,2023-02-10,-871.2,-146.14999999999998
849,24250015,2023-02-10,84.84,-61.309999999999945
8394,24250015,2023-02-11,-115.25,-176.55999999999995
850,24250015,2023-02-11,107.86,-68.69999999999993
851,24250015,2023-02-12,1354.4,1285.7000000000003
453,24285988,2023-01-31,0.0,783.9
2656,24285988,2023-02-02,158.28,942.18
5954,24285988,2023-02-04,-58.09,884.0899999999999
2657,24285988,2023-02-05,963.3,1847.3899999999999
5955,24285988,2023-02-06,-149.08,1698.31
2658,24285988,2023-02-06,99.14,1797.4499999999998
5956,24285988,2023-02-14,-178.04,1619.4099999999999
5957,24285988,2023-02-14,-114.54,1504.87
454,24298516,2023-01-31,0.0,768.69
1297,24298516,2023-02-01,-74.43,694.26
4918,24298516,2023-02-03,177.23,871.49
4919,24298516,2023-02-09,63.75,935.24
4920,24298516,2023-02-09,146.1,1081.3400000000001
455,24299977,2023-01-31,0.0,199.33
588,24299977,2023-02-01,-218.14,-18.809999999999974
591,24299977,2023-02-01,-88.99,-107.79999999999998
590,24299977,2023-02-01,-62.95,-170.74999999999997
589,24299977,2023-02-01,-13.37,-184.11999999999998
3029,24299977,2023-02-02,114.88,-69.23999999999998
3030,24299977,2023-02-04,78.83,9.590000000000003
592,24299977,2023-02-06,-177.63,-168.04
593,24299977,2023-02-08,-88.44,-256.48
594,24299977,2023-02-10,-139.51,-395.9899999999999
595,24299977,2023-02-11,-102.84,-498.8299999999999
596,24299977,2023-02-13,-168.68,-667.51
3031,24299977,2023-02-13,118.4,-549.11
456,24308337,2023-01-31,0.0,764.57
2738,24308337,2023-02-02,-79.25,685.32
2740,24308337,2023-02-03,-886.6,-201.27999999999997
2739,24308337,2023-02-03,-123.6,-324.88
2741,24308337,2023-02-07,-1653.3,-1978.1799999999998
8158,24308337,2023-02-09,148.45,-1829.73
8159,24308337,2023-02-11,148.81,-1680.9199999999996
2742,24308337,2023-02-12,-146.05,-1826.9699999999998
8160,24308337,2023-02-13,959.6,-867.37
457,24370240,2023-01-31,0.0,608.64
1066,24370240,2023-02-01,-45.7,562.9399999999999
2240,24370240,2023-02-02,113.03,675.97
1067,24370240,2023-02-06,-137.34,538.63
1068,24370240,2023-02-07,-39.54,499.09
2241,24370240,2023-02-08,1245.5,1744.5900000000001
2242,24370240,2023-02-09,88.73,1833.3200000000002
2244,24370240,2023-02-13,136.9,1970.2199999999998
2243,24370240,2023-02-13,153.62,2123.84
2245,24370240,2023-02-14,63.74,2187.58
458,24382889,2023-01-31,0.0,14.23
5507,24382889,2023-02-04,68.76,82.99000000000001
5508,24382889,2023-02-06,69.68,152.67
5509,24382889,2023-02-12,68.37,221.04
8644,24382889,2023-02-13,-46.32,174.72
459,24406166,2023-01-31,0.0,746.97
8102,24406166,2023-02-09,96.52,843.49
8103,24406166,2023-02-09,132.48,975.97
8104,24406166,2023-02-10,149.61,1125.58
8466,24406166,2023-02-11,-103.18,1022.4
460,24434457,2023-01-31,0.0,385.3
4473,24434457,2023-02-03,2128.4,2513.7000000000003
8282,24434457,2023-02-10,-129.11,2384.59
461,24462859,2023-01-31,0.0,646.0
4813,24462859,2023-02-03,91.66,737.66
4814,24462859,2023-02-04,100.94,838.6
4815,24462859,2023-02-06,43.35,881.95
7270,24462859,2023-02-07,-120.64,761.31
4816,24462859,2023-02-08,136.38,897.69
7271,24462859,2023-02-09,-1855.5,-957.81
7272,24462859,2023-02-12,-20.21,-978.02
462,24510213,2023-01-31,0.0,142.59
8296,24510213,2023-02-10,-133.0,9.590000000000003
8685,24510213,2023-02-14,56.12,65.71000000000001
463,24513968,2023-01-31,0.0,306.35
635,24513968,2023-02-01,1277.2,1583.5500000000002
4578,24513968,2023-02-03,-110.56,1472.9900000000002
4579,24513968,2023-02-07,-111.37,1361.62
636,24513968,2023-02-13,80.72,1442.3400000000001
464,24516638,2023-01-31,0.0,426.16
5344,24516638,2023-02-04,-80.86,345.3
8143,24516638,2023-02-09,121.34,466.64000000000004
5345,24516638,2023-02-11,-26.95,439.69000000000005
8144,24516638,2023-02-14,117.24,556.9300000000001
8145,24516638,2023-02-14,124.79,681.72
465,24519138,2023-01-31,0.0,58.15
1696,24519138,2023-02-01,-123.96,-65.81
5091,24519138,2023-02-04,119.74,53.93
1697,24519138,2023-02-06,-742.3,-688.37
5092,24519138,2023-02-10,39.7,-648.67
5093,24519138,2023-02-11,887.8,239.13000000000002
1698,24519138,2023-02-13,-139.83,99.30000000000001
1699,24519138,2023-02-13,-52.77,46.53
5094,24519138,2023-02-13,166.98,213.51
1700,24519138,2023-02-14,-156.38,57.12999999999999
5095,24519138,2023-02-14,126.36,183.48999999999998
466,24529850,2023-01-31,0.0,800.79
4617,24529850,2023-02-03,105.07,905.8599999999999
7462,24529850,2023-02-07,-103.43,802.43
7463,24529850,2023-02-08,-2283.2,-1480.77
4618,24529850,2023-02-08,135.88,-1344.8899999999999
7465,24529850,2023-02-09,-196.64,-1541.5299999999997
7464,24529850,2023-02-09,-136.3,-1677.83
7466,24529850,2023-02-09,-103.19,-1781.02
7467,24529850,2023-02-09,-62.59,-1843.6100000000001
7468,24529850,2023-02-11,-122.71,-1966.3200000000002
7469,24529850,2023-02-14,-79.12,-2045.44
4619,24529850,2023-02-14,665.3,-1380.1399999999999
467,24531428,2023-01-31,0.0,565.21
4701,24531428,2023-02-03,-80.5,484.71000000000004
8448,24531428,2023-02-11,49.15,533.86
4702,24531428,2023-02-12,-89.04,444.82000000000005
468,24533829,2023-01-31,0.0,190.8
1506,24533829,2023-02-01,118.62,309.42
3458,24533829,2023-02-02,-180.4,129.02
3459,24533829,2023-02-09,-105.21,23.810000000000002
3460,24533829,2023-02-11,-56.69,-32.879999999999995
3461,24533829,2023-02-14,-52.36,-85.23999999999995
469,24533935,2023-01-31,0.0,808.99
2932,24533935,2023-02-02,-13.68,795.3100000000001
2933,24533935,2023-02-06,-114.86,680.45
7192,24533935,2023-02-06,59.42,739.87
7193,24533935,2023-02-07,118.19,858.06
7194,24533935,2023-02-11,95.27,953.3299999999999
2934,24533935,2023-02-12,-37.35,915.98
7196,24533935,2023-02-14,85.15,1001.13
7195,24533935,2023-02-14,139.74,1140.87
470,24539679,2023-01-31,0.0,768.68
3681,24539679,2023-02-02,-22.39,746.29
2483,24539679,2023-02-02,950.2,1696.49
2484,24539679,2023-02-05,58.5,1754.99
2485,24539679,2023-02-07,1151.1,2906.0899999999997
3682,24539679,2023-02-09,-127.72,2778.37
3683,24539679,2023-02-10,-114.72,2663.6499999999996
3684,24539679,2023-02-11,-35.03,2628.62
3686,24539679,2023-02-14,-125.94,2502.68
3685,24539679,2023-02-14,-68.67,2434.0099999999998
2486,24539679,2023-02-14,104.91,2538.9199999999996
471,24577383,2023-01-31,0.0,911.96
2866,24577383,2023-02-02,88.1,1000.0600000000001
7994,24577383,2023-02-08,-152.99,847.07
2867,24577383,2023-02-11,49.94,897.01
2868,24577383,2023-02-11,120.57,1017.58
7995,24577383,2023-02-14,-1191.7,-174.12000000000012
2869,24577383,2023-02-14,131.53,-42.590000000000146
472,24638469,2023-01-31,0.0,968.27
1260,24638469,2023-02-01,-209.89,758.38
1261,24638469,2023-02-11,-127.49,630.89
473,24669065,2023-01-31,0.0,574.3
8013,24669065,2023-02-09,87.21,661.51
8442,24669065,2023-02-11,-74.61,586.9
8443,24669065,2023-02-11,-65.05,521.8499999999999
8444,24669065,2023-02-14,-162.09,359.75999999999993
474,24715803,2023-01-31,0.0,684.75
6866,24715803,2023-02-06,131.6,816.35
8221,24715803,2023-02-10,-85.88,730.47
6867,24715803,2023-02-10,88.61,819.0799999999999
8222,24715803,2023-02-13,-117.96,701.12
8223,24715803,2023-02-14,-80.46,620.66
475,24725325,2023-01-31,0.0,567.17
5929,24725325,2023-02-04,-27.77,539.4
5931,24725325,2023-02-06,-143.3,396.0999999999999
5930,24725325,2023-02-06,-78.29,317.80999999999995
5932,24725325,2023-02-08,-150.55,167.25999999999993
8009,24725325,2023-02-09,129.85,297.1099999999999
5934,24725325,2023-02-12,-139.56,157.54999999999995
5933,24725325,2023-02-12,-11.42,146.12999999999994
476,24796881,2023-01-31,0.0,943.93
6667,24796881,2023-02-06,111.33,1055.26
6668,24796881,2023-02-08,89.09,1144.35
6669,24796881,2023-02-09,125.13,1269.48
8385,24796881,2023-02-10,-89.61,1179.87
8386,24796881,2023-02-14,-52.73,1127.1399999999999
6671,24796881,2023-02-14,122.9,1250.04
6670,24796881,2023-02-14,142.18,1392.22
477,24826358,2023-01-31,0.0,923.46
7018,24826358,2023-02-06,-113.2,810.26
7019,24826358,2023-02-08,-151.47,658.79
7813,24826358,2023-02-08,123.43,782.22
7020,24826358,2023-02-09,-170.19,612.0300000000001
7021,24826358,2023-02-09,-107.86,504.1700000000001
7814,24826358,2023-02-10,355.2,859.3700000000001
7815,24826358,2023-02-14,72.61,931.98
478,24849103,2023-01-31,0.0,381.36
901,24849103,2023-02-01,-83.41,297.95000000000005
902,24849103,2023-02-02,-104.28,193.67000000000002
903,24849103,2023-02-05,-174.13,19.54000000000002
8353,24849103,2023-02-10,143.73,163.27
904,24849103,2023-02-11,-185.47,-22.19999999999999
905,24849103,2023-02-12,-77.02,-99.21999999999997
906,24849103,2023-02-13,-142.2,-241.41999999999996
8354,24849103,2023-02-13,125.61,-115.80999999999995
8355,24849103,2023-02-14,18.23,-97.57999999999998
479,24859951,2023-01-31,0.0,950.69
7974,24859951,2023-02-08,-204.91,745.7800000000001
7975,24859951,2023-02-09,-58.69,687.09
7976,24859951,2023-02-13,-74.74,612.3500000000001
480,24860683,2023-01-31,0.0,982.97
425,24860683,2023-02-01,-114.22,868.75
426,24860683,2023-02-06,-8.35,860.4000000000001
7199,24860683,2023-02-06,163.9,1024.3
427,24860683,2023-02-08,-941.0,83.30000000000007
7200,24860683,2023-02-09,108.36,191.66000000000008
7201,24860683,2023-02-10,83.94,275.6
7202,24860683,2023-02-10,92.9,368.5000000000001
481,24976861,2023-01-31,0.0,982.53
1575,24976861,2023-02-01,91.95,1074.48
1576,24976861,2023-02-02,190.68,1265.1599999999999
5161,24976861,2023-02-04,-133.05,1132.11
5160,24976861,2023-02-04,-64.92,1067.19
1578,24976861,2023-02-06,104.1,1171.29
1577,24976861,2023-02-06,110.9,1282.19
1579,24976861,2023-02-10,145.54,1427.73
1580,24976861,2023-02-11,105.42,1533.15
1581,24976861,2023-02-14,34.07,1567.2199999999998
482,24999129,2023-01-31,0.0,750.61
3877,24999129,2023-02-03,-179.75,570.86
6327,24999129,2023-02-05,173.68,744.54
3878,24999129,2023-02-09,-75.79,668.75
3879,24999129,2023-02-09,-38.13,630.62
3880,24999129,2023-02-13,-731.4,-100.77999999999997
6328,24999129,2023-02-13,70.3,-30.480000000000018
483,25004339,2023-01-31,0.0,120.44
4542,25004339,2023-02-03,-131.18,-10.740000000000009
4700,25004339,2023-02-03,79.25,68.50999999999999
4701,25004339,2023-02-05,56.51,125.01999999999998
4702,25004339,2023-02-05,102.38,227.39999999999998
4703,25004339,2023-02-07,92.13,319.53
4543,25004339,2023-02-14,-89.42,230.10999999999996
4704,25004339,2023-02-14,79.28,309.39
484,25006771,2023-01-31,0.0,600.16
146,25006771,2023-02-01,-94.29,505.86999999999995
1569,25006771,2023-02-01,143.83,649.6999999999999
1570,25006771,2023-02-01,2027.7,2677.4
1571,25006771,2023-02-03,119.1,2796.5
1573,25006771,2023-02-04,95.64,2892.14
1572,25006771,2023-02-04,105.81,2997.95
1574,25006771,2023-02-12,2147.9,5145.85
485,25033680,2023-01-31,0.0,639.47
1425,25033680,2023-02-01,-615.8,23.670000000000073
1426,25033680,2023-02-02,-412.3,-388.6299999999999
2854,25033680,2023-02-02,82.11,-306.52
1427,25033680,2023-02-07,-78.73,-385.25
1428,25033680,2023-02-08,-169.4,-554.6499999999999
1429,25033680,2023-02-09,-120.08,-674.73
2855,25033680,2023-02-10,142.57,-532.1600000000001
486,25099734,2023-01-31,0.0,872.31
2210,25099734,2023-02-02,-177.88,694.43
2212,25099734,2023-02-03,-124.18,570.25
2211,25099734,2023-02-03,-117.86,452.38999999999993
2213,25099734,2023-02-04,-39.71,412.67999999999995
6425,25099734,2023-02-05,193.92,606.5999999999999
2214,25099734,2023-02-09,-155.22,451.37999999999994
2215,25099734,2023-02-14,-38.18,413.19999999999993
487,25110012,2023-01-31,0.0,300.03
1518,25110012,2023-02-01,103.35,403.38
6903,25110012,2023-02-06,-104.85,298.53
6904,25110012,2023-02-08,-129.86,168.66999999999996
6905,25110012,2023-02-09,-118.7,49.96999999999997
1519,25110012,2023-02-09,6.19,56.15999999999997
6906,25110012,2023-02-13,-104.02,-47.860000000000014
6907,25110012,2023-02-13,-53.93,-101.79000000000002
488,25133996,2023-01-31,0.0,419.22
5745,25133996,2023-02-04,-103.33,315.89000000000004
5188,25133996,2023-02-04,130.57,446.46000000000004
5746,25133996,2023-02-07,-174.77,271.69
5747,25133996,2023-02-08,-34.38,237.31000000000003
5189,25133996,2023-02-11,107.4,344.71000000000004
5748,25133996,2023-02-12,-68.8,275.91
5749,25133996,2023-02-14,-42.13,233.78000000000003
489,25146667,2023-01-31,0.0,534.11
1054,25146667,2023-02-01,-830.7,-296.59000000000003
8327,25146667,2023-02-10,99.46,-197.13
8328,25146667,2023-02-11,41.23,-155.9000000000001
8329,25146667,2023-02-12,105.79,-50.110000000000014
8330,25146667,2023-02-13,229.21,179.09999999999997
1055,25146667,2023-02-14,-201.77,-22.670000000000073
8332,25146667,2023-02-14,0.73,-21.940000000000055
8331,25146667,2023-02-14,129.18,107.23999999999995
490,25240031,2023-01-31,0.0,520.29
3442,25240031,2023-02-02,140.31,660.5999999999999
3443,25240031,2023-02-03,125.77,786.3699999999999
7770,25240031,2023-02-08,-57.72,728.65
7771,25240031,2023-02-09,-175.48,553.17
491,25269707,2023-01-31,0.0,770.38
5288,25269707,2023-02-04,-131.28,639.1
5289,25269707,2023-02-04,-88.89,550.21
5483,25269707,2023-02-04,110.37,660.58
5484,25269707,2023-02-08,67.93,728.51
5485,25269707,2023-02-13,97.59,826.1
492,25281513,2023-01-31,0.0,618.78
2577,25281513,2023-02-02,78.21,696.99
6266,25281513,2023-02-05,-99.57,597.42
493,25310962,2023-01-31,0.0,376.9
1479,25310962,2023-02-01,98.74,475.64
2690,25310962,2023-02-02,-58.7,416.93999999999994
2691,25310962,2023-02-05,-134.95,281.99
2692,25310962,2023-02-06,-222.12,59.870000000000005
494,25318205,2023-01-31,0.0,582.9
4729,25318205,2023-02-03,-140.51,442.39
4731,25318205,2023-02-07,-161.73,280.65999999999997
4730,25318205,2023-02-07,-97.67,182.99
8310,25318205,2023-02-10,90.09,273.08
8311,25318205,2023-02-13,105.4,378.48
495,25406407,2023-01-31,0.0,394.05
1846,25406407,2023-02-01,56.06,450.11
4088,25406407,2023-02-03,-158.72,291.39
4089,25406407,2023-02-05,-226.81,64.57999999999998
1847,25406407,2023-02-06,140.67,205.25
1848,25406407,2023-02-07,120.62,325.87
1849,25406407,2023-02-09,165.96,491.83000000000004
4090,25406407,2023-02-10,-174.95,316.88
4091,25406407,2023-02-10,-29.92,286.96000000000004
4092,25406407,2023-02-11,-218.81,68.15000000000003
1850,25406407,2023-02-11,66.62,134.77000000000004
496,25412464,2023-01-31,0.0,203.46
2897,25412464,2023-02-02,107.62,311.08000000000004
4913,25412464,2023-02-03,-87.6,223.48000000000002
2898,25412464,2023-02-04,82.87,306.35
2899,25412464,2023-02-04,191.64,497.99
4914,25412464,2023-02-05,-90.59,407.4
2900,25412464,2023-02-07,96.86,504.26
4915,25412464,2023-02-09,-38.42,465.84000000000003
4916,25412464,2023-02-13,-106.97,358.87
497,25439304,2023-01-31,0.0,890.08
993,25439304,2023-02-01,-126.4,763.6800000000001
994,25439304,2023-02-05,-159.54,604.1400000000001
498,25504032,2023-01-31,0.0,838.81
2279,25504032,2023-02-02,-147.42,691.39
2278,25504032,2023-02-02,-89.88,601.51
2280,25504032,2023-02-06,-133.47,468.03999999999996
499,25510430,2023-01-31,0.0,110.66
4352,25510430,2023-02-03,159.23,269.89
5760,25510430,2023-02-04,-74.75,195.14
5761,25510430,2023-02-06,-79.47,115.66999999999999
4353,25510430,2023-02-06,1359.0,1474.67
5762,25510430,2023-02-09,-143.27,1331.4
5763,25510430,2023-02-09,-87.21,1244.19
4354,25510430,2023-02-09,145.58,1389.7700000000002
4355,25510430,2023-02-10,92.86,1482.63
4356,25510430,2023-02-11,59.3,1541.93
500,25522226,2023-01-31,0.0,428.21
3625,25522226,2023-02-02,92.61,520.8199999999999
3626,25522226,2023-02-04,1410.9,1931.72
7106,25522226,2023-02-06,-161.37,1770.35
3627,25522226,2023-02-07,70.76,1841.1100000000001
3628,25522226,2023-02-10,111.11,1952.22
3630,25522226,2023-02-11,99.57,2051.79
3629,25522226,2023-02-11,158.64,2210.43
501,25584693,2023-01-31,0.0,793.42
6814,25584693,2023-02-06,96.19,889.6099999999999
6815,25584693,2023-02-06,308.7,1198.31
6816,25584693,2023-02-07,142.6,1340.9099999999999
6817,25584693,2023-02-08,693.4,2034.31
8081,25584693,2023-02-09,-184.91,1849.4
8082,25584693,2023-02-13,-98.45,1750.9499999999998
6818,25584693,2023-02-13,145.19,1896.1399999999999
6819,25584693,2023-02-13,193.1,2089.24
6820,25584693,2023-02-14,117.12,2206.36
502,25596483,2023-01-31,0.0,595.87
2635,25596483,2023-02-02,-160.62,435.25
6473,25596483,2023-02-05,80.23,515.48
6474,25596483,2023-02-07,171.64,687.12
6475,25596483,2023-02-10,105.35,792.47
503,25628234,2023-01-31,0.0,808.37
2995,25628234,2023-02-02,-92.36,716.01
2229,25628234,2023-02-02,57.66,773.67
2230,25628234,2023-02-07,43.31,816.98
2996,25628234,2023-02-09,-159.54,657.44
2231,25628234,2023-02-09,68.25,725.69
2232,25628234,2023-02-12,67.6,793.29
2233,25628234,2023-02-12,140.22,933.51
504,25636885,2023-01-31,0.0,755.58
3455,25636885,2023-02-02,20.11,775.69
3456,25636885,2023-02-02,412.3,1187.99
3458,25636885,2023-02-08,92.86,1280.85
3457,25636885,2023-02-08,93.01,1373.8600000000001
8374,25636885,2023-02-10,-1048.2,325.65999999999997
3459,25636885,2023-02-10,151.75,477.40999999999997
8375,25636885,2023-02-12,-77.54,399.86999999999995
8376,25636885,2023-02-13,-140.3,259.56999999999994
505,25677428,2023-01-31,0.0,307.44
4751,25677428,2023-02-03,-56.35,251.09
7297,25677428,2023-02-07,114.28,365.37
4752,25677428,2023-02-12,-1601.3,-1235.9299999999998
506,25678043,2023-01-31,0.0,49.06
6865,25678043,2023-02-06,-133.66,-84.6
6864,25678043,2023-02-06,-71.4,-156.0
7956,25678043,2023-02-08,2283.2,2127.2
6866,25678043,2023-02-10,-34.35,2092.85
6867,25678043,2023-02-11,-110.5,1982.35
6868,25678043,2023-02-12,-180.46,1801.8899999999999
6869,25678043,2023-02-13,-384.8,1417.0899999999997
507,25698177,2023-01-31,0.0,923.38
4547,25698177,2023-02-03,131.18,1054.56
5281,25698177,2023-02-04,-124.06,930.5
4548,25698177,2023-02-04,55.58,986.08
4549,25698177,2023-02-04,81.16,1067.24
4550,25698177,2023-02-06,1524.9,2592.1400000000003
4551,25698177,2023-02-08,150.64,2742.78
4552,25698177,2023-02-09,892.4,3635.1800000000003
5282,25698177,2023-02-11,-182.11,3453.07
4554,25698177,2023-02-12,124.17,3577.2400000000002
4553,25698177,2023-02-12,791.8,4369.04
508,25710768,2023-01-31,0.0,968.16
509,25737886,2023-01-31,0.0,410.76
5593,25737886,2023-02-04,121.97,532.73
5594,25737886,2023-02-05,196.0,728.73
5595,25737886,2023-02-10,196.24,924.97
8454,25737886,2023-02-11,-122.96,802.01
5597,25737886,2023-02-11,65.05,867.06
5596,25737886,2023-02-11,143.94,1011.0
8455,25737886,2023-02-12,-78.26,932.74
5598,25737886,2023-02-12,107.09,1039.83
5599,25737886,2023-02-14,119.1,1158.9299999999998
510,25746852,2023-01-31,0.0,320.7
1787,25746852,2023-02-01,-86.44,234.26
1788,25746852,2023-02-04,-91.22,143.04
7901,25746852,2023-02-08,49.64,192.68
1789,25746852,2023-02-10,-1524.4,-1331.72
7902,25746852,2023-02-12,156.13,-1175.59
7903,25746852,2023-02-13,77.91,-1097.68
1790,25746852,2023-02-14,-1485.7,-2583.38
511,25768265,2023-01-31,0.0,702.22
3467,25768265,2023-02-02,-1902.2,-1199.98
3468,25768265,2023-02-06,-1502.6,-2702.58
6905,25768265,2023-02-06,121.72,-2580.8599999999997
6906,25768265,2023-02-08,72.17,-2508.6899999999996
6907,25768265,2023-02-09,113.82,-2394.87
3469,25768265,2023-02-10,-82.0,-2476.87
3470,25768265,2023-02-14,-145.06,-2621.9300000000003
512,25779398,2023-01-31,0.0,967.13
2865,25779398,2023-02-02,-134.24,832.89
5486,25779398,2023-02-04,66.32,899.21
2866,25779398,2023-02-05,-100.05,799.16
2867,25779398,2023-02-11,-161.33,637.8299999999999
5487,25779398,2023-02-11,1104.5,1742.33
513,25787771,2023-01-31,0.0,494.02
2678,25787771,2023-02-02,127.28,621.3
2679,25787771,2023-02-06,143.42,764.72
2680,25787771,2023-02-06,154.47,919.1899999999999
7557,25787771,2023-02-07,-742.8,176.39
2682,25787771,2023-02-07,48.04,224.43
2681,25787771,2023-02-07,64.41,288.84
7558,25787771,2023-02-08,-117.36,171.47999999999996
2683,25787771,2023-02-09,74.98,246.45999999999998
7559,25787771,2023-02-10,-128.96,117.5
2684,25787771,2023-02-10,150.3,267.79999999999995
2685,25787771,2023-02-10,1662.6,1930.3999999999999
2686,25787771,2023-02-11,126.14,2056.54
2688,25787771,2023-02-13,61.53,2118.0699999999997
2687,25787771,2023-02-13,154.81,2272.88
514,25807378,2023-01-31,0.0,25.32
5576,25807378,2023-02-04,-120.85,-95.53
8193,25807378,2023-02-10,51.27,-44.259999999999984
515,25893329,2023-01-31,0.0,211.58
7969,25893329,2023-02-08,-218.9,-7.319999999999993
7970,25893329,2023-02-12,-176.03,-183.35
516,25931435,2023-01-31,0.0,127.08
2120,25931435,2023-02-01,-69.52,57.56
7558,25931435,2023-02-07,199.86,257.42
2121,25931435,2023-02-08,-111.03,146.39000000000004
517,25939481,2023-01-31,0.0,502.59
1670,25939481,2023-02-01,106.3,608.89
6145,25939481,2023-02-05,-101.46,507.42999999999995
1671,25939481,2023-02-10,52.02,559.4499999999999
518,25941557,2023-01-31,0.0,656.34
969,25941557,2023-02-01,-818.4,-162.05999999999995
970,25941557,2023-02-01,-61.87,-223.92999999999995
2202,25941557,2023-02-02,34.56,-189.3699999999999
971,25941557,2023-02-03,-96.63,-285.9999999999999
972,25941557,2023-02-05,-37.99,-323.9899999999999
973,25941557,2023-02-06,-100.34,-424.33000000000004
974,25941557,2023-02-08,-130.43,-554.7599999999999
2203,25941557,2023-02-10,69.68,-485.08000000000004
2204,25941557,2023-02-10,175.95,-309.13
2205,25941557,2023-02-12,1601.3,1292.17
2206,25941557,2023-02-13,149.9,1442.07
519,26008806,2023-01-31,0.0,553.23
2705,26008806,2023-02-02,205.49,758.72
2706,26008806,2023-02-03,105.92,864.6400000000001
6549,26008806,2023-02-05,-168.21,696.4300000000001
2707,26008806,2023-02-05,121.03,817.46
2708,26008806,2023-02-06,72.35,889.81
520,26023976,2023-01-31,0.0,681.17
4074,26023976,2023-02-03,90.66,771.8299999999999
4075,26023976,2023-02-06,885.9,1657.73
521,26070761,2023-01-31,0.0,641.67
7695,26070761,2023-02-07,1076.8,1718.4699999999998
7696,26070761,2023-02-11,93.32,1811.79
7697,26070761,2023-02-13,105.17,1916.96
8681,26070761,2023-02-14,-103.89,1813.0699999999997
522,26087369,2023-01-31,0.0,653.2
567,26087369,2023-02-01,-47.33,605.87
568,26087369,2023-02-02,-130.93,474.94000000000005
569,26087369,2023-02-10,-67.07,407.87000000000006
570,26087369,2023-02-14,-72.4,335.47
523,26101648,2023-01-31,0.0,9.84
3815,26101648,2023-02-03,76.87,86.71000000000001
3816,26101648,2023-02-04,97.94,184.65
524,26102798,2023-01-31,0.0,104.08
4800,26102798,2023-02-03,-144.82,-40.739999999999995
4801,26102798,2023-02-04,-182.66,-223.40000000000003
4802,26102798,2023-02-05,-113.1,-336.5
4803,26102798,2023-02-07,-162.11,-498.61000000000007
4804,26102798,2023-02-09,-108.34,-606.9499999999999
4805,26102798,2023-02-10,-158.38,-765.3299999999999
8606,26102798,2023-02-12,108.99,-656.3399999999999
4807,26102798,2023-02-14,-156.56,-812.9
4806,26102798,2023-02-14,-63.34,-876.24
4808,26102798,2023-02-14,-58.63,-934.87
525,26109213,2023-01-31,0.0,698.97
3453,26109213,2023-02-02,-1586.6,-887.6299999999999
3454,26109213,2023-02-05,-26.93,-914.56
6403,26109213,2023-02-05,1315.1,400.53999999999996
3455,26109213,2023-02-06,-73.4,327.14
6404,26109213,2023-02-06,55.84,382.97999999999996
6405,26109213,2023-02-08,104.18,487.15999999999997
3456,26109213,2023-02-09,-105.79,381.36999999999995
6406,26109213,2023-02-09,109.32,490.68999999999994
6407,26109213,2023-02-12,81.37,572.06
3457,26109213,2023-02-13,-193.1,378.96
526,26115121,2023-01-31,0.0,466.67
4817,26115121,2023-02-03,-84.79,381.88
3880,26115121,2023-02-03,144.61,526.49
3881,26115121,2023-02-14,97.12,623.61
527,26118463,2023-01-31,0.0,981.0
1611,26118463,2023-02-01,127.46,1108.46
4020,26118463,2023-02-03,-104.95,1003.51
4021,26118463,2023-02-12,-96.4,907.11
528,26248782,2023-01-31,0.0,70.58
2636,26248782,2023-02-02,-130.23,-59.64999999999999
6830,26248782,2023-02-06,71.52,11.870000000000005
2637,26248782,2023-02-11,-28.34,-16.47
2638,26248782,2023-02-13,-138.97,-155.44
529,26375186,2023-01-31,0.0,804.02
6946,26375186,2023-02-06,-154.75,649.27
6758,26375186,2023-02-06,46.31,695.5799999999999
6757,26375186,2023-02-06,97.54,793.12
6756,26375186,2023-02-06,168.93,962.05
6759,26375186,2023-02-07,125.96,1088.01
6760,26375186,2023-02-08,167.59,1255.6
6947,26375186,2023-02-10,-73.99,1181.6100000000001
6948,26375186,2023-02-11,-135.38,1046.23
6761,26375186,2023-02-14,1650.9,2697.13
530,26432558,2023-01-31,0.0,465.32
1582,26432558,2023-02-01,-32.75,432.57
293,26432558,2023-02-01,27.36,459.93
294,26432558,2023-02-01,28.95,488.88
292,26432558,2023-02-01,189.07,677.95
295,26432558,2023-02-03,169.95,847.9
1583,26432558,2023-02-04,-139.51,708.39
296,26432558,2023-02-06,25.86,734.25
297,26432558,2023-02-06,1543.0,2277.25
1584,26432558,2023-02-07,-1121.9,1155.35
531,26506201,2023-01-31,0.0,592.7
5980,26506201,2023-02-05,-43.28,549.4200000000001
5988,26506201,2023-02-05,159.54,708.96
5989,26506201,2023-02-07,135.69,844.6500000000001
5990,26506201,2023-02-09,8.38,853.03
5981,26506201,2023-02-11,-1215.8,-362.77
532,26522255,2023-01-31,0.0,283.67
2665,26522255,2023-02-02,-56.84,226.83
2666,26522255,2023-02-08,-1127.1,-900.2699999999998
2667,26522255,2023-02-13,-1085.6,-1985.87
2668,26522255,2023-02-14,-129.25,-2115.12
2669,26522255,2023-02-14,-120.06,-2235.18
533,26528251,2023-01-31,0.0,539.97
8452,26528251,2023-02-11,-108.59,431.38
8453,26528251,2023-02-13,-155.36,276.02
8671,26528251,2023-02-14,102.55,378.57
534,26632358,2023-01-31,0.0,384.64
82,26632358,2023-02-01,180.83,565.47
81,26632358,2023-02-01,182.19,747.66
83,26632358,2023-02-02,61.7,809.36
84,26632358,2023-02-07,1029.9,1839.2600000000002
85,26632358,2023-02-09,82.99,1922.25
8501,26632358,2023-02-11,-24.9,1897.35
86,26632358,2023-02-13,1487.7,3385.0499999999997
535,26643616,2023-01-31,0.0,260.1
1675,26643616,2023-02-01,-137.72,122.38000000000002
863,26643616,2023-02-01,90.79,213.17000000000002
1676,26643616,2023-02-05,-160.91,52.26000000000005
864,26643616,2023-02-09,74.6,126.86000000000001
865,26643616,2023-02-11,170.89,297.75
1677,26643616,2023-02-12,-121.86,175.89
866,26643616,2023-02-14,129.29,305.18
536,26669001,2023-01-31,0.0,70.04
4133,26669001,2023-02-03,21.03,91.07000000000001
4132,26669001,2023-02-03,56.31,147.38
8431,26669001,2023-02-11,-1318.1,-1170.72
8432,26669001,2023-02-11,-142.29,-1313.01
8434,26669001,2023-02-14,-634.0,-1947.01
8433,26669001,2023-02-14,-94.21,-2041.2199999999998
537,26675311,2023-01-31,0.0,989.13
3095,26675311,2023-02-02,-114.88,874.25
3096,26675311,2023-02-07,-15.66,858.59
3097,26675311,2023-02-09,-155.29,703.3
8152,26675311,2023-02-09,27.53,730.83
3100,26675311,2023-02-11,-181.25,549.58
3098,26675311,2023-02-11,-41.86,507.72
3099,26675311,2023-02-11,-22.62,485.1
3101,26675311,2023-02-13,-124.33,360.77
3102,26675311,2023-02-14,-64.87,295.9
538,26751921,2023-01-31,0.0,800.07
8667,26751921,2023-02-14,127.34,927.4100000000001
8668,26751921,2023-02-14,132.36,1059.77
539,26791907,2023-01-31,0.0,266.27
1973,26791907,2023-02-01,-126.46,139.81
1974,26791907,2023-02-09,-624.2,-484.3900000000001
8582,26791907,2023-02-12,79.75,-404.6400000000001
1975,26791907,2023-02-13,-181.54,-586.1800000000001
540,26793058,2023-01-31,0.0,384.98
4846,26793058,2023-02-03,44.59,429.57000000000005
4847,26793058,2023-02-05,20.17,449.74
4848,26793058,2023-02-06,687.1,1136.8400000000001
7784,26793058,2023-02-08,-70.15,1066.69
541,26863880,2023-01-31,0.0,818.47
6044,26863880,2023-02-05,-115.12,703.35
6045,26863880,2023-02-05,-88.7,614.6500000000001
6046,26863880,2023-02-07,-102.54,512.11
7890,26863880,2023-02-08,946.2,1458.31
6047,26863880,2023-02-09,-107.47,1350.8400000000001
7892,26863880,2023-02-14,76.32,1427.16
7891,26863880,2023-02-14,101.53,1528.69
542,26874415,2023-01-31,0.0,19.62
3447,26874415,2023-02-02,-2269.2,-2249.58
3448,26874415,2023-02-03,-111.84,-2361.42
5542,26874415,2023-02-04,86.74,-2274.68
5541,26874415,2023-02-04,523.6,-1751.08
5543,26874415,2023-02-05,95.35,-1655.73
5544,26874415,2023-02-05,121.41,-1534.32
3449,26874415,2023-02-08,-52.99,-1587.31
5545,26874415,2023-02-11,99.56,-1487.75
543,26884718,2023-01-31,0.0,573.65
1184,26884718,2023-02-01,114.47,688.12
1185,26884718,2023-02-02,482.7,1170.82
4380,26884718,2023-02-03,-118.63,1052.19
4379,26884718,2023-02-03,-20.42,1031.77
1186,26884718,2023-02-04,150.38,1182.15
1187,26884718,2023-02-08,149.83,1331.98
4381,26884718,2023-02-10,-47.01,1284.97
1188,26884718,2023-02-11,146.56,1431.53
544,26888158,2023-01-31,0.0,473.02
3312,26888158,2023-02-02,-15.77,457.25
3657,26888158,2023-02-02,70.88,528.13
3313,26888158,2023-02-05,-1022.3,-494.16999999999996
3658,26888158,2023-02-12,179.93,-314.24
545,26893181,2023-01-31,0.0,957.43
227,26893181,2023-02-01,-169.18,788.25
228,26893181,2023-02-01,-65.9,722.3499999999999
539,26893181,2023-02-01,116.66,839.01
229,26893181,2023-02-03,-613.0,226.00999999999988
540,26893181,2023-02-10,89.11,315.1199999999999
546,26906533,2023-01-31,0.0,312.58
6208,26906533,2023-02-05,-58.5,254.07999999999998
6383,26906533,2023-02-05,104.74,358.82
6209,26906533,2023-02-07,-34.65,324.16999999999996
6384,26906533,2023-02-08,13.32,337.49
6210,26906533,2023-02-10,-75.71,261.78
6385,26906533,2023-02-12,89.48,351.26
6386,26906533,2023-02-14,50.82,402.08
547,26907311,2023-01-31,0.0,842.69
6287,26907311,2023-02-05,-1195.0,-352.30999999999995
6029,26907311,2023-02-05,103.21,-249.0999999999999
6288,26907311,2023-02-07,-93.19,-342.28999999999996
6030,26907311,2023-02-07,125.73,-216.55999999999995
6289,26907311,2023-02-09,-160.54,-377.0999999999999
6031,26907311,2023-02-10,61.2,-315.89999999999986
6032,26907311,2023-02-13,74.01,-241.88999999999987
548,26953669,2023-01-31,0.0,813.21
1756,26953669,2023-02-01,81.22,894.4300000000001
1757,26953669,2023-02-02,528.9,1423.33
4810,26953669,2023-02-03,-100.42,1322.91
1758,26953669,2023-02-09,75.79,1398.7
1759,26953669,2023-02-11,137.86,1536.56
549,26958171,2023-01-31,0.0,837.04
3559,26958171,2023-02-02,-116.1,720.9399999999999
6601,26958171,2023-02-05,9.05,729.99
3560,26958171,2023-02-07,-114.74,615.25
3561,26958171,2023-02-11,-23.0,592.25
6602,26958171,2023-02-11,19.24,611.49
550,26964507,2023-01-31,0.0,358.72
551,26979446,2023-01-31,0.0,149.65
553,26979446,2023-02-01,18.27,167.92000000000002
554,26979446,2023-02-03,214.53,382.45000000000005
555,26979446,2023-02-07,133.96,516.41
8506,26979446,2023-02-11,-34.89,481.52
8507,26979446,2023-02-14,-70.4,411.12
552,26985042,2023-01-31,0.0,248.7
3615,26985042,2023-02-02,-116.25,132.45
3616,26985042,2023-02-03,-104.82,27.629999999999995
3935,26985042,2023-02-03,228.59,256.22
3936,26985042,2023-02-09,142.67,398.89
3617,26985042,2023-02-12,-54.1,344.78999999999996
3937,26985042,2023-02-14,124.19,468.98
553,27010847,2023-01-31,0.0,272.04
44,27010847,2023-02-01,-249.75,22.29000000000002
45,27010847,2023-02-02,-182.71,-160.42000000000002
46,27010847,2023-02-02,-131.53,-291.95
2584,27010847,2023-02-02,20.72,-271.22999999999996
2585,27010847,2023-02-02,126.94,-144.29000000000002
47,27010847,2023-02-05,-298.3,-442.59
2586,27010847,2023-02-07,100.4,-342.19
2587,27010847,2023-02-07,856.5,514.31
2588,27010847,2023-02-08,135.91,650.22
48,27010847,2023-02-13,-163.33,486.89
49,27010847,2023-02-14,-97.12,389.77
2589,27010847,2023-02-14,133.67,523.4399999999999
554,27108454,2023-01-31,0.0,423.96
3265,27108454,2023-02-02,106.6,530.56
3266,27108454,2023-02-03,15.35,545.91
3267,27108454,2023-02-08,98.0,643.91
3268,27108454,2023-02-09,1324.2,1968.1100000000001
3269,27108454,2023-02-14,69.99,2038.1000000000001
555,27117946,2023-01-31,0.0,342.03
6589,27117946,2023-02-05,20.31,362.34
7372,27117946,2023-02-07,-135.32,227.01999999999998
6590,27117946,2023-02-08,137.97,364.99
7373,27117946,2023-02-13,-91.43,273.55999999999995
556,27170424,2023-01-31,0.0,211.66
5666,27170424,2023-02-04,-150.79,60.870000000000005
5667,27170424,2023-02-09,-111.55,-50.67999999999998
5668,27170424,2023-02-10,-835.9,-886.58
8392,27170424,2023-02-10,140.57,-746.0099999999999
557,27193025,2023-01-31,0.0,187.57
1765,27193025,2023-02-01,54.7,242.26999999999998
1766,27193025,2023-02-03,19.83,262.1
5367,27193025,2023-02-04,-104.24,157.86
1767,27193025,2023-02-05,118.39,276.25
5368,27193025,2023-02-06,-155.37,120.88
5369,27193025,2023-02-07,-166.29,-45.41
1768,27193025,2023-02-08,67.49,22.079999999999984
1769,27193025,2023-02-10,44.74,66.82
1770,27193025,2023-02-10,47.75,114.57
1771,27193025,2023-02-11,56.69,171.26
1772,27193025,2023-02-13,25.57,196.82999999999998
558,27193470,2023-01-31,0.0,479.57
2353,27193470,2023-02-02,-68.41,411.15999999999997
2354,27193470,2023-02-03,-82.41,328.75
5535,27193470,2023-02-04,105.89,434.64
2355,27193470,2023-02-06,-78.77,355.87
5536,27193470,2023-02-06,1486.9,1842.77
2356,27193470,2023-02-07,-116.86,1725.91
5537,27193470,2023-02-07,480.0,2205.9100000000003
2358,27193470,2023-02-08,-139.22,2066.69
2357,27193470,2023-02-08,-117.53,1949.16
2359,27193470,2023-02-09,-118.46,1830.7
2360,27193470,2023-02-12,-142.98,1687.72
559,27203821,2023-01-31,0.0,256.57
4110,27203821,2023-02-03,-866.1,-609.53
7673,27203821,2023-02-07,152.23,-457.3
7674,27203821,2023-02-07,1679.8,1222.5
4111,27203821,2023-02-09,-177.2,1045.3
560,27264533,2023-01-31,0.0,254.28
4380,27264533,2023-02-03,95.29,349.57
4381,27264533,2023-02-07,64.08,413.65
4382,27264533,2023-02-08,85.29,498.94000000000005
561,27305999,2023-01-31,0.0,17.22
4577,27305999,2023-02-03,-185.02,-167.8
4576,27305999,2023-02-03,-117.17,-284.97
562,27334998,2023-01-31,0.0,817.28
6058,27334998,2023-02-05,-1.11,816.17
6088,27334998,2023-02-05,100.57,916.74
6089,27334998,2023-02-06,99.03,1015.77
6059,27334998,2023-02-07,-170.65,845.1199999999999
6060,27334998,2023-02-08,-130.38,714.74
563,27356852,2023-01-31,0.0,414.82
0,27356852,2023-02-01,128.78,543.6
1,27356852,2023-02-01,160.76,704.3599999999999
4537,27356852,2023-02-03,-99.42,604.94
4538,27356852,2023-02-04,-57.96,546.98
2,27356852,2023-02-04,381.6,928.5799999999999
4539,27356852,2023-02-05,-116.94,811.64
3,27356852,2023-02-10,1271.5,2083.14
4540,27356852,2023-02-12,-118.8,1964.34
4541,27356852,2023-02-12,-41.2,1923.1399999999999
564,27357010,2023-01-31,0.0,579.29
2378,27357010,2023-02-02,-120.26,459.03
2379,27357010,2023-02-06,-90.59,368.43999999999994
7161,27357010,2023-02-06,90.59,459.03
7162,27357010,2023-02-09,101.24,560.27
7163,27357010,2023-02-13,48.01,608.28
2380,27357010,2023-02-14,-122.47,485.80999999999995
565,27382109,2023-01-31,0.0,174.95
623,27382109,2023-02-01,63.48,238.42999999999998
6550,27382109,2023-02-05,-858.4,-619.97
6552,27382109,2023-02-07,-136.09,-756.06
6553,27382109,2023-02-07,-60.4,-816.46
6551,27382109,2023-02-07,-45.83,-862.29
624,27382109,2023-02-13,1188.4,326.11000000000007
6554,27382109,2023-02-14,-188.72,137.39000000000007
566,27388260,2023-01-31,0.0,39.64
5108,27388260,2023-02-04,137.7,177.33999999999997
7529,27388260,2023-02-07,-107.54,69.79999999999998
5109,27388260,2023-02-07,135.14,204.93999999999994
7530,27388260,2023-02-08,-107.42,97.51999999999995
5110,27388260,2023-02-09,30.61,128.12999999999994
7531,27388260,2023-02-11,-6.54,121.58999999999995
5111,27388260,2023-02-12,49.38,170.96999999999997
5112,27388260,2023-02-12,109.89,280.85999999999996
5113,27388260,2023-02-14,123.36,404.2199999999999
567,27389680,2023-01-31,0.0,815.68
2955,27389680,2023-02-02,327.6,1143.28
2956,27389680,2023-02-05,18.13,1161.4099999999999
7811,27389680,2023-02-08,-156.86,1004.55
7810,27389680,2023-02-08,-57.93,946.6199999999999
7812,27389680,2023-02-14,-82.48,864.14
568,27415805,2023-01-31,0.0,902.28
3206,27415805,2023-02-02,-94.5,807.78
4185,27415805,2023-02-03,43.72,851.5
3207,27415805,2023-02-06,-1107.9,-256.4000000000001
4186,27415805,2023-02-07,36.73,-219.67000000000007
3208,27415805,2023-02-09,-30.61,-250.2800000000002
4187,27415805,2023-02-09,125.11,-125.17000000000007
3209,27415805,2023-02-11,-172.32,-297.49
569,27430568,2023-01-31,0.0,450.45
850,27430568,2023-02-01,-186.45,264.0
849,27430568,2023-02-01,-100.12,163.88
851,27430568,2023-02-02,-832.5,-668.6199999999999
852,27430568,2023-02-03,-107.8,-776.4199999999998
3928,27430568,2023-02-03,173.67,-602.7499999999998
3929,27430568,2023-02-06,91.5,-511.24999999999994
3930,27430568,2023-02-09,230.97,-280.2799999999999
3931,27430568,2023-02-10,86.27,-194.00999999999993
854,27430568,2023-02-11,-90.65,-284.6599999999999
853,27430568,2023-02-11,-84.59,-369.24999999999994
855,27430568,2023-02-12,-1025.1,-1394.3499999999997
570,27580272,2023-01-31,0.0,352.81
4676,27580272,2023-02-03,115.75,468.56
4677,27580272,2023-02-07,91.56,560.12
8158,27580272,2023-02-09,-64.46,495.66
571,27582893,2023-01-31,0.0,639.21
3738,27582893,2023-02-02,-98.09,541.12
3739,27582893,2023-02-03,-146.33,394.79
3740,27582893,2023-02-03,-129.73,265.06000000000006
3741,27582893,2023-02-05,-105.33,159.73000000000002
3742,27582893,2023-02-14,-66.56,93.17000000000007
572,27585212,2023-01-31,0.0,150.57
3848,27585212,2023-02-03,-101.07,49.5
7776,27585212,2023-02-08,76.59,126.09
573,27589482,2023-01-31,0.0,494.03
397,27589482,2023-02-01,129.54,623.5699999999999
5721,27589482,2023-02-04,-24.15,599.42
398,27589482,2023-02-06,102.35,701.77
5722,27589482,2023-02-09,-129.57,572.1999999999999
5723,27589482,2023-02-13,-81.27,490.92999999999995
399,27589482,2023-02-13,14.56,505.48999999999995
574,27596004,2023-01-31,0.0,505.73
232,27596004,2023-02-01,36.3,542.03
233,27596004,2023-02-01,172.77,714.8
231,27596004,2023-02-01,989.3,1704.1
234,27596004,2023-02-06,193.24,1897.34
8020,27596004,2023-02-09,-88.16,1809.1799999999998
8021,27596004,2023-02-12,-1255.7,553.4799999999998
8022,27596004,2023-02-14,-259.3,294.1799999999998
235,27596004,2023-02-14,0.43,294.6099999999998
575,27600956,2023-01-31,0.0,84.39
5205,27600956,2023-02-04,33.69,118.08
6471,27600956,2023-02-05,-104.27,13.810000000000002
5206,27600956,2023-02-08,105.35,119.16
5207,27600956,2023-02-10,109.1,228.26
6472,27600956,2023-02-12,-1268.1,-1039.84
5209,27600956,2023-02-12,16.56,-1023.2800000000001
5208,27600956,2023-02-12,197.29,-825.99
5210,27600956,2023-02-14,135.36,-690.63
576,27625709,2023-01-31,0.0,616.45
995,27625709,2023-02-01,-77.61,538.84
996,27625709,2023-02-04,-32.88,505.96000000000004
997,27625709,2023-02-10,-4.42,501.5400000000001
8430,27625709,2023-02-11,131.8,633.34
998,27625709,2023-02-14,-153.23,480.11000000000007
8431,27625709,2023-02-14,128.39,608.5
577,27628187,2023-01-31,0.0,344.63
2326,27628187,2023-02-02,-148.04,196.59
2327,27628187,2023-02-02,-109.57,87.01999999999998
2328,27628187,2023-02-03,-127.48,-40.45999999999998
7587,27628187,2023-02-07,87.52,47.06
578,27713909,2023-01-31,0.0,199.77
2669,27713909,2023-02-02,79.25,279.02
2670,27713909,2023-02-06,7.07,286.09000000000003
2671,27713909,2023-02-09,1160.0,1446.09
579,27806002,2023-01-31,0.0,565.08
7476,27806002,2023-02-07,27.75,592.83
7477,27806002,2023-02-08,233.36,826.19
8671,27806002,2023-02-14,-479.9,346.2900000000001
580,27821800,2023-01-31,0.0,322.23
6832,27821800,2023-02-06,-394.5,-72.26999999999998
6833,27821800,2023-02-10,-76.32,-148.58999999999997
8644,27821800,2023-02-13,58.62,-89.96999999999997
8645,27821800,2023-02-14,151.02,61.05000000000007
581,27845045,2023-01-31,0.0,136.91
1452,27845045,2023-02-01,80.9,217.81
1453,27845045,2023-02-08,117.08,334.89
8678,27845045,2023-02-14,-130.09,204.79999999999998
582,27870202,2023-01-31,0.0,286.17
4714,27870202,2023-02-03,111.04,397.21000000000004
4715,27870202,2023-02-07,1613.2,2010.41
4716,27870202,2023-02-08,13.55,2023.96
8495,27870202,2023-02-11,-17.89,2006.0700000000002
4717,27870202,2023-02-14,99.23,2105.3
583,27985160,2023-01-31,0.0,446.21
2766,27985160,2023-02-02,-744.2,-297.99000000000007
2767,27985160,2023-02-08,-132.6,-430.5900000000001
8176,27985160,2023-02-09,107.22,-323.37000000000006
584,28053942,2023-01-31,0.0,70.94
604,28053942,2023-02-01,-1821.2,-1750.26
605,28053942,2023-02-02,-132.84,-1883.1
606,28053942,2023-02-05,-841.2,-2724.3
607,28053942,2023-02-05,-119.28,-2843.58
608,28053942,2023-02-06,-75.16,-2918.7400000000002
585,28063272,2023-01-31,0.0,252.41
5846,28063272,2023-02-04,155.57,407.98
5847,28063272,2023-02-06,202.05,610.03
5848,28063272,2023-02-07,194.01,804.04
7792,28063272,2023-02-08,-125.91,678.13
5849,28063272,2023-02-08,967.3,1645.43
7793,28063272,2023-02-09,-105.86,1539.5700000000002
7794,28063272,2023-02-10,-165.63,1373.94
7795,28063272,2023-02-10,-82.97,1290.97
5850,28063272,2023-02-10,149.81,1440.78
7796,28063272,2023-02-14,-58.88,1381.9
586,28142099,2023-01-31,0.0,420.86
8325,28142099,2023-02-10,-1134.6,-713.7399999999999
587,28222331,2023-01-31,0.0,137.74
832,28222331,2023-02-01,102.76,240.5
831,28222331,2023-02-01,140.1,380.6
5063,28222331,2023-02-04,-67.93,312.66999999999996
833,28222331,2023-02-04,30.36,343.03
834,28222331,2023-02-07,49.81,392.84
588,28240243,2023-01-31,0.0,850.7
1906,28240243,2023-02-01,-122.07,728.6300000000001
1907,28240243,2023-02-08,-93.01,635.6200000000001
1908,28240243,2023-02-13,-175.32,460.30000000000007
589,28247818,2023-01-31,0.0,150.24
1989,28247818,2023-02-01,75.52,225.76
1990,28247818,2023-02-05,65.92,291.68
1991,28247818,2023-02-07,102.9,394.58000000000004
1992,28247818,2023-02-07,126.45,521.03
1993,28247818,2023-02-09,77.58,598.61
8356,28247818,2023-02-10,-107.08,491.53000000000003
1995,28247818,2023-02-11,29.76,521.29
1994,28247818,2023-02-11,65.22,586.51
8358,28247818,2023-02-12,-127.0,459.51
8357,28247818,2023-02-12,-67.6,391.91
1996,28247818,2023-02-12,119.93,511.84000000000003
590,28251857,2023-01-31,0.0,431.6
1682,28251857,2023-02-01,85.99,517.59
2980,28251857,2023-02-02,-90.38,427.21000000000004
1683,28251857,2023-02-02,1501.3,1928.5099999999998
2981,28251857,2023-02-05,-117.78,1810.73
1684,28251857,2023-02-05,0.49,1811.2199999999998
1685,28251857,2023-02-06,180.89,1992.1099999999997
2982,28251857,2023-02-10,-104.53,1887.58
1686,28251857,2023-02-10,20.93,1908.5099999999998
591,28254911,2023-01-31,0.0,697.78
3881,28254911,2023-02-03,-16.2,681.5799999999999
5361,28254911,2023-02-04,888.9,1570.48
3882,28254911,2023-02-06,-131.6,1438.8799999999999
5362,28254911,2023-02-06,165.67,1604.55
3883,28254911,2023-02-07,-139.63,1464.9199999999998
5363,28254911,2023-02-08,90.88,1555.8
5364,28254911,2023-02-09,68.62,1624.4199999999998
3885,28254911,2023-02-11,-122.35,1502.07
3884,28254911,2023-02-11,-89.22,1412.85
5365,28254911,2023-02-11,633.2,2046.05
3886,28254911,2023-02-12,-147.01,1899.04
5366,28254911,2023-02-12,92.53,1991.57
3887,28254911,2023-02-14,-118.38,1873.19
592,28362321,2023-01-31,0.0,849.34
4014,28362321,2023-02-03,-77.07,772.27
6171,28362321,2023-02-05,76.11,848.38
6172,28362321,2023-02-07,59.08,907.46
6173,28362321,2023-02-08,44.34,951.8000000000001
4015,28362321,2023-02-10,-69.69,882.11
6174,28362321,2023-02-10,17.18,899.2900000000001
6175,28362321,2023-02-10,849.7,1748.9900000000002
4016,28362321,2023-02-12,-614.4,1134.5900000000001
593,28380949,2023-01-31,0.0,937.24
1145,28380949,2023-02-01,-131.58,805.66
1147,28380949,2023-02-04,-1412.5,-606.8399999999999
1146,28380949,2023-02-04,-58.38,-665.22
1148,28380949,2023-02-05,-141.36,-806.5799999999999
7678,28380949,2023-02-07,17.39,-789.1899999999998
7679,28380949,2023-02-11,573.2,-215.99
594,28429440,2023-01-31,0.0,538.15
546,28429440,2023-02-01,-57.95,480.2
547,28429440,2023-02-03,-85.06,395.14
548,28429440,2023-02-05,-471.4,-76.25999999999999
549,28429440,2023-02-07,-86.22,-162.48000000000002
8222,28429440,2023-02-10,59.31,-103.16999999999996
550,28429440,2023-02-11,-1096.1,-1199.27
8223,28429440,2023-02-12,180.17,-1019.0999999999998
595,28548067,2023-01-31,0.0,499.29
3938,28548067,2023-02-03,32.08,531.37
3939,28548067,2023-02-05,100.87,632.24
3940,28548067,2023-02-12,36.02,668.26
596,28553155,2023-01-31,0.0,147.09
1040,28553155,2023-02-01,-131.36,15.72999999999999
1041,28553155,2023-02-03,-106.67,-90.94000000000003
6607,28553155,2023-02-05,134.95,44.00999999999996
6608,28553155,2023-02-08,124.98,168.98999999999995
6609,28553155,2023-02-09,102.41,271.4
1042,28553155,2023-02-10,-76.15,195.24999999999994
1043,28553155,2023-02-13,-14.56,180.68999999999994
6610,28553155,2023-02-14,112.72,293.40999999999997
597,28572979,2023-01-31,0.0,156.38
3223,28572979,2023-02-02,-190.92,-34.53999999999999
2568,28572979,2023-02-02,130.23,95.69
2569,28572979,2023-02-04,1026.7,1122.3899999999999
3224,28572979,2023-02-06,-210.36,912.03
3225,28572979,2023-02-09,-48.05,863.98
3226,28572979,2023-02-11,-168.92,695.0600000000001
2570,28572979,2023-02-12,66.4,761.46
598,28595197,2023-01-31,0.0,897.68
2692,28595197,2023-02-02,68.18,965.8599999999999
2693,28595197,2023-02-03,108.32,1074.1799999999998
5165,28595197,2023-02-04,-809.4,264.78
5166,28595197,2023-02-06,-34.09,230.68999999999994
5167,28595197,2023-02-07,-993.9,-763.2099999999999
5168,28595197,2023-02-09,-1606.6,-2369.81
599,28606808,2023-01-31,0.0,1.71
3693,28606808,2023-02-02,-41.88,-40.17
3694,28606808,2023-02-07,-71.01,-111.18000000000002
3695,28606808,2023-02-07,-59.08,-170.26
7782,28606808,2023-02-08,957.8,787.54
3696,28606808,2023-02-09,-139.7,647.8399999999999
600,28629966,2023-01-31,0.0,60.86
3416,28629966,2023-02-02,52.11,112.97
4182,28629966,2023-02-03,-55.02,57.949999999999996
3418,28629966,2023-02-04,8.63,66.58
3417,28629966,2023-02-04,72.49,139.07
3419,28629966,2023-02-05,108.31,247.38
4183,28629966,2023-02-07,-186.23,61.15000000000002
3420,28629966,2023-02-09,103.88,165.03000000000003
4184,28629966,2023-02-11,-59.3,105.73000000000002
3421,28629966,2023-02-12,98.2,203.93
4185,28629966,2023-02-13,-148.89,55.040000000000035
3422,28629966,2023-02-13,126.46,181.50000000000003
601,28640713,2023-01-31,0.0,204.33
937,28640713,2023-02-01,-53.43,150.9
938,28640713,2023-02-03,-111.46,39.440000000000026
939,28640713,2023-02-05,-128.65,-89.21000000000001
940,28640713,2023-02-06,-97.36,-186.57000000000002
7215,28640713,2023-02-06,27.94,-158.63000000000002
7214,28640713,2023-02-06,93.75,-64.88000000000002
7213,28640713,2023-02-06,157.18,92.29999999999998
7216,28640713,2023-02-07,9.52,101.81999999999998
941,28640713,2023-02-09,-86.0,15.819999999999965
942,28640713,2023-02-13,-117.35,-101.53
602,28652960,2023-01-31,0.0,140.6
5408,28652960,2023-02-04,129.92,270.52
5407,28652960,2023-02-04,134.34,404.86
7168,28652960,2023-02-06,-91.86,313.0
7169,28652960,2023-02-09,-116.34,196.65999999999997
5409,28652960,2023-02-09,214.76,411.41999999999996
7170,28652960,2023-02-10,-30.02,381.4
5410,28652960,2023-02-10,197.72,579.12
5411,28652960,2023-02-11,130.89,710.01
5412,28652960,2023-02-12,66.67,776.68
7171,28652960,2023-02-13,-89.23,687.4499999999999
5413,28652960,2023-02-13,96.41,783.86
603,28659160,2023-01-31,0.0,115.6
910,28659160,2023-02-01,-172.77,-57.170000000000016
911,28659160,2023-02-02,-327.6,-384.77
912,28659160,2023-02-06,-134.68,-519.4499999999999
7418,28659160,2023-02-07,98.93,-420.52
604,28680375,2023-01-31,0.0,337.2
2090,28680375,2023-02-02,84.65,421.85
8615,28680375,2023-02-13,-152.92,268.93
8616,28680375,2023-02-13,-25.85,243.08
8617,28680375,2023-02-14,-106.21,136.87
605,28696496,2023-01-31,0.0,150.57
2935,28696496,2023-02-02,58.23,208.79999999999998
7753,28696496,2023-02-08,-120.55,88.25
2936,28696496,2023-02-09,82.54,170.79
7754,28696496,2023-02-13,-123.86,46.93000000000001
7755,28696496,2023-02-13,-93.53,-46.60000000000002
2937,28696496,2023-02-14,148.05,101.44999999999999
606,28738041,2023-01-31,0.0,907.31
2411,28738041,2023-02-02,-48.35,858.9599999999999
7434,28738041,2023-02-07,1806.9,2665.86
7435,28738041,2023-02-09,96.94,2762.8
7436,28738041,2023-02-11,190.18,2952.98
2412,28738041,2023-02-12,-66.05,2886.9300000000003
2413,28738041,2023-02-13,-56.68,2830.25
2414,28738041,2023-02-14,-69.79,2760.46
607,28743137,2023-01-31,0.0,781.13
3405,28743137,2023-02-02,-118.55,662.58
3406,28743137,2023-02-13,-64.85,597.73
8641,28743137,2023-02-13,111.36,709.09
608,28745450,2023-01-31,0.0,157.38
4,28745450,2023-02-01,163.82,321.2
6884,28745450,2023-02-06,-77.81,243.39
5,28745450,2023-02-09,47.96,291.35
6,28745450,2023-02-09,113.5,404.85
6885,28745450,2023-02-12,-180.44,224.41
609,28754062,2023-01-31,0.0,16.41
610,28781155,2023-01-31,0.0,555.55
2675,28781155,2023-02-02,99.34,654.89
2676,28781155,2023-02-06,105.25,760.14
8333,28781155,2023-02-10,-67.41,692.73
8334,28781155,2023-02-11,-109.94,582.79
2677,28781155,2023-02-11,34.81,617.5999999999999
611,28811285,2023-01-31,0.0,813.63
3943,28811285,2023-02-03,-227.05,586.5799999999999
3944,28811285,2023-02-04,-86.15,500.42999999999995
3945,28811285,2023-02-08,-110.78,389.65
8583,28811285,2023-02-12,1534.6,1924.25
612,28819175,2023-01-31,0.0,414.48
1131,28819175,2023-02-01,-44.29,370.19
3538,28819175,2023-02-02,20.57,390.76
3539,28819175,2023-02-03,63.29,454.05
1132,28819175,2023-02-06,-178.95,275.1
1133,28819175,2023-02-09,-363.8,-88.69999999999999
1134,28819175,2023-02-09,-91.82,-180.51999999999998
1135,28819175,2023-02-11,-155.49,-336.01
613,28822117,2023-01-31,0.0,204.79
1447,28822117,2023-02-01,-98.74,106.05
6472,28822117,2023-02-05,1022.3,1128.35
1448,28822117,2023-02-07,-43.86,1084.49
614,28909144,2023-01-31,0.0,263.97
5615,28909144,2023-02-04,32.51,296.48
5614,28909144,2023-02-04,32.88,329.36
6563,28909144,2023-02-05,-66.8,262.56000000000006
5616,28909144,2023-02-08,165.79,428.35
6564,28909144,2023-02-14,-30.0,398.35
615,28911002,2023-01-31,0.0,858.06
91,28911002,2023-02-01,1139.7,1997.76
2868,28911002,2023-02-02,-137.03,1860.73
2869,28911002,2023-02-06,-122.69,1738.04
2870,28911002,2023-02-11,-75.03,1663.01
92,28911002,2023-02-11,50.13,1713.1399999999999
616,28969443,2023-01-31,0.0,12.77
7217,28969443,2023-02-07,-485.9,-473.13
7218,28969443,2023-02-08,-79.06,-552.19
7972,28969443,2023-02-09,29.71,-522.48
7219,28969443,2023-02-14,-111.2,-633.6800000000001
617,28976546,2023-01-31,0.0,454.25
856,28976546,2023-02-01,-128.83,325.41999999999996
6566,28976546,2023-02-05,59.2,384.62
857,28976546,2023-02-06,-71.54,313.08
858,28976546,2023-02-09,-48.6,264.48
618,29000698,2023-01-31,0.0,954.02
6930,29000698,2023-02-06,-97.54,856.48
7555,29000698,2023-02-07,44.98,901.4599999999999
7556,29000698,2023-02-11,16.59,918.05
7557,29000698,2023-02-12,191.61,1109.6599999999999
619,29017229,2023-01-31,0.0,950.07
2872,29017229,2023-02-02,95.2,1045.27
4621,29017229,2023-02-03,-183.44,861.83
2873,29017229,2023-02-03,179.54,1041.3700000000001
2874,29017229,2023-02-04,1246.9,2288.27
4622,29017229,2023-02-06,-189.84,2098.4300000000003
2875,29017229,2023-02-14,71.88,2170.31
620,29039134,2023-01-31,0.0,218.26
6329,29039134,2023-02-05,115.1,333.36
6330,29039134,2023-02-08,245.8,579.16
6331,29039134,2023-02-11,82.76,661.9200000000001
6332,29039134,2023-02-12,97.82,759.74
6333,29039134,2023-02-12,1411.1,2170.84
6334,29039134,2023-02-14,104.64,2275.4799999999996
6335,29039134,2023-02-14,558.8,2834.2799999999997
621,29043142,2023-01-31,0.0,210.89
8011,29043142,2023-02-09,-110.51,100.37999999999998
8012,29043142,2023-02-11,-114.61,-14.230000000000018
8013,29043142,2023-02-12,-141.01,-155.24
8605,29043142,2023-02-12,67.25,-87.99000000000001
622,29052260,2023-01-31,0.0,639.05
4113,29052260,2023-02-03,132.95,772.0
4114,29052260,2023-02-05,89.52,861.52
4115,29052260,2023-02-10,117.25,978.77
623,29061354,2023-01-31,0.0,180.47
6152,29061354,2023-02-05,2.25,182.72
6153,29061354,2023-02-07,92.81,275.53
8498,29061354,2023-02-11,-54.28,221.25
6154,29061354,2023-02-11,667.1,888.35
624,29074095,2023-01-31,0.0,512.38
228,29074095,2023-02-01,86.91,599.29
2927,29074095,2023-02-02,-924.0,-324.71000000000004
2928,29074095,2023-02-07,-164.85,-489.56000000000006
2929,29074095,2023-02-11,-87.14,-576.6999999999999
2930,29074095,2023-02-12,-110.14,-686.84
2931,29074095,2023-02-13,-65.54,-752.38
229,29074095,2023-02-13,184.92,-567.4600000000002
625,29222005,2023-01-31,0.0,0.34
4415,29222005,2023-02-03,98.53,98.87
6427,29222005,2023-02-05,-119.42,-20.55
6428,29222005,2023-02-05,-109.63,-130.17999999999998
4416,29222005,2023-02-07,80.36,-49.81999999999999
4417,29222005,2023-02-12,94.0,44.18000000000001
626,29238925,2023-01-31,0.0,574.82
5128,29238925,2023-02-04,2.44,577.2600000000001
5129,29238925,2023-02-09,47.07,624.33
8481,29238925,2023-02-11,-887.8,-263.4699999999999
8482,29238925,2023-02-14,-956.2,-1219.67
627,29288598,2023-01-31,0.0,386.76
4582,29288598,2023-02-03,201.14,587.9
5109,29288598,2023-02-04,-84.15,503.75
4583,29288598,2023-02-06,74.62,578.37
4584,29288598,2023-02-07,109.13,687.5
4585,29288598,2023-02-08,265.04,952.54
5110,29288598,2023-02-11,-142.47,810.0699999999999
5111,29288598,2023-02-13,-137.35,672.72
4587,29288598,2023-02-14,143.6,816.3199999999999
4586,29288598,2023-02-14,1295.6,2111.92
628,29303323,2023-01-31,0.0,525.6
2587,29303323,2023-02-02,-143.82,381.78000000000003
2586,29303323,2023-02-02,-103.75,278.03000000000003
3996,29303323,2023-02-03,136.61,414.64000000000004
3997,29303323,2023-02-04,136.51,551.1500000000001
2588,29303323,2023-02-09,-142.5,408.65000000000003
3998,29303323,2023-02-09,1301.5,1710.15
4000,29303323,2023-02-13,126.86,1837.0099999999998
3999,29303323,2023-02-13,185.87,2022.88
629,29358670,2023-01-31,0.0,874.94
1082,29358670,2023-02-01,92.86,967.8000000000001
1083,29358670,2023-02-06,173.92,1141.72
7882,29358670,2023-02-08,-120.57,1021.1500000000001
7881,29358670,2023-02-08,-50.38,970.7700000000001
7883,29358670,2023-02-09,-83.38,887.3900000000001
1084,29358670,2023-02-09,105.57,992.96
1085,29358670,2023-02-11,86.69,1079.65
1086,29358670,2023-02-11,121.51,1201.16
7884,29358670,2023-02-12,-1183.8,17.360000000000127
7885,29358670,2023-02-13,-56.85,-39.489999999999895
630,29422349,2023-01-31,0.0,623.61
7895,29422349,2023-02-08,91.11,714.72
7896,29422349,2023-02-10,144.27,858.99
8585,29422349,2023-02-13,-145.83,713.1600000000001
631,29464742,2023-01-31,0.0,557.11
2252,29464742,2023-02-02,86.31,643.4200000000001
2253,29464742,2023-02-07,211.77,855.19
7942,29464742,2023-02-08,-92.83,762.36
7943,29464742,2023-02-14,-147.24,615.12
632,29473763,2023-01-31,0.0,724.82
6591,29473763,2023-02-05,-80.66,644.1600000000001
7704,29473763,2023-02-08,144.06,788.22
6592,29473763,2023-02-14,-141.21,647.01
633,29489865,2023-01-31,0.0,854.53
4297,29489865,2023-02-03,-109.66,744.87
6660,29489865,2023-02-06,114.3,859.17
4298,29489865,2023-02-10,-169.47,689.7
4299,29489865,2023-02-11,-82.38,607.3199999999999
6661,29489865,2023-02-11,29.25,636.5699999999999
6662,29489865,2023-02-14,122.97,759.54
634,29523226,2023-01-31,0.0,807.56
530,29523226,2023-02-01,102.6,910.16
4288,29523226,2023-02-03,-48.79,861.3699999999999
531,29523226,2023-02-03,68.85,930.2199999999999
4290,29523226,2023-02-05,-90.06,840.16
4289,29523226,2023-02-05,-73.99,766.17
532,29523226,2023-02-05,191.47,957.6399999999999
4291,29523226,2023-02-06,-134.96,822.68
533,29523226,2023-02-06,58.71,881.39
4292,29523226,2023-02-08,-83.33,798.06
534,29523226,2023-02-09,254.92,1052.98
4293,29523226,2023-02-10,-83.94,969.04
536,29523226,2023-02-13,25.85,994.8899999999999
535,29523226,2023-02-13,63.08,1057.97
635,29527534,2023-01-31,0.0,355.57
4112,29527534,2023-02-03,-122.97,232.6
5664,29527534,2023-02-04,99.39,331.99
4113,29527534,2023-02-10,-148.63,183.36
5665,29527534,2023-02-11,86.28,269.64
636,29608056,2023-01-31,0.0,248.43
4762,29608056,2023-02-03,-105.92,142.51
4681,29608056,2023-02-03,61.91,204.42000000000002
4763,29608056,2023-02-06,-115.19,89.23000000000002
4682,29608056,2023-02-06,86.9,176.13
4764,29608056,2023-02-07,-1610.4,-1434.27
4765,29608056,2023-02-11,-131.8,-1566.07
4686,29608056,2023-02-12,51.66,-1514.41
4683,29608056,2023-02-12,96.87,-1417.54
4684,29608056,2023-02-12,126.97,-1290.57
4685,29608056,2023-02-12,134.36,-1156.21
637,29631870,2023-01-31,0.0,694.99
3304,29631870,2023-02-02,78.61,773.6
3303,29631870,2023-02-02,1138.0,1911.6
5217,29631870,2023-02-04,-74.21,1837.3899999999999
3305,29631870,2023-02-04,68.54,1905.9299999999998
3306,29631870,2023-02-12,113.45,2019.3799999999999
5218,29631870,2023-02-14,-90.07,1929.31
638,29638033,2023-01-31,0.0,537.95
645,29638033,2023-02-01,-1775.6,-1237.6499999999999
644,29638033,2023-02-01,-129.52,-1367.1699999999998
646,29638033,2023-02-02,-1890.0,-3257.17
647,29638033,2023-02-03,-103.79,-3360.96
648,29638033,2023-02-08,-40.08,-3401.04
649,29638033,2023-02-11,-89.5,-3490.54
8557,29638033,2023-02-12,122.32,-3368.2200000000003
650,29638033,2023-02-14,-134.42,-3502.6399999999994
639,29639626,2023-01-31,0.0,985.7
5582,29639626,2023-02-04,-112.65,873.0500000000001
6226,29639626,2023-02-05,135.88,1008.9300000000001
5583,29639626,2023-02-06,-58.79,950.14
5584,29639626,2023-02-10,-15.25,934.89
6227,29639626,2023-02-10,103.67,1038.56
5585,29639626,2023-02-13,-163.71,874.85
6228,29639626,2023-02-13,41.85,916.7
640,29705419,2023-01-31,0.0,799.07
2210,29705419,2023-02-02,89.88,888.95
4107,29705419,2023-02-03,-749.7,139.25
2211,29705419,2023-02-03,62.89,202.14
2212,29705419,2023-02-06,149.08,351.22
2213,29705419,2023-02-08,133.54,484.76
4108,29705419,2023-02-09,-99.59,385.17
4109,29705419,2023-02-13,-105.96,279.21000000000004
641,29878790,2023-01-31,0.0,360.74
8627,29878790,2023-02-13,-94.19,266.55
642,29887258,2023-01-31,0.0,392.91
6308,29887258,2023-02-05,103.8,496.71000000000004
7899,29887258,2023-02-08,-17.63,479.08000000000004
7900,29887258,2023-02-13,-157.09,321.99
6309,29887258,2023-02-14,122.47,444.46000000000004
6310,29887258,2023-02-14,175.07,619.53
643,29920698,2023-01-31,0.0,922.07
2347,29920698,2023-02-02,-108.09,813.98
5547,29920698,2023-02-04,45.53,859.51
5546,29920698,2023-02-04,47.33,906.84
2348,29920698,2023-02-05,-1475.4,-568.5600000000001
5548,29920698,2023-02-08,77.84,-490.72000000000014
5549,29920698,2023-02-13,86.2,-404.5200000000001
644,29958061,2023-01-31,0.0,17.43
1791,29958061,2023-02-01,93.28,110.71000000000001
3394,29958061,2023-02-02,-28.3,82.41
1792,29958061,2023-02-02,103.39,185.8
1793,29958061,2023-02-03,167.61,353.41
1794,29958061,2023-02-04,115.56,468.97
1795,29958061,2023-02-07,183.11,652.08
3395,29958061,2023-02-08,-104.32,547.76
1796,29958061,2023-02-12,614.4,1162.16
645,30030650,2023-01-31,0.0,414.27
7155,30030650,2023-02-06,96.15,510.41999999999996
7570,30030650,2023-02-07,-99.74,410.68
7157,30030650,2023-02-08,79.57,490.25
7156,30030650,2023-02-08,140.45,630.7
7571,30030650,2023-02-13,-23.8,606.9
646,30058030,2023-01-31,0.0,39.21
2757,30058030,2023-02-02,-68.18,-28.970000000000006
4207,30058030,2023-02-03,106.54,77.57
4209,30058030,2023-02-12,37.7,115.27000000000001
4208,30058030,2023-02-12,89.64,204.91
2758,30058030,2023-02-14,-823.0,-618.0899999999999
4210,30058030,2023-02-14,69.27,-548.8199999999999
647,30093672,2023-01-31,0.0,939.77
5341,30093672,2023-02-04,121.83,1061.6
5342,30093672,2023-02-05,62.74,1124.34
6949,30093672,2023-02-06,-79.32,1045.02
5343,30093672,2023-02-06,34.09,1079.11
6950,30093672,2023-02-08,-1002.0,77.11000000000001
5344,30093672,2023-02-09,7.12,84.23000000000002
6951,30093672,2023-02-10,-142.07,-57.83999999999992
5345,30093672,2023-02-11,108.41,50.57000000000005
6952,30093672,2023-02-12,-129.0,-78.42999999999995
648,30110747,2023-01-31,0.0,949.76
1586,30110747,2023-02-01,98.39,1048.15
4062,30110747,2023-02-03,-225.89,822.26
4063,30110747,2023-02-03,-158.58,663.6800000000001
1587,30110747,2023-02-06,70.1,733.78
1588,30110747,2023-02-07,69.34,803.12
4064,30110747,2023-02-10,-37.83,765.29
1589,30110747,2023-02-13,143.14,908.43
649,30112323,2023-01-31,0.0,519.73
1558,30112323,2023-02-01,-12.31,507.42
547,30112323,2023-02-01,38.91,546.33
548,30112323,2023-02-01,99.68,646.01
1559,30112323,2023-02-04,-136.46,509.55
1560,30112323,2023-02-07,-27.47,482.08000000000004
1561,30112323,2023-02-08,-1379.8,-897.72
549,30112323,2023-02-09,1504.7,606.98
1562,30112323,2023-02-14,-117.3,489.68
650,30196319,2023-01-31,0.0,721.4
1388,30196319,2023-02-01,-32.39,689.01
6697,30196319,2023-02-06,125.2,814.21
1389,30196319,2023-02-09,-118.21,696.0
1390,30196319,2023-02-10,-95.98,600.02
651,30227774,2023-01-31,0.0,546.85
144,30227774,2023-02-01,-99.3,447.55
5967,30227774,2023-02-05,46.86,494.41
5968,30227774,2023-02-09,89.75,584.1600000000001
145,30227774,2023-02-11,-146.03,438.13
652,30235398,2023-01-31,0.0,973.95
3147,30235398,2023-02-02,-122.38,851.57
3518,30235398,2023-02-02,54.94,906.51
3148,30235398,2023-02-13,-63.08,843.4300000000001
653,30237685,2023-01-31,0.0,751.93
7206,30237685,2023-02-06,-189.18,562.75
8351,30237685,2023-02-10,831.4,1394.15
8352,30237685,2023-02-12,95.25,1489.3999999999999
654,30279114,2023-01-31,0.0,951.13
1081,30279114,2023-02-01,144.31,1095.44
2375,30279114,2023-02-02,-231.9,863.54
2376,30279114,2023-02-08,-66.97,796.5699999999999
2377,30279114,2023-02-09,-210.8,585.77
655,30312615,2023-01-31,0.0,659.36
6235,30312615,2023-02-05,-1852.7,-1193.3400000000001
6826,30312615,2023-02-06,77.23,-1116.1100000000001
6236,30312615,2023-02-07,-116.04,-1232.15
6237,30312615,2023-02-12,-158.57,-1390.7199999999998
6827,30312615,2023-02-12,443.1,-947.62
6238,30312615,2023-02-13,-136.9,-1084.52
656,30324819,2023-01-31,0.0,823.45
3426,30324819,2023-02-02,469.3,1292.75
3427,30324819,2023-02-03,157.15,1449.9
6345,30324819,2023-02-05,-141.51,1308.39
6344,30324819,2023-02-05,-130.7,1177.69
657,30340808,2023-01-31,0.0,895.41
4811,30340808,2023-02-03,-123.39,772.02
4812,30340808,2023-02-06,-64.83,707.1899999999999
4813,30340808,2023-02-07,-121.9,585.29
4814,30340808,2023-02-14,-1660.2,-1074.9100000000003
658,30372316,2023-01-31,0.0,189.39
3151,30372316,2023-02-02,-179.4,9.98999999999998
3152,30372316,2023-02-08,-78.98,-68.99000000000001
7699,30372316,2023-02-08,151.99,83.0
3153,30372316,2023-02-09,-953.9,-870.9
7700,30372316,2023-02-09,1216.6,345.69999999999993
7701,30372316,2023-02-11,40.81,386.50999999999993
3154,30372316,2023-02-13,-102.23,284.2799999999999
3155,30372316,2023-02-14,-0.43,283.8499999999999
659,30374840,2023-01-31,0.0,564.42
4011,30374840,2023-02-03,-1278.2,-713.7800000000001
4010,30374840,2023-02-03,-96.42,-810.2000000000002
7284,30374840,2023-02-07,143.62,-666.58
7283,30374840,2023-02-07,204.81,-461.7700000000001
4012,30374840,2023-02-08,-38.13,-499.9000000000002
7285,30374840,2023-02-08,107.7,-392.20000000000016
4013,30374840,2023-02-10,-1585.0,-1977.1999999999998
660,30396291,2023-01-31,0.0,803.37
4920,30396291,2023-02-03,-610.8,192.57000000000005
4061,30396291,2023-02-03,199.09,391.6600000000001
4921,30396291,2023-02-06,-100.05,291.61000000000007
4922,30396291,2023-02-06,-99.42,192.19000000000005
661,30409599,2023-01-31,0.0,117.47
4629,30409599,2023-02-03,174.62,292.09000000000003
4630,30409599,2023-02-05,51.26,343.35
4631,30409599,2023-02-07,180.63,523.98
4632,30409599,2023-02-08,109.72,633.7
8337,30409599,2023-02-10,-28.25,605.45
4633,30409599,2023-02-14,867.5,1472.95
662,30428666,2023-01-31,0.0,393.33
5391,30428666,2023-02-04,-150.02,243.30999999999997
5392,30428666,2023-02-05,-29.05,214.25999999999996
5393,30428666,2023-02-07,-66.67,147.58999999999997
8455,30428666,2023-02-11,40.71,188.29999999999998
663,30484027,2023-01-31,0.0,272.71
1446,30484027,2023-02-01,127.65,400.36
4695,30484027,2023-02-03,-116.69,283.66999999999996
1447,30484027,2023-02-05,78.67,362.34
4696,30484027,2023-02-09,-10.45,351.89
4697,30484027,2023-02-12,-127.83,224.06
4698,30484027,2023-02-12,-76.6,147.45999999999998
664,30511779,2023-01-31,0.0,772.02
3484,30511779,2023-02-02,179.94,951.96
3485,30511779,2023-02-07,71.18,1023.14
3486,30511779,2023-02-08,106.87,1130.01
3487,30511779,2023-02-10,67.41,1197.42
3489,30511779,2023-02-11,58.01,1255.43
3488,30511779,2023-02-11,114.77,1370.2
665,30518350,2023-01-31,0.0,490.85
6654,30518350,2023-02-06,1498.3,1989.15
8499,30518350,2023-02-11,-19.24,1969.9099999999999
666,30557885,2023-01-31,0.0,615.82
6546,30557885,2023-02-05,-678.7,-62.879999999999995
667,30565855,2023-01-31,0.0,982.05
5969,30565855,2023-02-05,1292.8,2274.85
8054,30565855,2023-02-09,-51.68,2223.17
8055,30565855,2023-02-11,-121.33,2101.84
5970,30565855,2023-02-13,70.54,2172.38
5971,30565855,2023-02-14,483.2,2655.58
668,30623117,2023-01-31,0.0,266.92
5325,30623117,2023-02-04,-125.73,141.19
5326,30623117,2023-02-09,-1169.4,-1028.21
5328,30623117,2023-02-11,-111.11,-1139.32
5327,30623117,2023-02-11,-38.74,-1178.06
5329,30623117,2023-02-14,-159.03,-1337.0900000000001
8670,30623117,2023-02-14,77.33,-1259.76
8669,30623117,2023-02-14,154.58,-1105.18
669,30647433,2023-01-31,0.0,632.2
2983,30647433,2023-02-02,-224.91,407.2900000000001
2984,30647433,2023-02-03,-474.7,-67.40999999999997
2985,30647433,2023-02-04,-15.32,-82.7299999999999
2986,30647433,2023-02-05,-100.81,-183.53999999999996
2987,30647433,2023-02-07,-39.09,-222.62999999999988
7257,30647433,2023-02-07,80.19,-142.43999999999994
7258,30647433,2023-02-10,104.39,-38.049999999999955
670,30657838,2023-01-31,0.0,468.82
1574,30657838,2023-02-01,-91.95,376.87
580,30657838,2023-02-01,2239.3,2616.1700000000005
1575,30657838,2023-02-03,-139.16,2477.01
581,30657838,2023-02-04,124.06,2601.0700000000006
1576,30657838,2023-02-05,-161.8,2439.2700000000004
582,30657838,2023-02-05,539.8,2979.0700000000006
1577,30657838,2023-02-06,-52.94,2926.1300000000006
583,30657838,2023-02-06,90.98,3017.1100000000006
584,30657838,2023-02-08,84.11,3101.2200000000007
585,30657838,2023-02-09,69.33,3170.5500000000006
586,30657838,2023-02-11,152.76,3323.3100000000004
671,30671754,2023-01-31,0.0,621.9
5744,30671754,2023-02-04,-133.3,488.59999999999997
7688,30671754,2023-02-07,5.07,493.66999999999996
672,30672740,2023-01-31,0.0,355.33
3044,30672740,2023-02-02,187.4,542.73
3045,30672740,2023-02-06,126.49,669.22
3046,30672740,2023-02-07,46.51,715.73
3047,30672740,2023-02-11,1949.6,2665.33
8622,30672740,2023-02-13,-106.6,2558.73
673,30688447,2023-01-31,0.0,555.31
4400,30688447,2023-02-03,-137.98,417.3299999999999
4401,30688447,2023-02-05,-160.67,256.65999999999997
7070,30688447,2023-02-06,81.99,338.65
4402,30688447,2023-02-10,-162.32,176.32999999999998
4403,30688447,2023-02-14,-101.76,74.57
674,30718836,2023-01-31,0.0,360.78
913,30718836,2023-02-01,-76.9,283.88
1235,30718836,2023-02-01,186.89,470.77
914,30718836,2023-02-03,-133.1,337.66999999999996
1236,30718836,2023-02-04,58.09,395.76
915,30718836,2023-02-06,-110.26,285.49999999999994
916,30718836,2023-02-07,-16.27,269.22999999999996
917,30718836,2023-02-08,-1127.4,-858.1700000000001
1237,30718836,2023-02-09,51.68,-806.49
1238,30718836,2023-02-11,64.55,-741.94
918,30718836,2023-02-13,-75.16,-817.1000000000001
675,30723991,2023-01-31,0.0,310.02
2735,30723991,2023-02-02,86.69,396.71
2736,30723991,2023-02-03,138.68,535.39
7415,30723991,2023-02-07,-95.78,439.61
676,30758515,2023-01-31,0.0,35.74
722,30758515,2023-02-01,102.39,138.13
723,30758515,2023-02-02,61.09,199.22000000000003
724,30758515,2023-02-13,183.43,382.65000000000003
677,30760024,2023-01-31,0.0,766.43
2633,30760024,2023-02-02,-77.14,689.29
2634,30760024,2023-02-03,-38.61,650.68
7989,30760024,2023-02-09,83.26,733.9399999999999
678,30791105,2023-01-31,0.0,272.5
2652,30791105,2023-02-02,192.77,465.27
5433,30791105,2023-02-04,-113.62,351.65
5434,30791105,2023-02-06,-112.33,239.32
2653,30791105,2023-02-06,102.01,341.33000000000004
2654,30791105,2023-02-10,179.95,521.28
2655,30791105,2023-02-11,107.01,628.29
679,30929422,2023-01-31,0.0,161.53
1913,30929422,2023-02-01,-159.64,1.8900000000000148
1914,30929422,2023-02-01,-120.93,-119.03999999999999
7364,30929422,2023-02-07,82.91,-36.129999999999995
1915,30929422,2023-02-08,-113.42,-149.54999999999998
1916,30929422,2023-02-08,-23.59,-173.14000000000001
1917,30929422,2023-02-11,-38.37,-211.50999999999996
1918,30929422,2023-02-12,-76.48,-287.99
1919,30929422,2023-02-13,-113.91,-401.9
680,30970897,2023-01-31,0.0,57.17
1640,30970897,2023-02-01,-141.6,-84.42999999999999
1641,30970897,2023-02-03,-115.62,-200.05
1642,30970897,2023-02-03,-110.54,-310.59
1643,30970897,2023-02-04,-116.66,-427.25
5900,30970897,2023-02-05,201.75,-225.5
1644,30970897,2023-02-07,-141.27,-366.77000000000004
1645,30970897,2023-02-09,-157.3,-524.07
1646,30970897,2023-02-09,-113.36,-637.4300000000001
5901,30970897,2023-02-12,27.9,-609.5300000000001
5902,30970897,2023-02-13,100.5,-509.03000000000003
681,30977834,2023-01-31,0.0,203.99
3333,30977834,2023-02-02,175.73,379.72
5000,30977834,2023-02-04,-175.99,203.73
3334,30977834,2023-02-04,686.5,890.23
5001,30977834,2023-02-05,-35.3,854.9300000000001
5003,30977834,2023-02-07,-87.82,767.11
5002,30977834,2023-02-07,-86.46,680.6500000000001
3335,30977834,2023-02-10,67.29,747.94
3336,30977834,2023-02-12,45.23,793.1700000000001
682,30979429,2023-01-31,0.0,414.1
1755,30979429,2023-02-01,-70.34,343.76
1756,30979429,2023-02-02,-865.4,-521.64
4102,30979429,2023-02-03,866.1,344.46000000000004
4103,30979429,2023-02-05,104.27,448.73
1757,30979429,2023-02-09,-160.06,288.67
4104,30979429,2023-02-11,35.07,323.74
1758,30979429,2023-02-12,-78.65,245.09000000000003
683,30990911,2023-01-31,0.0,997.59
3366,30990911,2023-02-02,-144.05,853.54
3367,30990911,2023-02-04,-173.9,679.64
5170,30990911,2023-02-04,170.56,850.2
3368,30990911,2023-02-07,-124.86,725.34
5171,30990911,2023-02-08,132.2,857.54
3369,30990911,2023-02-11,-106.4,751.14
684,31026801,2023-01-31,0.0,85.36
230,31026801,2023-02-01,52.99,138.35
6726,31026801,2023-02-06,-99.14,39.21
6727,31026801,2023-02-07,-102.26,-63.05
6728,31026801,2023-02-08,-47.58,-110.63000000000001
6729,31026801,2023-02-11,-62.33,-172.95999999999998
685,31131351,2023-01-31,0.0,278.94
5213,31131351,2023-02-04,98.42,377.36
5212,31131351,2023-02-04,262.0,639.36
5211,31131351,2023-02-04,786.1,1425.46
6980,31131351,2023-02-06,-1124.1,301.36000000000007
5214,31131351,2023-02-06,29.95,331.31000000000006
5215,31131351,2023-02-08,104.01,435.32000000000005
6981,31131351,2023-02-09,-158.52,276.80000000000007
6982,31131351,2023-02-12,-224.14,52.66000000000008
686,31150830,2023-01-31,0.0,36.16
240,31150830,2023-02-01,-161.85,-125.69
2103,31150830,2023-02-02,126.12,0.4300000000000068
2102,31150830,2023-02-02,128.71,129.14000000000001
241,31150830,2023-02-05,-61.68,67.46000000000001
2104,31150830,2023-02-06,52.31,119.77000000000001
242,31150830,2023-02-07,-435.8,-316.03
244,31150830,2023-02-09,-70.29,-386.32000000000005
243,31150830,2023-02-09,-55.88,-442.20000000000005
245,31150830,2023-02-11,-84.45,-526.65
687,31158381,2023-01-31,0.0,514.96
556,31158381,2023-02-01,139.18,654.1400000000001
557,31158381,2023-02-01,223.94,878.08
558,31158381,2023-02-07,80.94,959.02
7776,31158381,2023-02-08,-132.45,826.57
7777,31158381,2023-02-13,-131.36,695.21
688,31183587,2023-01-31,0.0,725.0
3056,31183587,2023-02-02,-36.32,688.68
3057,31183587,2023-02-03,-19.31,669.37
6317,31183587,2023-02-05,1152.5,1821.87
3058,31183587,2023-02-08,-952.0,869.8699999999999
6319,31183587,2023-02-12,112.63,982.4999999999999
6318,31183587,2023-02-12,221.72,1204.2199999999998
3060,31183587,2023-02-13,-117.77,1086.4499999999998
3059,31183587,2023-02-13,-76.49,1009.9599999999999
689,31187024,2023-01-31,0.0,950.41
2749,31187024,2023-02-02,-105.52,844.89
2750,31187024,2023-02-03,-49.39,795.5
2751,31187024,2023-02-04,-125.25,670.25
6947,31187024,2023-02-06,154.42,824.67
2752,31187024,2023-02-08,-537.9,286.77
6948,31187024,2023-02-08,71.81,358.58000000000004
2753,31187024,2023-02-10,-163.18,195.39999999999998
6949,31187024,2023-02-10,782.2,977.6
690,31263913,2023-01-31,0.0,267.5
134,31263913,2023-02-01,-48.78,218.72
135,31263913,2023-02-02,-133.38,85.34
7132,31263913,2023-02-06,84.46,169.8
691,31319183,2023-01-31,0.0,407.92
7099,31319183,2023-02-06,-95.11,312.81
7816,31319183,2023-02-08,58.82,371.63
7100,31319183,2023-02-09,-151.22,220.41000000000003
7817,31319183,2023-02-10,60.41,280.82000000000005
7101,31319183,2023-02-12,-63.33,217.49
7818,31319183,2023-02-12,104.9,322.39000000000004
7819,31319183,2023-02-13,126.66,449.05
692,31335654,2023-01-31,0.0,217.33
3036,31335654,2023-02-02,125.99,343.32
3037,31335654,2023-02-07,146.82,490.14
3038,31335654,2023-02-10,87.63,577.77
3039,31335654,2023-02-10,88.62,666.39
3040,31335654,2023-02-12,1192.7,1859.09
693,31367758,2023-01-31,0.0,536.16
68,31367758,2023-02-01,89.01,625.17
69,31367758,2023-02-08,96.58,721.75
70,31367758,2023-02-10,835.9,1557.65
71,31367758,2023-02-13,107.55,1665.1999999999998
694,31392168,2023-01-31,0.0,615.42
6416,31392168,2023-02-05,-177.67,437.75
7897,31392168,2023-02-08,170.98,608.73
7898,31392168,2023-02-10,143.84,752.5699999999999
7899,31392168,2023-02-13,44.2,796.77
695,31525756,2023-01-31,0.0,363.68
1444,31525756,2023-02-01,81.02,444.7
1445,31525756,2023-02-07,146.76,591.46
8518,31525756,2023-02-12,-128.32,463.14
8519,31525756,2023-02-13,-75.56,387.58
8520,31525756,2023-02-13,-41.85,345.72999999999996
696,31537778,2023-01-31,0.0,335.19
887,31537778,2023-02-01,-36.43,298.76
8680,31537778,2023-02-14,118.75,417.51
697,31541158,2023-01-31,0.0,215.94
7386,31541158,2023-02-07,-107.79,108.14999999999999
7981,31541158,2023-02-09,73.6,181.75
7980,31541158,2023-02-09,120.47,302.21999999999997
7387,31541158,2023-02-13,-110.17,192.04999999999998
698,31557275,2023-01-31,0.0,362.05
2418,31557275,2023-02-02,-162.35,199.70000000000002
2419,31557275,2023-02-05,-63.32,136.38000000000002
7978,31557275,2023-02-09,86.86,223.24
2420,31557275,2023-02-11,-166.3,56.94
7979,31557275,2023-02-14,59.81,116.75
699,31589468,2023-01-31,0.0,713.44
200,31589468,2023-02-01,-807.2,-93.75999999999999
199,31589468,2023-02-01,-78.07,-171.82999999999993
3798,31589468,2023-02-03,117.46,-54.370000000000005
3799,31589468,2023-02-10,142.13,87.75999999999999
201,31589468,2023-02-14,-77.69,10.069999999999936
700,31594938,2023-01-31,0.0,486.88
3497,31594938,2023-02-02,-206.91,279.97
3498,31594938,2023-02-02,-72.9,207.07
4080,31594938,2023-02-03,49.54,256.61
4081,31594938,2023-02-05,230.5,487.11
3500,31594938,2023-02-06,-131.96,355.15
3499,31594938,2023-02-06,-77.22,277.92999999999995
3501,31594938,2023-02-10,-47.87,230.06
3502,31594938,2023-02-14,-90.86,139.2
701,31595213,2023-01-31,0.0,418.35
3602,31595213,2023-02-02,184.44,602.79
3946,31595213,2023-02-03,-110.43,492.36
3603,31595213,2023-02-04,128.21,620.57
3604,31595213,2023-02-10,80.77,701.34
3947,31595213,2023-02-12,-122.61,578.73
3605,31595213,2023-02-14,172.38,751.11
702,31661113,2023-01-31,0.0,309.32
2590,31661113,2023-02-02,68.17,377.49
2591,31661113,2023-02-10,11.31,388.8
2592,31661113,2023-02-10,102.92,491.72
2593,31661113,2023-02-13,16.59,508.31
703,31670977,2023-01-31,0.0,385.42
3103,31670977,2023-02-02,-1520.8,-1135.3799999999999
5699,31670977,2023-02-04,133.3,-1002.0799999999999
5700,31670977,2023-02-08,10.05,-992.03
3104,31670977,2023-02-14,-87.61,-1079.6399999999999
704,31680976,2023-01-31,0.0,327.79
338,31680976,2023-02-01,-82.09,245.70000000000002
339,31680976,2023-02-05,-65.73,179.97000000000003
6850,31680976,2023-02-06,470.6,650.57
6851,31680976,2023-02-08,362.6,1013.1700000000001
341,31680976,2023-02-10,-115.98,897.19
340,31680976,2023-02-10,-69.68,827.51
342,31680976,2023-02-11,-1125.0,-297.48999999999995
6852,31680976,2023-02-14,149.9,-147.58999999999997
705,31689747,2023-01-31,0.0,907.21
343,31689747,2023-02-01,104.57,1011.78
3545,31689747,2023-02-02,-177.5,834.28
3546,31689747,2023-02-04,-41.77,792.51
345,31689747,2023-02-04,19.13,811.64
344,31689747,2023-02-04,89.19,900.83
3547,31689747,2023-02-06,-101.84,798.99
3548,31689747,2023-02-07,-107.26,691.73
346,31689747,2023-02-09,171.71,863.44
706,31693244,2023-01-31,0.0,311.41
3525,31693244,2023-02-02,-145.85,165.56000000000003
3748,31693244,2023-02-03,49.16,214.72000000000003
3526,31693244,2023-02-08,-710.3,-495.58
3527,31693244,2023-02-08,-96.95,-592.53
3749,31693244,2023-02-10,81.43,-511.09999999999997
3529,31693244,2023-02-13,-155.44,-666.54
3528,31693244,2023-02-13,-126.46,-793.0
3530,31693244,2023-02-14,-73.36,-866.3599999999999
707,31759645,2023-01-31,0.0,43.92
1101,31759645,2023-02-01,162.02,205.94
3079,31759645,2023-02-02,-482.7,-276.75999999999993
3080,31759645,2023-02-04,-104.15,-380.91
1102,31759645,2023-02-06,57.88,-323.03
1103,31759645,2023-02-06,123.09,-199.94
3081,31759645,2023-02-07,-169.21,-369.15000000000003
3082,31759645,2023-02-08,-163.97,-533.12
1104,31759645,2023-02-08,79.06,-454.06
3084,31759645,2023-02-09,-110.83,-564.8900000000001
3083,31759645,2023-02-09,-33.72,-598.61
3085,31759645,2023-02-10,-150.77,-749.38
708,31770323,2023-01-31,0.0,666.66
7491,31770323,2023-02-07,-1002.5,-335.84000000000003
7490,31770323,2023-02-07,-74.35,-410.18999999999994
8459,31770323,2023-02-11,60.05,-350.14
8460,31770323,2023-02-12,73.94,-276.20000000000005
8461,31770323,2023-02-12,147.45,-128.7500000000001
7492,31770323,2023-02-13,-181.51,-310.2600000000001
8462,31770323,2023-02-13,109.06,-201.20000000000005
709,31774984,2023-01-31,0.0,964.57
1923,31774984,2023-02-01,127.57,1092.14
1924,31774984,2023-02-04,121.49,1213.63
1925,31774984,2023-02-08,164.7,1378.33
8017,31774984,2023-02-09,-139.86,1238.47
1926,31774984,2023-02-09,127.38,1365.85
1927,31774984,2023-02-11,139.2,1505.0500000000002
710,31826534,2023-01-31,0.0,541.64
3067,31826534,2023-02-02,-95.44,446.2
7387,31826534,2023-02-07,155.12,601.3199999999999
3068,31826534,2023-02-10,-104.86,496.46
3069,31826534,2023-02-11,-85.0,411.46
7388,31826534,2023-02-14,615.6,1027.06
711,31830289,2023-01-31,0.0,816.55
1151,31830289,2023-02-01,44.29,860.8399999999999
7034,31830289,2023-02-06,-154.47,706.3699999999999
1152,31830289,2023-02-14,201.77,908.14
712,31873155,2023-01-31,0.0,351.03
2171,31873155,2023-02-02,-123.2,227.82999999999998
2091,31873155,2023-02-02,27.44,255.26999999999998
2092,31873155,2023-02-04,214.78,470.04999999999995
2172,31873155,2023-02-06,-107.54,362.51
2173,31873155,2023-02-08,-176.94,185.56999999999996
2093,31873155,2023-02-11,111.88,297.44999999999993
2174,31873155,2023-02-12,-9.9,287.54999999999995
713,31957459,2023-01-31,0.0,758.69
379,31957459,2023-02-01,98.52,857.21
3818,31957459,2023-02-03,-113.46,743.75
380,31957459,2023-02-03,67.03,810.7800000000001
381,31957459,2023-02-03,89.23,900.01
3819,31957459,2023-02-06,-104.66,795.35
3820,31957459,2023-02-08,-92.54,702.8100000000001
382,31957459,2023-02-08,10.58,713.3900000000001
3821,31957459,2023-02-10,-97.29,616.1
714,31978646,2023-01-31,0.0,393.51
6473,31978646,2023-02-05,-172.62,220.89
7246,31978646,2023-02-06,189.18,410.07
6474,31978646,2023-02-09,-50.02,360.05
7247,31978646,2023-02-10,89.99,450.03999999999996
7248,31978646,2023-02-11,112.56,562.6
715,32019304,2023-01-31,0.0,961.49
1701,32019304,2023-02-01,-200.4,761.09
768,32019304,2023-02-01,156.79,917.88
769,32019304,2023-02-02,109.57,1027.45
770,32019304,2023-02-08,83.96,1111.4099999999999
771,32019304,2023-02-10,32.99,1144.4
1702,32019304,2023-02-11,-109.66,1034.74
772,32019304,2023-02-13,98.9,1133.6399999999999
716,32084810,2023-01-31,0.0,610.7
2315,32084810,2023-02-02,-167.22,443.48
2316,32084810,2023-02-03,-124.8,318.68000000000006
2317,32084810,2023-02-05,-23.02,295.66
2318,32084810,2023-02-06,-16.67,278.99000000000007
2319,32084810,2023-02-08,-67.6,211.39000000000004
2320,32084810,2023-02-12,-67.02,144.37000000000006
717,32092491,2023-01-31,0.0,51.82
1191,32092491,2023-02-01,126.01,177.83
1192,32092491,2023-02-02,101.15,278.98
1193,32092491,2023-02-03,48.48,327.46
1194,32092491,2023-02-07,186.23,513.69
1195,32092491,2023-02-09,65.15,578.84
1196,32092491,2023-02-10,400.1,978.94
8656,32092491,2023-02-14,-1401.8,-422.85999999999996
8654,32092491,2023-02-14,-349.1,-771.9599999999999
8655,32092491,2023-02-14,-137.92,-909.8799999999999
718,32109414,2023-01-31,0.0,967.31
1047,32109414,2023-02-01,116.27,1083.58
6650,32109414,2023-02-05,-119.48,964.0999999999999
1048,32109414,2023-02-12,62.68,1026.78
6651,32109414,2023-02-13,-109.06,917.7199999999999
719,32131123,2023-01-31,0.0,758.69
5226,32131123,2023-02-04,16.51,775.2
8391,32131123,2023-02-10,-96.17,679.0300000000001
8392,32131123,2023-02-11,-132.94,546.09
720,32192958,2023-01-31,0.0,209.37
2531,32192958,2023-02-02,157.41,366.78
6525,32192958,2023-02-05,-139.75,227.03
2532,32192958,2023-02-05,1625.6,1852.63
2533,32192958,2023-02-07,43.86,1896.4899999999998
2534,32192958,2023-02-11,148.04,2044.5299999999997
6526,32192958,2023-02-13,-1132.5,912.0299999999999
6527,32192958,2023-02-13,-52.19,859.8399999999998
721,32221529,2023-01-31,0.0,887.75
6720,32221529,2023-02-06,114.11,1001.86
6721,32221529,2023-02-06,120.6,1122.46
6722,32221529,2023-02-07,120.64,1243.1
7849,32221529,2023-02-08,-48.19,1194.9099999999999
6723,32221529,2023-02-10,108.57,1303.48
6724,32221529,2023-02-11,45.67,1349.15
7850,32221529,2023-02-13,-70.3,1278.85
6725,32221529,2023-02-13,102.23,1381.08
722,32221652,2023-01-31,0.0,36.96
224,32221652,2023-02-01,-1820.3,-1783.34
223,32221652,2023-02-01,-1089.6,-2872.9399999999996
225,32221652,2023-02-06,-92.29,-2965.23
6709,32221652,2023-02-06,32.37,-2932.8599999999997
6710,32221652,2023-02-07,591.2,-2341.66
226,32221652,2023-02-08,-178.49,-2520.1499999999996
723,32261620,2023-01-31,0.0,55.43
2034,32261620,2023-02-01,787.2,842.63
2036,32261620,2023-02-02,91.97,934.6
2035,32261620,2023-02-02,179.4,1114.0000000000002
2037,32261620,2023-02-03,126.64,1240.64
2038,32261620,2023-02-11,143.78,1384.42
8625,32261620,2023-02-13,-157.9,1226.5200000000002
8626,32261620,2023-02-13,-151.84,1074.68
724,32275676,2023-01-31,0.0,889.61
5001,32275676,2023-02-03,70.29,959.9
7648,32275676,2023-02-07,-173.35,786.5500000000001
5002,32275676,2023-02-09,119.17,905.72
5003,32275676,2023-02-14,70.03,975.75
725,32308270,2023-01-31,0.0,976.53
3903,32308270,2023-02-03,139.16,1115.69
6643,32308270,2023-02-05,-62.56,1053.1299999999999
6644,32308270,2023-02-09,-1060.0,-6.8700000000000045
3904,32308270,2023-02-09,11.67,4.7999999999999545
726,32312381,2023-01-31,0.0,742.85
2078,32312381,2023-02-01,-96.77,646.08
8394,32312381,2023-02-11,134.09,780.1700000000001
727,32312410,2023-01-31,0.0,817.47
5432,32312410,2023-02-04,-89.58,727.89
728,32370392,2023-01-31,0.0,369.09
5078,32370392,2023-02-04,67.93,437.02
5079,32370392,2023-02-05,167.18,604.2
5080,32370392,2023-02-06,64.83,669.03
8315,32370392,2023-02-10,-133.46,535.5699999999999
8316,32370392,2023-02-12,-71.93,463.64
729,32386770,2023-01-31,0.0,639.45
1021,32386770,2023-02-01,-56.55,582.9000000000001
2426,32386770,2023-02-02,101.46,684.36
1022,32386770,2023-02-03,-3.65,680.71
2427,32386770,2023-02-03,716.6,1397.31
2428,32386770,2023-02-05,1131.8,2529.1099999999997
2429,32386770,2023-02-06,72.25,2601.36
1023,32386770,2023-02-07,-51.11,2550.25
2430,32386770,2023-02-07,118.34,2668.59
2431,32386770,2023-02-11,178.01,2846.6000000000004
2432,32386770,2023-02-14,134.52,2981.12
730,32390015,2023-01-31,0.0,529.35
3333,32390015,2023-02-02,-147.44,381.91
3334,32390015,2023-02-04,-117.79,264.12
3335,32390015,2023-02-07,-83.34,180.78000000000003
3336,32390015,2023-02-08,-96.43,84.35000000000002
8030,32390015,2023-02-09,157.13,241.48000000000002
8031,32390015,2023-02-12,88.41,329.89
3337,32390015,2023-02-13,-173.36,156.52999999999997
3338,32390015,2023-02-13,-80.09,76.44
8032,32390015,2023-02-14,137.37,213.81
731,32400822,2023-01-31,0.0,987.34
8005,32400822,2023-02-08,-1808.4,-821.0600000000001
8595,32400822,2023-02-12,183.41,-637.65
8006,32400822,2023-02-14,-136.49,-774.14
732,32408166,2023-01-31,0.0,261.63
1609,32408166,2023-02-01,-670.1,-408.47
1608,32408166,2023-02-01,-65.12,-473.59000000000003
2448,32408166,2023-02-02,62.78,-410.81000000000006
1610,32408166,2023-02-05,-113.82,-524.63
2449,32408166,2023-02-05,81.05,-443.58000000000004
1611,32408166,2023-02-06,-122.96,-566.5400000000001
2450,32408166,2023-02-11,173.97,-392.57000000000005
2451,32408166,2023-02-13,82.89,-309.68000000000006
733,32424424,2023-01-31,0.0,848.04
7027,32424424,2023-02-06,1751.6,2599.64
7028,32424424,2023-02-07,155.69,2755.33
7696,32424424,2023-02-08,-106.62,2648.71
7695,32424424,2023-02-08,-53.13,2595.58
7697,32424424,2023-02-12,-160.33,2435.25
7029,32424424,2023-02-13,91.78,2527.0299999999997
734,32474004,2023-01-31,0.0,509.41
6130,32474004,2023-02-05,-78.96,430.45000000000005
6131,32474004,2023-02-06,-116.91,313.54
7803,32474004,2023-02-08,4.84,318.38
7804,32474004,2023-02-09,106.38,424.76000000000005
735,32476086,2023-01-31,0.0,67.66
7044,32476086,2023-02-06,55.3,122.96
7045,32476086,2023-02-09,115.75,238.71
7046,32476086,2023-02-10,137.56,376.27
7047,32476086,2023-02-12,127.6,503.87
7048,32476086,2023-02-14,908.4,1412.2700000000002
736,32597705,2023-01-31,0.0,869.89
4753,32597705,2023-02-03,-172.24,697.65
4754,32597705,2023-02-03,-125.04,572.6099999999999
4755,32597705,2023-02-06,-76.6,496.01
7831,32597705,2023-02-08,175.42,671.43
4756,32597705,2023-02-12,-90.34,581.0899999999999
4757,32597705,2023-02-13,-111.43,469.65999999999997
737,32641357,2023-01-31,0.0,12.39
4267,32641357,2023-02-03,-16.93,-4.539999999999999
4268,32641357,2023-02-04,-94.62,-99.16000000000001
5743,32641357,2023-02-04,119.25,20.08999999999999
4269,32641357,2023-02-08,-693.0,-672.91
4270,32641357,2023-02-09,-46.37,-719.28
738,32679915,2023-01-31,0.0,841.31
3445,32679915,2023-02-02,-161.91,679.4
3446,32679915,2023-02-03,-109.86,569.54
7049,32679915,2023-02-06,154.3,723.8399999999999
739,32737909,2023-01-31,0.0,744.1
373,32737909,2023-02-01,99.52,843.62
374,32737909,2023-02-02,140.27,983.8900000000001
375,32737909,2023-02-03,37.02,1020.9100000000001
376,32737909,2023-02-04,53.51,1074.42
7274,32737909,2023-02-07,-57.25,1017.1700000000001
377,32737909,2023-02-09,112.93,1130.1
378,32737909,2023-02-10,57.63,1187.73
7275,32737909,2023-02-13,-375.1,812.63
740,32803222,2023-01-31,0.0,827.92
1267,32803222,2023-02-01,-80.92,747.0
8301,32803222,2023-02-10,63.87,810.87
8302,32803222,2023-02-11,142.41,953.28
8303,32803222,2023-02-12,9.9,963.18
8304,32803222,2023-02-13,96.06,1059.24
8305,32803222,2023-02-14,56.66,1115.9
741,32824719,2023-01-31,0.0,502.37
57,32824719,2023-02-01,-9.8,492.57
8356,32824719,2023-02-10,179.1,671.67
58,32824719,2023-02-11,-110.41,561.26
742,32888555,2023-01-31,0.0,781.33
4801,32888555,2023-02-03,76.11,857.44
6001,32888555,2023-02-05,-74.16,783.2800000000001
6002,32888555,2023-02-06,-96.15,687.13
4802,32888555,2023-02-06,1161.4,1848.5300000000002
6003,32888555,2023-02-09,-179.26,1669.27
6004,32888555,2023-02-11,-42.9,1626.3700000000001
4803,32888555,2023-02-12,169.36,1795.73
4804,32888555,2023-02-14,207.36,2003.0900000000001
743,32930305,2023-01-31,0.0,49.71
6369,32930305,2023-02-05,151.29,201.0
7772,32930305,2023-02-08,-209.73,-8.729999999999997
6370,32930305,2023-02-11,73.61,64.88
7773,32930305,2023-02-12,-183.73,-118.85
744,32934183,2023-01-31,0.0,917.81
4933,32934183,2023-02-03,-886.3,31.50999999999999
4934,32934183,2023-02-07,-65.97,-34.460000000000036
8427,32934183,2023-02-11,55.38,20.91999999999996
745,32973728,2023-01-31,0.0,321.03
6992,32973728,2023-02-06,54.71,375.73999999999995
7913,32973728,2023-02-08,-104.18,271.55999999999995
6993,32973728,2023-02-13,131.36,402.91999999999996
746,32991596,2023-01-31,0.0,755.92
1861,32991596,2023-02-01,166.48,922.4
1862,32991596,2023-02-05,65.54,987.9399999999999
1863,32991596,2023-02-07,162.11,1150.05
1864,32991596,2023-02-09,118.82,1268.87
8408,32991596,2023-02-11,-158.64,1110.23
8409,32991596,2023-02-11,-147.54,962.6899999999999
1865,32991596,2023-02-11,1851.4,2814.09
747,33014501,2023-01-31,0.0,454.35
4217,33014501,2023-02-03,-84.12,370.23
4218,33014501,2023-02-03,-68.85,301.38
5504,33014501,2023-02-04,85.27,386.65000000000003
5503,33014501,2023-02-04,129.64,516.29
4219,33014501,2023-02-05,-80.26,436.03
5505,33014501,2023-02-09,77.66,513.69
4220,33014501,2023-02-13,-135.78,377.90999999999997
5506,33014501,2023-02-13,152.83,530.74
748,33112628,2023-01-31,0.0,879.2
3058,33112628,2023-02-02,196.6,1075.8
3059,33112628,2023-02-04,245.23,1321.03
3060,33112628,2023-02-05,133.1,1454.13
7125,33112628,2023-02-06,-75.81,1378.3200000000002
3061,33112628,2023-02-10,99.53,1477.85
7126,33112628,2023-02-11,-123.24,1354.6100000000001
3062,33112628,2023-02-12,84.07,1438.68
3063,33112628,2023-02-13,117.35,1556.03
749,33116647,2023-01-31,0.0,391.76
5768,33116647,2023-02-04,68.44,460.2
6500,33116647,2023-02-05,-60.9,399.3
6501,33116647,2023-02-06,-1095.4,-696.1000000000001
6502,33116647,2023-02-06,-136.49,-832.5900000000001
6503,33116647,2023-02-09,-58.09,-890.6800000000001
5769,33116647,2023-02-09,78.1,-812.5800000000002
5770,33116647,2023-02-13,31.07,-781.5100000000002
6504,33116647,2023-02-14,-60.92,-842.4300000000001
750,33159039,2023-01-31,0.0,100.51
1840,33159039,2023-02-01,-240.2,-139.69
1841,33159039,2023-02-05,-143.3,-282.99
1842,33159039,2023-02-05,-126.51,-409.5
1843,33159039,2023-02-12,-94.36,-503.86
751,33168725,2023-01-31,0.0,211.44
926,33168725,2023-02-01,88.65,300.09000000000003
4095,33168725,2023-02-03,-110.05,190.04000000000002
4096,33168725,2023-02-04,-262.0,-71.95999999999998
4097,33168725,2023-02-10,-99.53,-171.48999999999995
4098,33168725,2023-02-14,-123.42,-294.90999999999997
752,33173974,2023-01-31,0.0,94.47
2746,33173974,2023-02-02,88.57,183.04
2747,33173974,2023-02-04,51.84,234.88
6567,33173974,2023-02-05,-106.32,128.56
6568,33173974,2023-02-06,-98.92,29.64
2748,33173974,2023-02-07,134.59,164.23000000000002
6569,33173974,2023-02-08,-160.1,4.13000000000001
2749,33173974,2023-02-10,162.36,166.49
6570,33173974,2023-02-13,-201.95,-35.45999999999995
2750,33173974,2023-02-13,69.55,34.090000000000046
753,33202593,2023-01-31,0.0,329.25
8157,33202593,2023-02-09,-191.29,137.96
754,33240853,2023-01-31,0.0,985.46
1545,33240853,2023-02-01,-120.69,864.77
7469,33240853,2023-02-07,1429.1,2293.87
1546,33240853,2023-02-09,-938.3,1355.57
7470,33240853,2023-02-11,1318.1,2673.67
7471,33240853,2023-02-13,86.25,2759.92
1547,33240853,2023-02-14,-77.21,2682.71
755,33259781,2023-01-31,0.0,923.18
364,33259781,2023-02-01,-93.43,829.75
6412,33259781,2023-02-05,65.57,895.3199999999999
6413,33259781,2023-02-07,66.88,962.1999999999999
365,33259781,2023-02-08,-149.64,812.56
6414,33259781,2023-02-09,912.8,1725.36
366,33259781,2023-02-10,-150.39,1574.9699999999998
6416,33259781,2023-02-12,93.57,1668.54
6415,33259781,2023-02-12,841.7,2510.24
367,33259781,2023-02-14,-87.23,2423.0099999999998
6417,33259781,2023-02-14,66.29,2489.2999999999997
756,33270307,2023-01-31,0.0,38.51
2394,33270307,2023-02-02,-120.61,-82.1
5816,33270307,2023-02-04,32.62,-49.48000000000001
2395,33270307,2023-02-06,-116.99,-166.47
5817,33270307,2023-02-12,110.81,-55.65999999999999
5818,33270307,2023-02-14,1376.0,1320.34
757,33348876,2023-01-31,0.0,267.33
3374,33348876,2023-02-02,-40.94,226.39
6398,33348876,2023-02-05,60.35,286.74
6399,33348876,2023-02-07,99.21,385.95
6400,33348876,2023-02-07,111.26,497.21
3375,33348876,2023-02-08,-217.58,279.63
3376,33348876,2023-02-09,-153.45,126.17999999999998
758,33351056,2023-01-31,0.0,597.06
2487,33351056,2023-02-02,-142.28,454.78
3827,33351056,2023-02-03,179.13,633.91
3825,33351056,2023-02-03,208.28,842.1899999999999
3826,33351056,2023-02-03,769.3,1611.4899999999998
3828,33351056,2023-02-07,90.26,1701.75
2488,33351056,2023-02-10,-89.98,1611.77
3829,33351056,2023-02-13,84.2,1695.9699999999998
759,33381880,2023-01-31,0.0,682.27
5592,33381880,2023-02-04,-97.06,585.21
5304,33381880,2023-02-04,58.31,643.52
5305,33381880,2023-02-07,75.46,718.98
5593,33381880,2023-02-08,-168.29,550.69
5594,33381880,2023-02-11,-172.57,378.12
5306,33381880,2023-02-12,131.34,509.46
5307,33381880,2023-02-14,73.4,582.86
760,33403100,2023-01-31,0.0,270.23
8460,33403100,2023-02-11,-110.28,159.95000000000002
761,33414190,2023-01-31,0.0,204.38
5568,33414190,2023-02-04,63.54,267.92
7278,33414190,2023-02-07,-29.79,238.13
5569,33414190,2023-02-11,60.37,298.5
7279,33414190,2023-02-13,-150.38,148.12
762,33424425,2023-01-31,0.0,23.18
1828,33424425,2023-02-01,-54.7,-31.520000000000003
3342,33424425,2023-02-02,108.46,76.94
3344,33424425,2023-02-04,45.45,122.38999999999999
3343,33424425,2023-02-04,578.6,700.99
1829,33424425,2023-02-07,-39.59,661.4
3345,33424425,2023-02-13,76.04,737.44
763,33470885,2023-01-31,0.0,531.96
3451,33470885,2023-02-02,181.56,713.52
4271,33470885,2023-02-03,-107.9,605.62
4272,33470885,2023-02-03,-75.66,529.96
4273,33470885,2023-02-05,-70.44,459.52000000000004
3452,33470885,2023-02-07,1676.4,2135.92
4274,33470885,2023-02-12,-1071.4,1064.52
3453,33470885,2023-02-13,61.95,1126.47
3454,33470885,2023-02-14,145.06,1271.53
764,33505838,2023-01-31,0.0,76.39
6127,33505838,2023-02-05,54.53,130.92000000000002
6128,33505838,2023-02-06,135.81,266.73
7229,33505838,2023-02-07,-77.96,188.77
7228,33505838,2023-02-07,-73.26,115.51
6129,33505838,2023-02-08,87.34,202.85000000000002
7230,33505838,2023-02-14,-93.12,109.73
765,33527603,2023-01-31,0.0,413.42
8294,33527603,2023-02-10,-504.8,-91.38
8293,33527603,2023-02-10,-123.66,-215.04000000000002
8295,33527603,2023-02-11,-95.27,-310.31
8607,33527603,2023-02-12,94.05,-216.26000000000005
8608,33527603,2023-02-13,1154.7,938.44
766,33527759,2023-01-31,0.0,245.55
7104,33527759,2023-02-06,-100.9,144.65
7105,33527759,2023-02-11,-792.4,-647.75
767,33561341,2023-01-31,0.0,749.16
117,33561341,2023-02-01,102.31,851.47
118,33561341,2023-02-05,17.25,868.72
119,33561341,2023-02-09,114.45,983.17
768,33632099,2023-01-31,0.0,943.81
5188,33632099,2023-02-04,-1398.7,-454.8900000000001
5189,33632099,2023-02-05,-34.76,-489.6500000000001
5190,33632099,2023-02-10,-83.51,-573.1600000000001
8230,33632099,2023-02-10,88.72,-484.44000000000005
8231,33632099,2023-02-11,1991.3,1506.86
8232,33632099,2023-02-12,1955.6,3462.4599999999996
5191,33632099,2023-02-13,-1370.1,2092.3599999999997
8233,33632099,2023-02-13,54.59,2146.95
5192,33632099,2023-02-14,-57.83,2089.12
769,33634912,2023-01-31,0.0,888.99
3432,33634912,2023-02-02,-49.76,839.23
3433,33634912,2023-02-04,-109.08,730.15
5806,33634912,2023-02-04,26.48,756.63
5807,33634912,2023-02-06,11.61,768.24
3434,33634912,2023-02-10,-141.06,627.1800000000001
3435,33634912,2023-02-13,-151.76,475.42
3436,33634912,2023-02-13,-118.83,356.59000000000003
5808,33634912,2023-02-13,61.34,417.93
3437,33634912,2023-02-14,-163.34,254.59000000000003
770,33749113,2023-01-31,0.0,590.37
3822,33749113,2023-02-03,-144.98,445.39
3823,33749113,2023-02-05,-102.17,343.22
3824,33749113,2023-02-07,-122.02,221.20000000000005
3825,33749113,2023-02-12,-122.81,98.38999999999999
8538,33749113,2023-02-12,126.93,225.32000000000005
771,33749812,2023-01-31,0.0,121.02
3163,33749812,2023-02-02,50.83,171.85
4485,33749812,2023-02-03,-78.92,92.92999999999999
4486,33749812,2023-02-04,-957.5,-864.57
4487,33749812,2023-02-04,-39.76,-904.3300000000002
3164,33749812,2023-02-05,110.07,-794.26
3165,33749812,2023-02-06,100.8,-693.46
772,33750944,2023-01-31,0.0,100.44
6394,33750944,2023-02-05,-138.66,-38.22
8660,33750944,2023-02-14,120.83,82.61
773,33771855,2023-01-31,0.0,886.78
1663,33771855,2023-02-01,-527.1,359.67999999999995
1397,33771855,2023-02-01,153.65,513.3299999999999
1664,33771855,2023-02-05,-230.5,282.8299999999999
1398,33771855,2023-02-09,26.32,309.15
1665,33771855,2023-02-11,-203.67,105.48000000000002
1399,33771855,2023-02-13,45.56,151.03999999999996
774,33806253,2023-01-31,0.0,847.44
857,33806253,2023-02-01,151.18,998.6200000000001
6253,33806253,2023-02-05,-144.63,853.99
6254,33806253,2023-02-06,-110.47,743.5200000000001
6255,33806253,2023-02-09,-87.02,656.5
858,33806253,2023-02-10,139.76,796.26
775,33832864,2023-01-31,0.0,46.85
2405,33832864,2023-02-02,-109.28,-62.43
2406,33832864,2023-02-03,-128.62,-191.05
2407,33832864,2023-02-06,-1743.5,-1934.5500000000002
8629,33832864,2023-02-13,123.05,-1811.5000000000002
776,33906740,2023-01-31,0.0,820.46
625,33906740,2023-02-01,-67.52,752.94
626,33906740,2023-02-02,-701.1,51.84000000000003
627,33906740,2023-02-04,-62.69,-10.849999999999909
628,33906740,2023-02-04,-46.49,-57.33999999999992
629,33906740,2023-02-10,-747.3,-804.6399999999999
8499,33906740,2023-02-11,105.46,-699.1799999999998
630,33906740,2023-02-12,-24.74,-723.9199999999998
8500,33906740,2023-02-14,147.38,-576.54
777,33914941,2023-01-31,0.0,665.9
1417,33914941,2023-02-01,-160.48,505.41999999999996
1418,33914941,2023-02-03,-105.07,400.35
1419,33914941,2023-02-05,-142.97,257.38
1420,33914941,2023-02-06,-54.05,203.32999999999998
778,33915504,2023-01-31,0.0,742.98
7648,33915504,2023-02-07,134.62,877.6
8283,33915504,2023-02-10,-712.2,165.39999999999998
8284,33915504,2023-02-11,-78.32,87.07999999999993
7649,33915504,2023-02-11,1136.3,1223.3799999999999
8285,33915504,2023-02-12,-108.16,1115.2199999999998
7650,33915504,2023-02-13,124.44,1239.6599999999999
8286,33915504,2023-02-14,-2237.0,-997.3400000000001
8287,33915504,2023-02-14,-50.82,-1048.16
779,33967237,2023-01-31,0.0,324.8
752,33967237,2023-02-01,142.15,466.95000000000005
753,33967237,2023-02-03,152.86,619.81
5060,33967237,2023-02-04,-87.08,532.73
754,33967237,2023-02-04,108.21,640.94
755,33967237,2023-02-07,53.6,694.54
5061,33967237,2023-02-13,-65.9,628.6400000000001
5062,33967237,2023-02-14,-66.68,561.96
780,34017695,2023-01-31,0.0,672.46
148,34017695,2023-02-01,79.2,751.6600000000001
5506,34017695,2023-02-04,-73.93,677.73
5507,34017695,2023-02-05,-36.56,641.1700000000001
5508,34017695,2023-02-07,-218.5,422.67
5509,34017695,2023-02-08,-67.49,355.18
5511,34017695,2023-02-13,-1756.0,-1400.8200000000002
5510,34017695,2023-02-13,-144.46,-1545.2799999999997
149,34017695,2023-02-13,148.43,-1396.85
5512,34017695,2023-02-14,-2002.7,-3399.55
150,34017695,2023-02-14,150.24,-3249.31
781,34027487,2023-01-31,0.0,54.87
2216,34027487,2023-02-02,-56.02,-1.1500000000000057
2217,34027487,2023-02-07,-192.3,-193.45000000000002
8276,34027487,2023-02-10,123.94,-69.51000000000002
2218,34027487,2023-02-11,-43.17,-112.68
8277,34027487,2023-02-12,57.16,-55.52000000000003
8278,34027487,2023-02-13,144.25,88.72999999999996
8279,34027487,2023-02-14,101.1,189.82999999999998
782,34112514,2023-01-31,0.0,974.1
8572,34112514,2023-02-12,-123.24,850.86
783,34128127,2023-01-31,0.0,275.83
14,34128127,2023-02-01,88.1,363.92999999999995
16,34128127,2023-02-05,136.6,500.53
15,34128127,2023-02-05,841.2,1341.73
17,34128127,2023-02-10,15.25,1356.98
8420,34128127,2023-02-11,-45.02,1311.96
784,34158235,2023-01-31,0.0,50.76
3138,34158235,2023-02-02,95.52,146.28
4305,34158235,2023-02-03,-85.48,60.79999999999999
3139,34158235,2023-02-05,65.82,126.61999999999998
3140,34158235,2023-02-06,132.93,259.55
4306,34158235,2023-02-07,-43.24,216.30999999999997
4307,34158235,2023-02-08,-80.16,136.14999999999998
4308,34158235,2023-02-10,-81.26,54.88999999999998
4309,34158235,2023-02-13,-156.49,-101.60000000000002
4310,34158235,2023-02-14,-439.8,-541.4000000000001
4311,34158235,2023-02-14,-159.08,-700.48
785,34190086,2023-01-31,0.0,890.87
676,34190086,2023-02-01,65.9,956.77
7701,34190086,2023-02-08,-144.06,812.71
7702,34190086,2023-02-13,-73.96,738.75
677,34190086,2023-02-13,69.63,808.38
678,34190086,2023-02-14,25.45,833.83
786,34252525,2023-01-31,0.0,107.18
2609,34252525,2023-02-02,-95.27,11.91000000000001
2610,34252525,2023-02-04,-244.13,-232.21999999999997
5603,34252525,2023-02-04,113.49,-118.72999999999996
5604,34252525,2023-02-07,82.79,-35.93999999999997
2611,34252525,2023-02-08,-85.07,-121.00999999999996
5605,34252525,2023-02-13,1503.4,1382.39
787,34264499,2023-01-31,0.0,864.86
7733,34264499,2023-02-08,105.97,970.83
7736,34264499,2023-02-09,25.95,996.78
7735,34264499,2023-02-09,135.68,1132.46
7734,34264499,2023-02-09,898.1,2030.56
8510,34264499,2023-02-12,-77.9,1952.6599999999999
7737,34264499,2023-02-13,76.07,2028.73
7738,34264499,2023-02-14,72.4,2101.13
788,34275044,2023-01-31,0.0,532.29
7472,34275044,2023-02-07,79.84,612.13
7473,34275044,2023-02-08,144.26,756.39
7474,34275044,2023-02-10,91.66,848.05
7475,34275044,2023-02-11,109.94,957.99
8590,34275044,2023-02-13,-156.89,801.0999999999999
789,34284479,2023-01-31,0.0,74.46
5319,34284479,2023-02-04,-25.74,48.72
6189,34284479,2023-02-05,155.64,204.35999999999996
5320,34284479,2023-02-08,-203.1,1.2599999999999767
5321,34284479,2023-02-08,-66.05,-64.79
6190,34284479,2023-02-10,63.76,-1.0300000000000153
6191,34284479,2023-02-12,122.48,121.44999999999997
790,34336001,2023-01-31,0.0,396.75
1184,34336001,2023-02-01,-48.39,348.36
7203,34336001,2023-02-06,133.66,482.02
7204,34336001,2023-02-08,186.34,668.36
1185,34336001,2023-02-12,-71.39,596.97
1186,34336001,2023-02-14,-89.16,507.81
7205,34336001,2023-02-14,72.93,580.74
791,34351752,2023-01-31,0.0,30.31
2889,34351752,2023-02-02,-27.52,2.789999999999999
2890,34351752,2023-02-02,-12.65,-9.860000000000003
2891,34351752,2023-02-05,-227.66,-237.51999999999998
792,34374766,2023-01-31,0.0,916.09
787,34374766,2023-02-01,131.53,1047.6200000000001
788,34374766,2023-02-03,749.7,1797.3200000000002
6732,34374766,2023-02-06,-138.24,1659.08
6733,34374766,2023-02-08,-233.36,1425.72
789,34374766,2023-02-08,968.8,2394.52
6734,34374766,2023-02-10,-68.91,2325.61
790,34374766,2023-02-14,13.43,2339.04
793,34400277,2023-01-31,0.0,207.59
1637,34400277,2023-02-01,-1393.7,-1186.1100000000001
4597,34400277,2023-02-03,68.13,-1117.9800000000002
4598,34400277,2023-02-04,76.66,-1041.3200000000002
4599,34400277,2023-02-04,150.45,-890.87
4600,34400277,2023-02-05,6.72,-884.15
4601,34400277,2023-02-06,688.5,-195.65
1638,34400277,2023-02-10,-54.78,-250.42999999999998
1639,34400277,2023-02-14,-86.17,-336.6
4602,34400277,2023-02-14,113.52,-223.08
794,34403979,2023-01-31,0.0,101.14
718,34403979,2023-02-01,181.06,282.2
3318,34403979,2023-02-02,-98.37,183.82999999999998
719,34403979,2023-02-04,77.37,261.2
3319,34403979,2023-02-07,-210.28,50.92
720,34403979,2023-02-11,42.47,93.39
3320,34403979,2023-02-12,-1201.1,-1107.7099999999998
721,34403979,2023-02-14,85.41,-1022.2999999999998
795,34461285,2023-01-31,0.0,149.82
5523,34461285,2023-02-04,83.73,233.55
5524,34461285,2023-02-06,121.6,355.15
8224,34461285,2023-02-10,-109.1,246.05
8225,34461285,2023-02-11,-128.1,117.95
5525,34461285,2023-02-11,143.15,261.1
5526,34461285,2023-02-13,82.99,344.09000000000003
796,34482885,2023-01-31,0.0,359.84
6217,34482885,2023-02-05,-161.46,198.37999999999997
6218,34482885,2023-02-08,-175.42,22.95999999999998
7780,34482885,2023-02-08,358.9,381.85999999999996
7781,34482885,2023-02-11,1161.1,1542.9599999999998
6219,34482885,2023-02-14,-90.48,1452.4799999999998
797,34650969,2023-01-31,0.0,177.82
6258,34650969,2023-02-05,-116.94,60.879999999999995
6259,34650969,2023-02-06,-995.2,-934.3200000000002
7868,34650969,2023-02-08,69.02,-865.3000000000002
6260,34650969,2023-02-10,-63.76,-929.0600000000002
798,34681193,2023-01-31,0.0,183.13
319,34681193,2023-02-01,-216.49,-33.360000000000014
5747,34681193,2023-02-04,67.01,33.64999999999998
5748,34681193,2023-02-06,133.12,166.76999999999998
320,34681193,2023-02-07,-124.56,42.20999999999998
5749,34681193,2023-02-09,73.98,116.18999999999998
321,34681193,2023-02-13,-115.5,0.6899999999999977
799,34866268,2023-01-31,0.0,516.92
4430,34866268,2023-02-03,-178.47,338.44999999999993
8594,34866268,2023-02-12,1261.7,1600.15
800,34867145,2023-01-31,0.0,212.16
3576,34867145,2023-02-02,-211.27,0.8899999999999864
3577,34867145,2023-02-05,-135.59,-134.70000000000002
3578,34867145,2023-02-10,-41.65,-176.35
801,34902863,2023-01-31,0.0,31.36
16,34902863,2023-02-01,-89.22,-57.86
17,34902863,2023-02-04,-68.54,-126.39999999999999
6753,34902863,2023-02-06,85.44,-40.96000000000001
6754,34902863,2023-02-07,140.1,99.13999999999999
6755,34902863,2023-02-11,191.93,291.07
802,34908905,2023-01-31,0.0,887.49
5673,34908905,2023-02-04,-102.31,785.1800000000001
6267,34908905,2023-02-05,17.69,802.87
5674,34908905,2023-02-07,-46.81,756.06
5675,34908905,2023-02-08,-155.62,600.44
5676,34908905,2023-02-09,-134.87,465.57
6268,34908905,2023-02-09,134.21,599.78
5677,34908905,2023-02-13,-124.37,475.40999999999997
803,34921262,2023-01-31,0.0,971.82
6405,34921262,2023-02-05,-1917.1,-945.2799999999999
7622,34921262,2023-02-07,71.52,-873.7599999999999
6406,34921262,2023-02-08,-101.87,-975.6299999999998
6407,34921262,2023-02-10,-84.84,-1060.4699999999998
7623,34921262,2023-02-13,49.05,-1011.42
6408,34921262,2023-02-14,-48.39,-1059.81
804,34960760,2023-01-31,0.0,981.79
2797,34960760,2023-02-02,-190.9,790.89
2798,34960760,2023-02-09,-95.76,695.1299999999999
8243,34960760,2023-02-10,89.12,784.25
8244,34960760,2023-02-12,160.14,944.3899999999999
805,35038984,2023-01-31,0.0,566.36
7560,35038984,2023-02-07,-176.01,390.35
7259,35038984,2023-02-07,107.2,497.55
7260,35038984,2023-02-09,94.29,591.84
7561,35038984,2023-02-11,-99.57,492.27000000000004
806,35051369,2023-01-31,0.0,637.18
1650,35051369,2023-02-01,-43.65,593.53
2969,35051369,2023-02-02,112.35,705.8799999999999
1651,35051369,2023-02-04,-198.37,507.50999999999993
1652,35051369,2023-02-11,-49.94,457.56999999999994
807,35082945,2023-01-31,0.0,713.95
7225,35082945,2023-02-07,-15.77,698.1800000000001
7226,35082945,2023-02-08,-132.78,565.4000000000001
8592,35082945,2023-02-12,113.6,679.0
8593,35082945,2023-02-14,188.72,867.72
808,35083564,2023-01-31,0.0,599.99
5911,35083564,2023-02-05,144.77,744.76
7145,35083564,2023-02-06,-181.24,563.52
7144,35083564,2023-02-06,-32.2,531.32
5912,35083564,2023-02-08,139.22,670.54
5913,35083564,2023-02-09,59.54,730.08
809,35126236,2023-01-31,0.0,739.8
2408,35126236,2023-02-02,-379.5,360.29999999999995
2409,35126236,2023-02-04,-109.21,251.08999999999997
5876,35126236,2023-02-04,64.48,315.56999999999994
5877,35126236,2023-02-06,995.2,1310.77
5878,35126236,2023-02-08,103.89,1414.6599999999999
5879,35126236,2023-02-08,130.56,1545.22
2410,35126236,2023-02-10,-34.71,1510.51
5881,35126236,2023-02-13,114.39,1624.9
5880,35126236,2023-02-13,137.35,1762.25
5882,35126236,2023-02-14,2138.0,3900.25
810,35160368,2023-01-31,0.0,53.59
110,35160368,2023-02-01,41.55,95.14
112,35160368,2023-02-05,85.08,180.22
111,35160368,2023-02-05,163.32,343.53999999999996
113,35160368,2023-02-10,155.39,498.92999999999995
114,35160368,2023-02-12,139.57,638.5
8641,35160368,2023-02-13,-39.15,599.35
8642,35160368,2023-02-14,-92.59,506.76
115,35160368,2023-02-14,87.33,594.09
811,35177782,2023-01-31,0.0,79.03
4191,35177782,2023-02-03,149.54,228.57
4192,35177782,2023-02-08,110.25,338.81999999999994
8210,35177782,2023-02-09,-105.82,233.0
8211,35177782,2023-02-10,-123.77,109.23
4193,35177782,2023-02-10,72.18,181.41000000000003
4194,35177782,2023-02-11,99.42,280.83000000000004
812,35194218,2023-01-31,0.0,842.34
1181,35194218,2023-02-01,142.2,984.54
1182,35194218,2023-02-04,5.86,990.4000000000001
6272,35194218,2023-02-05,-812.6,177.80000000000007
1183,35194218,2023-02-10,70.43,248.2299999999999
6273,35194218,2023-02-11,-134.16,114.06999999999994
6274,35194218,2023-02-12,-76.1,37.969999999999914
813,35197451,2023-01-31,0.0,411.69
907,35197451,2023-02-01,-96.06,315.63
2835,35197451,2023-02-02,0.91,316.53999999999996
2836,35197451,2023-02-03,98.31,414.85
2838,35197451,2023-02-05,86.14,500.99
2837,35197451,2023-02-05,141.51,642.5
2839,35197451,2023-02-07,131.84,774.3399999999999
908,35197451,2023-02-11,-148.4,625.94
909,35197451,2023-02-11,-60.22,565.72
2840,35197451,2023-02-14,723.4,1289.12
814,35210460,2023-01-31,0.0,185.3
2136,35210460,2023-02-01,-99.63,85.67000000000002
625,35210460,2023-02-01,1821.2,1906.8700000000001
626,35210460,2023-02-03,117.47,2024.34
627,35210460,2023-02-08,199.46,2223.8
628,35210460,2023-02-09,42.5,2266.3
629,35210460,2023-02-10,68.78,2335.08
815,35293864,2023-01-31,0.0,592.55
269,35293864,2023-02-01,-68.47,524.0799999999999
816,35321469,2023-01-31,0.0,194.57
918,35321469,2023-02-01,76.26,270.83
2275,35321469,2023-02-02,-119.36,151.47
2276,35321469,2023-02-07,-113.03,38.44
919,35321469,2023-02-09,74.96,113.39999999999999
2277,35321469,2023-02-14,-51.78,61.620000000000005
817,35330225,2023-01-31,0.0,717.9
3175,35330225,2023-02-02,38.42,756.3199999999999
3176,35330225,2023-02-04,117.96,874.28
3177,35330225,2023-02-05,72.1,946.38
7081,35330225,2023-02-06,-90.78,855.5999999999999
7082,35330225,2023-02-08,-95.08,760.52
3178,35330225,2023-02-09,1169.4,1929.92
7083,35330225,2023-02-14,-505.6,1424.32
818,35345678,2023-01-31,0.0,381.43
2541,35345678,2023-02-02,98.51,479.94
2542,35345678,2023-02-03,170.7,650.64
7137,35345678,2023-02-06,-97.06,553.5799999999999
2543,35345678,2023-02-06,153.53,707.1099999999999
7138,35345678,2023-02-07,-127.56,579.55
819,35379604,2023-01-31,0.0,171.68
7076,35379604,2023-02-06,-84.79,86.89
6727,35379604,2023-02-06,28.36,115.25
6729,35379604,2023-02-08,14.65,129.9
6728,35379604,2023-02-08,693.0,822.9000000000001
7077,35379604,2023-02-10,-113.82,709.0800000000002
7078,35379604,2023-02-13,-58.62,650.46
820,35391237,2023-01-31,0.0,412.06
295,35391237,2023-02-01,-126.5,285.56
296,35391237,2023-02-01,-105.94,179.62
432,35391237,2023-02-01,103.94,283.56
297,35391237,2023-02-02,-97.9,185.66
298,35391237,2023-02-03,-147.6,38.06
299,35391237,2023-02-04,-163.03,-124.96999999999997
300,35391237,2023-02-07,-153.96,-278.93
433,35391237,2023-02-11,58.36,-220.57
301,35391237,2023-02-13,-134.72,-355.29
434,35391237,2023-02-14,135.7,-219.5900000000001
821,35391340,2023-01-31,0.0,886.56
655,35391340,2023-02-01,-119.2,767.3599999999999
656,35391340,2023-02-04,-100.63,666.73
5065,35391340,2023-02-04,125.41,792.14
657,35391340,2023-02-08,-77.26,714.8799999999999
5066,35391340,2023-02-09,64.44,779.3199999999999
5067,35391340,2023-02-09,156.67,935.9899999999999
658,35391340,2023-02-11,-87.63,848.3599999999999
5068,35391340,2023-02-11,109.76,958.1199999999999
659,35391340,2023-02-12,-115.04,843.0799999999999
822,35405748,2023-01-31,0.0,19.49
3211,35405748,2023-02-02,1666.0,1685.49
4300,35405748,2023-02-03,-171.99,1513.5
4301,35405748,2023-02-06,-60.39,1453.11
4302,35405748,2023-02-09,-63.99,1389.12
823,35445202,2023-01-31,0.0,972.48
5598,35445202,2023-02-04,-95.01,877.47
5316,35445202,2023-02-04,138.34,1015.8100000000001
5317,35445202,2023-02-05,42.25,1058.06
5318,35445202,2023-02-07,71.12,1129.18
5599,35445202,2023-02-13,-80.72,1048.46
5319,35445202,2023-02-13,50.67,1099.13
5320,35445202,2023-02-14,128.56,1227.69
824,35506101,2023-01-31,0.0,713.65
5132,35506101,2023-02-04,-143.83,569.8199999999999
5133,35506101,2023-02-06,-368.9,200.91999999999996
7269,35506101,2023-02-07,15.77,216.68999999999994
7270,35506101,2023-02-07,26.09,242.77999999999997
7271,35506101,2023-02-08,70.92,313.69999999999993
5134,35506101,2023-02-09,-1386.8,-1073.1
7272,35506101,2023-02-09,87.02,-986.08
5135,35506101,2023-02-11,-107.95,-1094.0300000000002
825,35510004,2023-01-31,0.0,723.62
7253,35510004,2023-02-07,-53.14,670.48
7254,35510004,2023-02-09,-140.03,530.45
8684,35510004,2023-02-14,122.94,653.39
826,35539408,2023-01-31,0.0,469.13
7874,35539408,2023-02-08,66.58,535.71
8564,35539408,2023-02-12,-60.3,475.40999999999997
7875,35539408,2023-02-12,20.96,496.37
827,35540836,2023-01-31,0.0,17.91
1553,35540836,2023-02-01,120.69,138.6
1554,35540836,2023-02-04,162.1,300.7
8424,35540836,2023-02-11,-64.55,236.15
1555,35540836,2023-02-12,850.1,1086.2500000000002
828,35549277,2023-01-31,0.0,505.72
3837,35549277,2023-02-03,164.14,669.86
3838,35549277,2023-02-04,143.95,813.81
3839,35549277,2023-02-06,54.21,868.02
7730,35549277,2023-02-08,-65.82,802.2
3840,35549277,2023-02-09,79.33,881.53
3841,35549277,2023-02-14,135.72,1017.25
829,35555120,2023-01-31,0.0,598.72
6512,35555120,2023-02-05,-112.03,486.69000000000005
6513,35555120,2023-02-06,-155.04,331.65000000000003
6514,35555120,2023-02-09,-75.39,256.26000000000005
830,35564578,2023-01-31,0.0,621.37
1418,35564578,2023-02-01,101.68,723.05
1419,35564578,2023-02-01,156.88,879.9300000000001
6174,35564578,2023-02-05,-33.32,846.61
1421,35564578,2023-02-06,76.6,923.21
1420,35564578,2023-02-06,140.83,1064.04
6175,35564578,2023-02-07,-93.89,970.1500000000001
1422,35564578,2023-02-09,93.14,1063.29
6176,35564578,2023-02-11,-909.1,154.19
6177,35564578,2023-02-12,-95.71,58.48000000000002
1423,35564578,2023-02-14,153.48,211.95999999999998
831,35574156,2023-01-31,0.0,471.05
2299,35574156,2023-02-02,-113.03,358.02
2768,35574156,2023-02-02,81.2,439.22
2300,35574156,2023-02-04,-98.27,340.95000000000005
2769,35574156,2023-02-10,117.79,458.74
2301,35574156,2023-02-12,-71.65,387.09000000000003
832,35614465,2023-01-31,0.0,276.17
1384,35614465,2023-02-01,-111.48,164.69
418,35614465,2023-02-01,75.62,240.31
417,35614465,2023-02-01,106.89,347.20000000000005
419,35614465,2023-02-02,68.58,415.78000000000003
421,35614465,2023-02-04,82.25,498.03000000000003
420,35614465,2023-02-04,238.96,736.99
422,35614465,2023-02-07,176.01,913.0
1385,35614465,2023-02-09,-81.5,831.5
1386,35614465,2023-02-12,-41.61,789.8900000000001
1387,35614465,2023-02-14,-69.51,720.38
423,35614465,2023-02-14,52.1,772.48
833,35616763,2023-01-31,0.0,279.43
3800,35616763,2023-02-03,144.98,424.40999999999997
3801,35616763,2023-02-04,90.91,515.3199999999999
3802,35616763,2023-02-04,91.88,607.2
3803,35616763,2023-02-05,98.9,706.0999999999999
8198,35616763,2023-02-09,-94.78,611.3199999999999
8199,35616763,2023-02-10,-133.89,477.43
834,35633136,2023-01-31,0.0,603.11
7581,35633136,2023-02-07,-140.72,462.39
7582,35633136,2023-02-08,-1589.0,-1126.6100000000001
8162,35633136,2023-02-09,1855.5,728.89
7583,35633136,2023-02-10,-85.16,643.73
7584,35633136,2023-02-12,-128.62,515.11
8163,35633136,2023-02-14,223.99,739.1
835,35642953,2023-01-31,0.0,137.26
7601,35642953,2023-02-07,-45.83,91.42999999999999
8365,35642953,2023-02-10,141.83,233.26
7602,35642953,2023-02-11,-102.43,130.82999999999998
8366,35642953,2023-02-13,126.72,257.55
836,35652360,2023-01-31,0.0,41.81
3264,35652360,2023-02-02,87.3,129.11
7638,35652360,2023-02-07,-135.62,-6.510000000000005
7639,35652360,2023-02-10,-101.74,-108.25
7640,35652360,2023-02-12,-7.46,-115.71000000000001
837,35698347,2023-01-31,0.0,258.22
8140,35698347,2023-02-09,-145.02,113.20000000000002
8141,35698347,2023-02-12,-143.1,-29.899999999999977
8569,35698347,2023-02-12,28.42,-1.4799999999999613
8567,35698347,2023-02-12,76.36,74.88000000000002
8568,35698347,2023-02-12,82.2,157.08000000000004
8570,35698347,2023-02-13,23.8,180.88000000000002
8142,35698347,2023-02-14,-105.03,75.85000000000002
838,35712712,2023-01-31,0.0,828.88
3069,35712712,2023-02-02,94.92,923.8
3070,35712712,2023-02-04,91.22,1015.02
8613,35712712,2023-02-13,-93.58,921.44
8614,35712712,2023-02-14,-131.58,789.86
839,35721788,2023-01-31,0.0,837.07
2781,35721788,2023-02-02,47.72,884.7900000000001
2782,35721788,2023-02-04,1548.2,2432.9900000000002
6231,35721788,2023-02-05,-189.35,2243.6400000000003
2783,35721788,2023-02-07,166.27,2409.9100000000003
6232,35721788,2023-02-11,-67.03,2342.88
840,35726421,2023-01-31,0.0,379.1
314,35726421,2023-02-01,-36.3,342.8
315,35726421,2023-02-09,-32.68,310.12
7991,35726421,2023-02-09,257.1,567.22
316,35726421,2023-02-11,-117.41,449.81000000000006
317,35726421,2023-02-12,-146.81,303.00000000000006
7992,35726421,2023-02-12,118.77,421.77000000000004
7993,35726421,2023-02-13,32.01,453.7800000000001
318,35726421,2023-02-14,-84.96,368.82000000000005
7994,35726421,2023-02-14,143.07,511.89000000000004
841,35746207,2023-01-31,0.0,785.36
2226,35746207,2023-02-02,142.26,927.62
5542,35746207,2023-02-04,-163.58,764.04
5543,35746207,2023-02-08,-136.06,627.98
5544,35746207,2023-02-09,-180.04,447.94
5545,35746207,2023-02-11,-106.87,341.07
5546,35746207,2023-02-14,-73.77,267.29999999999995
2227,35746207,2023-02-14,82.48,349.78
842,35762783,2023-01-31,0.0,346.14
5069,35762783,2023-02-04,34.64,380.78
6908,35762783,2023-02-06,-98.21,282.57
5070,35762783,2023-02-06,97.52,380.09
843,35772673,2023-01-31,0.0,517.9
597,35772673,2023-02-01,-76.39,441.51
8475,35772673,2023-02-11,17.45,458.96
8476,35772673,2023-02-12,113.78,572.74
844,35799522,2023-01-31,0.0,750.79
5865,35799522,2023-02-04,-84.48,666.31
5580,35799522,2023-02-04,122.19,788.5
5581,35799522,2023-02-08,811.2,1599.7
5582,35799522,2023-02-09,77.09,1676.79
5866,35799522,2023-02-12,-122.13,1554.66
5583,35799522,2023-02-12,481.2,2035.8600000000001
5584,35799522,2023-02-13,53.69,2089.55
845,35805852,2023-01-31,0.0,886.37
4200,35805852,2023-02-03,26.28,912.65
4201,35805852,2023-02-08,159.05,1071.7
8598,35805852,2023-02-13,-128.78,942.9200000000001
8599,35805852,2023-02-13,-80.1,862.82
846,35827625,2023-01-31,0.0,445.63
109,35827625,2023-02-01,-4.45,441.18
110,35827625,2023-02-03,-130.92,310.26
6713,35827625,2023-02-06,50.86,361.12
6714,35827625,2023-02-07,166.06,527.1800000000001
111,35827625,2023-02-08,-103.49,423.69000000000005
6715,35827625,2023-02-13,138.07,561.76
847,35869347,2023-01-31,0.0,768.74
1374,35869347,2023-02-01,-99.06,669.6800000000001
6788,35869347,2023-02-06,128.7,798.38
1375,35869347,2023-02-08,-63.42,734.96
6789,35869347,2023-02-09,122.91,857.87
6790,35869347,2023-02-10,504.8,1362.67
1376,35869347,2023-02-13,-650.5,712.17
848,35948735,2023-01-31,0.0,117.14
7009,35948735,2023-02-06,173.27,290.41
7971,35948735,2023-02-08,-257.4,33.01000000000003
7972,35948735,2023-02-10,-59.81,-26.79999999999997
7973,35948735,2023-02-12,-103.8,-130.59999999999997
7010,35948735,2023-02-13,145.83,15.230000000000032
849,35996817,2023-01-31,0.0,187.89
2948,35996817,2023-02-02,-807.9,-620.01
2191,35996817,2023-02-02,62.13,-557.88
2949,35996817,2023-02-03,-955.4,-1513.2800000000002
2192,35996817,2023-02-04,97.19,-1416.0900000000001
2193,35996817,2023-02-04,162.76,-1253.33
2194,35996817,2023-02-05,39.08,-1214.25
2195,35996817,2023-02-06,1144.5,-69.74999999999989
2950,35996817,2023-02-13,-111.75,-181.4999999999999
850,36007496,2023-01-31,0.0,239.44
4186,36007496,2023-02-03,-106.54,132.89999999999998
5517,36007496,2023-02-04,130.37,263.27
4187,36007496,2023-02-10,-142.78,120.49
4188,36007496,2023-02-11,-55.67,64.82
4189,36007496,2023-02-12,-90.33,-25.50999999999999
851,36106467,2023-01-31,0.0,720.17
3637,36106467,2023-02-02,54.11,774.28
8632,36106467,2023-02-13,-48.97,725.31
8633,36106467,2023-02-14,-109.13,616.18
852,36110938,2023-01-31,0.0,532.77
6180,36110938,2023-02-05,-151.15,381.62
6181,36110938,2023-02-14,-51.36,330.26
8661,36110938,2023-02-14,110.42,440.67999999999995
853,36112473,2023-01-31,0.0,530.67
2390,36112473,2023-02-02,104.28,634.9499999999999
7509,36112473,2023-02-07,-16.72,618.23
2392,36112473,2023-02-08,37.07,655.3
2391,36112473,2023-02-08,128.42,783.7199999999999
2393,36112473,2023-02-11,111.87,895.5899999999999
854,36114551,2023-01-31,0.0,876.22
3831,36114551,2023-02-03,-1488.0,-611.78
3830,36114551,2023-02-03,-12.53,-624.31
3832,36114551,2023-02-07,-9.52,-633.8299999999999
8408,36114551,2023-02-11,113.2,-520.6299999999999
8407,36114551,2023-02-11,134.5,-386.1299999999999
3833,36114551,2023-02-13,-154.15,-540.28
8409,36114551,2023-02-14,134.51,-405.77
855,36126802,2023-01-31,0.0,617.04
5689,36126802,2023-02-04,117.97,735.01
8227,36126802,2023-02-10,-122.66,612.3499999999999
8228,36126802,2023-02-12,-80.63,531.72
856,36131723,2023-01-31,0.0,602.96
2824,36131723,2023-02-02,723.0,1325.96
2825,36131723,2023-02-06,74.78,1400.74
2826,36131723,2023-02-07,153.24,1553.98
7751,36131723,2023-02-08,-60.7,1493.2800000000002
2827,36131723,2023-02-13,118.36,1611.64
857,36141472,2023-01-31,0.0,656.7
7986,36141472,2023-02-09,20.1,676.8000000000001
858,36143004,2023-01-31,0.0,256.22
4126,36143004,2023-02-03,-132.95,123.27000000000004
4127,36143004,2023-02-04,-58.74,64.53000000000003
7893,36143004,2023-02-08,111.03,175.56000000000003
7894,36143004,2023-02-13,127.19,302.75
859,36171568,2023-01-31,0.0,343.44
7133,36171568,2023-02-06,-169.47,173.97
8655,36171568,2023-02-14,151.47,325.44
860,36192947,2023-01-31,0.0,744.33
3650,36192947,2023-02-02,73.15,817.48
3651,36192947,2023-02-04,47.16,864.6400000000001
6267,36192947,2023-02-05,-158.54,706.1
6269,36192947,2023-02-05,-134.86,571.24
6268,36192947,2023-02-05,-103.8,467.44000000000005
3652,36192947,2023-02-07,435.8,903.24
6270,36192947,2023-02-11,-69.7,833.5400000000001
3653,36192947,2023-02-11,36.38,869.9200000000001
6271,36192947,2023-02-13,-44.57,825.35
3654,36192947,2023-02-14,74.53,899.8800000000001
861,36197772,2023-01-31,0.0,962.03
795,36197772,2023-02-01,-21.82,940.2099999999999
796,36197772,2023-02-04,-189.3,750.91
6968,36197772,2023-02-06,179.58,930.49
797,36197772,2023-02-12,-77.33,853.16
798,36197772,2023-02-13,-164.76,688.4
799,36197772,2023-02-14,-110.14,578.26
862,36258926,2023-01-31,0.0,549.71
7054,36258926,2023-02-06,-100.71,449.00000000000006
7153,36258926,2023-02-06,103.37,552.37
7055,36258926,2023-02-09,-133.16,419.21000000000004
7154,36258926,2023-02-10,120.39,539.6
863,36259936,2023-01-31,0.0,628.23
890,36259936,2023-02-01,18.77,647.0
891,36259936,2023-02-05,403.6,1050.6
892,36259936,2023-02-06,16.5,1067.1
7763,36259936,2023-02-08,-60.7,1006.4000000000001
7764,36259936,2023-02-11,-131.61,874.79
7765,36259936,2023-02-12,-113.45,761.34
864,36296704,2023-01-31,0.0,491.31
5775,36296704,2023-02-04,-191.64,299.67
5052,36296704,2023-02-04,167.73,467.4
5053,36296704,2023-02-05,16.24,483.64
5054,36296704,2023-02-08,116.58,600.22
865,36327122,2023-01-31,0.0,808.81
2779,36327122,2023-02-02,-127.6,681.2099999999999
7298,36327122,2023-02-07,104.16,785.3699999999999
2780,36327122,2023-02-08,-51.75,733.6199999999999
866,36389309,2023-01-31,0.0,469.45
7187,36389309,2023-02-06,-132.93,336.52
7188,36389309,2023-02-08,-36.71,299.80999999999995
8021,36389309,2023-02-09,83.47,383.28
7189,36389309,2023-02-11,-1271.5,-888.22
8022,36389309,2023-02-11,145.81,-742.4100000000001
867,36393557,2023-01-31,0.0,407.12
4573,36393557,2023-02-03,-99.07,308.05
4574,36393557,2023-02-05,-101.16,206.89000000000001
4575,36393557,2023-02-06,-142.55,64.34000000000003
8087,36393557,2023-02-09,5.59,69.93
8088,36393557,2023-02-13,161.44,231.37
868,36419197,2023-01-31,0.0,627.78
2527,36419197,2023-02-02,129.45,757.23
2528,36419197,2023-02-07,169.36,926.5899999999999
2529,36419197,2023-02-08,1693.2,2619.79
2530,36419197,2023-02-14,90.74,2710.5299999999997
869,36425954,2023-01-31,0.0,93.85
4470,36425954,2023-02-03,-146.59,-52.74000000000001
5351,36425954,2023-02-04,131.69,78.94999999999999
5352,36425954,2023-02-04,150.84,229.79
4471,36425954,2023-02-10,-141.46,88.32999999999998
4472,36425954,2023-02-11,-40.22,48.109999999999985
5353,36425954,2023-02-14,104.18,152.29
870,36519974,2023-01-31,0.0,922.41
6170,36519974,2023-02-05,-129.47,792.9399999999999
6171,36519974,2023-02-07,-38.88,754.06
6172,36519974,2023-02-09,-1522.7,-768.64
6173,36519974,2023-02-12,-138.36,-906.9999999999999
871,36549889,2023-01-31,0.0,760.2
8104,36549889,2023-02-09,-97.39,662.8100000000001
8105,36549889,2023-02-10,-131.62,531.19
8106,36549889,2023-02-10,-12.48,518.71
8687,36549889,2023-02-14,143.83,662.5400000000001
872,36551112,2023-01-31,0.0,976.02
1873,36551112,2023-02-01,-12.83,963.1899999999999
1874,36551112,2023-02-05,-40.03,923.16
6336,36551112,2023-02-05,183.91,1107.07
1875,36551112,2023-02-06,-32.34,1074.73
6337,36551112,2023-02-06,97.64,1172.37
1876,36551112,2023-02-14,-2197.2,-1024.83
1877,36551112,2023-02-14,-1514.1,-2538.93
873,36596942,2023-01-31,0.0,550.9
3852,36596942,2023-02-03,130.92,681.8199999999999
3853,36596942,2023-02-06,110.09,791.91
7672,36596942,2023-02-08,-190.88,601.03
7671,36596942,2023-02-08,-74.13,526.9
3854,36596942,2023-02-09,155.29,682.1899999999999
7673,36596942,2023-02-13,-18.85,663.3399999999999
3856,36596942,2023-02-13,48.38,711.72
3855,36596942,2023-02-13,50.68,762.4
874,36611100,2023-01-31,0.0,485.06
3592,36611100,2023-02-02,144.06,629.12
4956,36611100,2023-02-03,-565.2,63.91999999999996
4957,36611100,2023-02-05,-91.56,-27.640000000000043
3593,36611100,2023-02-08,71.61,43.96999999999997
4958,36611100,2023-02-10,-174.77,-130.80000000000013
875,36636385,2023-01-31,0.0,985.55
416,36636385,2023-02-01,-134.06,851.49
5387,36636385,2023-02-04,74.02,925.51
5388,36636385,2023-02-07,1392.7,2318.21
418,36636385,2023-02-10,-134.54,2183.67
417,36636385,2023-02-10,-76.06,2107.61
876,36668239,2023-01-31,0.0,566.32
2418,36668239,2023-02-02,1640.2,2206.52
4980,36668239,2023-02-03,-71.27,2135.25
4981,36668239,2023-02-11,-123.81,2011.44
4982,36668239,2023-02-13,-11.11,2000.33
877,36692647,2023-01-31,0.0,710.29
2711,36692647,2023-02-02,166.35,876.64
2712,36692647,2023-02-09,129.76,1006.4
878,36696277,2023-01-31,0.0,395.42
815,36696277,2023-02-01,153.43,548.85
7831,36696277,2023-02-08,-121.98,426.87
7832,36696277,2023-02-08,-108.96,317.91
816,36696277,2023-02-08,74.38,392.29
817,36696277,2023-02-09,50.78,443.07000000000005
818,36696277,2023-02-10,550.8,993.8699999999999
819,36696277,2023-02-11,38.74,1032.61
820,36696277,2023-02-12,1491.7,2524.31
879,36725272,2023-01-31,0.0,52.82
3468,36725272,2023-02-02,52.78,105.6
3469,36725272,2023-02-05,129.27,234.87
3470,36725272,2023-02-06,161.37,396.24
7493,36725272,2023-02-07,-109.2,287.04
7494,36725272,2023-02-14,-126.36,160.68
880,36837451,2023-01-31,0.0,429.52
1866,36837451,2023-02-01,146.02,575.54
1868,36837451,2023-02-02,31.96,607.5
1869,36837451,2023-02-02,96.32,703.8199999999999
1867,36837451,2023-02-02,212.6,916.42
7407,36837451,2023-02-07,-77.46,838.96
7408,36837451,2023-02-12,-119.09,719.87
1870,36837451,2023-02-12,77.33,797.2
881,36841261,2023-01-31,0.0,172.37
1405,36841261,2023-02-01,-127.65,44.72
5357,36841261,2023-02-04,110.3,155.01999999999998
1406,36841261,2023-02-06,-159.47,-4.449999999999989
5358,36841261,2023-02-10,139.99,135.54
5359,36841261,2023-02-12,128.62,264.15999999999997
1407,36841261,2023-02-14,-148.63,115.53
882,36849841,2023-01-31,0.0,593.56
3033,36849841,2023-02-02,-62.52,531.04
3034,36849841,2023-02-03,-174.62,356.41999999999996
3035,36849841,2023-02-04,-83.73,272.68999999999994
6229,36849841,2023-02-05,114.02,386.7099999999999
3036,36849841,2023-02-10,-99.46,287.24999999999994
883,36871984,2023-01-31,0.0,949.89
6447,36871984,2023-02-05,-103.29,846.6
7548,36871984,2023-02-07,56.49,903.09
6448,36871984,2023-02-08,-154.63,748.46
7549,36871984,2023-02-12,1663.0,2411.46
6449,36871984,2023-02-13,-58.3,2353.16
884,36949196,2023-01-31,0.0,614.22
3382,36949196,2023-02-02,118.32,732.54
3383,36949196,2023-02-03,124.88,857.4200000000001
5048,36949196,2023-02-04,-125.41,732.01
5049,36949196,2023-02-04,-86.74,645.27
5050,36949196,2023-02-07,-85.77,559.5
885,36982820,2023-01-31,0.0,833.46
2086,36982820,2023-02-01,599.8,1433.26
6315,36982820,2023-02-05,-74.55,1358.71
2087,36982820,2023-02-08,2.72,1361.4299999999998
6316,36982820,2023-02-12,-125.62,1235.81
2088,36982820,2023-02-12,117.45,1353.26
2089,36982820,2023-02-14,80.46,1433.72
886,37004975,2023-01-31,0.0,635.77
5477,37004975,2023-02-04,-55.54,580.23
6303,37004975,2023-02-05,122.25,702.48
6304,37004975,2023-02-06,59.58,762.06
6305,37004975,2023-02-06,91.58,853.64
5478,37004975,2023-02-07,-1679.8,-826.1599999999999
5479,37004975,2023-02-08,-1290.2,-2116.36
5480,37004975,2023-02-09,-112.31,-2228.67
6306,37004975,2023-02-09,37.65,-2191.02
6307,37004975,2023-02-13,110.17,-2080.85
887,37017424,2023-01-31,0.0,71.34
355,37017424,2023-02-01,-98.52,-27.179999999999993
356,37017424,2023-02-01,-85.83,-113.00999999999999
2359,37017424,2023-02-02,111.16,-1.8499999999999943
358,37017424,2023-02-10,-1531.0,-1532.8500000000001
357,37017424,2023-02-10,-11.07,-1543.92
2360,37017424,2023-02-12,71.74,-1472.18
2361,37017424,2023-02-13,71.51,-1400.67
888,37062632,2023-01-31,0.0,366.72
123,37062632,2023-02-01,119.45,486.17
124,37062632,2023-02-04,89.51,575.6800000000001
7102,37062632,2023-02-06,-171.3,404.38
125,37062632,2023-02-09,50.41,454.79
7103,37062632,2023-02-10,-72.61,382.18
126,37062632,2023-02-10,104.53,486.71000000000004
127,37062632,2023-02-13,87.03,573.74
889,37146521,2023-01-31,0.0,471.64
524,37146521,2023-02-01,-18.27,453.37
525,37146521,2023-02-04,-94.29,359.08
528,37146521,2023-02-08,-1565.7,-1206.62
527,37146521,2023-02-08,-195.35,-1401.9699999999998
526,37146521,2023-02-08,-93.73,-1495.6999999999998
529,37146521,2023-02-10,-46.07,-1541.77
8630,37146521,2023-02-13,37.47,-1504.3000000000002
890,37164421,2023-01-31,0.0,302.68
4047,37164421,2023-02-03,145.42,448.1
4048,37164421,2023-02-06,133.47,581.5699999999999
8343,37164421,2023-02-10,-197.72,383.85
4049,37164421,2023-02-11,182.11,565.96
891,37247834,2023-01-31,0.0,319.19
1154,37247834,2023-02-01,-937.1,-617.9100000000001
1155,37247834,2023-02-01,-148.96,-766.8699999999999
7404,37247834,2023-02-07,169.21,-597.6600000000001
1156,37247834,2023-02-08,-56.13,-653.79
7405,37247834,2023-02-08,163.97,-489.82
1157,37247834,2023-02-09,-138.48,-628.3
1158,37247834,2023-02-09,-80.13,-708.4299999999998
1159,37247834,2023-02-11,-117.67,-826.0999999999999
1160,37247834,2023-02-12,-185.51,-1011.6099999999999
7406,37247834,2023-02-14,42.13,-969.48
892,37256412,2023-01-31,0.0,24.43
4352,37256412,2023-02-03,-1529.4,-1504.97
6048,37256412,2023-02-05,135.39,-1369.5800000000002
6049,37256412,2023-02-08,80.13,-1289.45
6050,37256412,2023-02-11,123.24,-1166.21
893,37267391,2023-01-31,0.0,819.11
1683,37267391,2023-02-01,-105.76,713.35
1684,37267391,2023-02-02,-666.0,47.35000000000002
5328,37267391,2023-02-04,102.71,150.06000000000006
1685,37267391,2023-02-06,-100.8,49.25999999999999
5329,37267391,2023-02-06,629.3,678.56
5330,37267391,2023-02-09,134.87,813.43
1686,37267391,2023-02-10,-62.82,750.6099999999999
5331,37267391,2023-02-11,47.38,797.99
894,37273974,2023-01-31,0.0,533.14
2280,37273974,2023-02-02,80.13,613.27
2281,37273974,2023-02-02,699.9,1313.17
2282,37273974,2023-02-03,180.87,1494.04
2283,37273974,2023-02-05,62.54,1556.58
8639,37273974,2023-02-13,-125.25,1431.33
895,37274865,2023-01-31,0.0,95.23
896,37297429,2023-01-31,0.0,693.82
519,37297429,2023-02-01,-79.4,614.4200000000001
2299,37297429,2023-02-02,108.09,722.51
2300,37297429,2023-02-02,983.3,1705.81
520,37297429,2023-02-03,-128.25,1577.56
2301,37297429,2023-02-05,45.9,1623.46
2302,37297429,2023-02-06,72.88,1696.3400000000001
521,37297429,2023-02-08,-193.89,1502.45
522,37297429,2023-02-14,-153.15,1349.3000000000002
523,37297429,2023-02-14,-25.45,1323.85
897,37319261,2023-01-31,0.0,574.42
5711,37319261,2023-02-04,-99.39,475.03
5712,37319261,2023-02-06,-1409.6,-934.57
5713,37319261,2023-02-09,-89.75,-1024.3200000000002
8267,37319261,2023-02-10,55.29,-969.0300000000001
898,37369245,2023-01-31,0.0,446.65
1539,37369245,2023-02-01,-74.4,372.25
1540,37369245,2023-02-03,-43.72,328.53
1541,37369245,2023-02-04,-118.19,210.33999999999997
5688,37369245,2023-02-04,82.56,292.9
1542,37369245,2023-02-05,-40.41,252.48999999999998
1543,37369245,2023-02-10,-1324.9,-1072.4100000000003
1544,37369245,2023-02-14,-124.26,-1196.67
899,37407392,2023-01-31,0.0,822.17
5114,37407392,2023-02-04,79.47,901.64
6226,37407392,2023-02-05,-6.87,894.77
6227,37407392,2023-02-10,-110.62,784.15
6228,37407392,2023-02-13,-87.2,696.9499999999999
5115,37407392,2023-02-14,49.4,746.3499999999999
900,37443706,2023-01-31,0.0,621.08
4162,37443706,2023-02-03,88.33,709.4100000000001
7470,37443706,2023-02-07,-89.31,620.1
4164,37443706,2023-02-08,48.19,668.2900000000001
4163,37443706,2023-02-08,158.67,826.96
4165,37443706,2023-02-12,95.8,922.76
7471,37443706,2023-02-13,-97.05,825.71
4166,37443706,2023-02-13,1088.0,1913.71
4167,37443706,2023-02-14,47.25,1960.96
901,37503622,2023-01-31,0.0,630.18
3859,37503622,2023-02-03,-121.3,508.87999999999994
4529,37503622,2023-02-03,146.88,655.76
3861,37503622,2023-02-04,-1395.3,-739.5400000000001
3860,37503622,2023-02-04,-1246.9,-1986.44
3862,37503622,2023-02-09,-102.69,-2089.13
4530,37503622,2023-02-09,103.16,-1985.9700000000003
4531,37503622,2023-02-09,1300.7,-685.2700000000001
902,37510139,2023-01-31,0.0,546.33
4283,37510139,2023-02-03,-825.8,-279.4699999999999
6466,37510139,2023-02-05,116.94,-162.52999999999986
6467,37510139,2023-02-11,42.19,-120.33999999999992
6468,37510139,2023-02-14,163.39,43.05000000000007
903,37528735,2023-01-31,0.0,368.39
2444,37528735,2023-02-02,-92.47,275.91999999999996
7368,37528735,2023-02-07,153.3,429.22
2445,37528735,2023-02-08,-42.59,386.63
7369,37528735,2023-02-11,11.3,397.93
7370,37528735,2023-02-14,89.42,487.35
904,37561049,2023-01-31,0.0,903.95
897,37561049,2023-02-01,-80.58,823.37
898,37561049,2023-02-02,-140.34,683.03
899,37561049,2023-02-03,-78.66,604.3700000000001
5219,37561049,2023-02-04,2.86,607.23
5220,37561049,2023-02-04,96.78,704.01
5221,37561049,2023-02-05,1922.5,2626.51
900,37561049,2023-02-13,-156.37,2470.1400000000003
5222,37561049,2023-02-13,163.33,2633.4700000000003
5223,37561049,2023-02-14,113.07,2746.54
905,37599317,2023-01-31,0.0,177.32
2107,37599317,2023-02-02,116.43,293.75
4463,37599317,2023-02-03,-167.61,126.13999999999999
2108,37599317,2023-02-09,56.53,182.67
4464,37599317,2023-02-11,-103.41,79.25999999999999
2109,37599317,2023-02-11,73.62,152.88
4465,37599317,2023-02-12,-132.48,20.400000000000006
906,37642787,2023-01-31,0.0,396.03
4834,37642787,2023-02-03,-187.7,208.32999999999998
4718,37642787,2023-02-03,1.03,209.35999999999999
4719,37642787,2023-02-03,78.28,287.64
4835,37642787,2023-02-04,-127.76,159.88
4836,37642787,2023-02-06,-48.31,111.57
4720,37642787,2023-02-10,25.31,136.88
4721,37642787,2023-02-10,1289.6,1426.4799999999998
4722,37642787,2023-02-14,159.09,1585.5699999999997
907,37658218,2023-01-31,0.0,561.27
746,37658218,2023-02-01,570.3,1131.57
2465,37658218,2023-02-02,-39.87,1091.6999999999998
747,37658218,2023-02-07,43.63,1135.33
2466,37658218,2023-02-09,-83.42,1051.9099999999999
2467,37658218,2023-02-14,-101.53,950.3799999999999
2468,37658218,2023-02-14,-85.5,864.8799999999999
908,37678813,2023-01-31,0.0,767.56
4004,37678813,2023-02-03,-67.35,700.2099999999999
4005,37678813,2023-02-08,-105.41,594.8
8611,37678813,2023-02-13,66.23,661.03
8612,37678813,2023-02-13,78.14,739.17
909,37767441,2023-01-31,0.0,726.46
1633,37767441,2023-02-01,-88.19,638.27
1634,37767441,2023-02-02,-15.8,622.47
4863,37767441,2023-02-03,94.83,717.3000000000001
4864,37767441,2023-02-08,87.01,804.3100000000001
4865,37767441,2023-02-09,64.96,869.27
4866,37767441,2023-02-12,169.44,1038.71
910,37789180,2023-01-31,0.0,854.05
3623,37789180,2023-02-02,-75.99,778.06
3964,37789180,2023-02-03,19.89,797.9499999999999
3965,37789180,2023-02-07,84.83,882.78
3966,37789180,2023-02-08,1621.0,2503.7799999999997
3624,37789180,2023-02-09,-1726.4,777.3799999999999
3969,37789180,2023-02-11,26.87,804.2499999999999
3968,37789180,2023-02-11,64.84,869.0899999999999
3967,37789180,2023-02-11,1037.0,1906.09
3625,37789180,2023-02-12,-66.32,1839.77
3626,37789180,2023-02-13,-147.5,1692.27
911,37796234,2023-01-31,0.0,992.46
3221,37796234,2023-02-02,54.93,1047.39
3222,37796234,2023-02-02,1698.0,2745.3900000000003
5534,37796234,2023-02-04,-84.91,2660.48
5533,37796234,2023-02-04,-84.12,2576.36
3223,37796234,2023-02-04,189.38,2765.74
3224,37796234,2023-02-06,63.36,2829.1000000000004
3225,37796234,2023-02-08,1096.2,3925.3
5535,37796234,2023-02-09,-173.2,3752.1000000000004
3226,37796234,2023-02-09,38.71,3790.8100000000004
912,37830423,2023-01-31,0.0,285.5
2225,37830423,2023-02-02,-84.91,200.59
5606,37830423,2023-02-04,120.69,321.28
5607,37830423,2023-02-05,55.38,376.65999999999997
2226,37830423,2023-02-07,-69.94,306.72
5608,37830423,2023-02-08,17.63,324.35
5609,37830423,2023-02-08,19.11,343.46
2227,37830423,2023-02-13,-63.17,280.28999999999996
913,37878074,2023-01-31,0.0,647.56
1451,37878074,2023-02-01,-124.69,522.8699999999999
1452,37878074,2023-02-03,-1218.0,-695.1300000000001
1453,37878074,2023-02-04,-36.24,-731.3700000000001
1455,37878074,2023-02-11,-720.7,-1452.0700000000002
1454,37878074,2023-02-11,-117.62,-1569.69
1456,37878074,2023-02-11,-102.13,-1671.8200000000002
914,37905098,2023-01-31,0.0,389.98
5550,37905098,2023-02-04,112.65,502.63
7294,37905098,2023-02-07,-197.62,305.01
7296,37905098,2023-02-07,-92.13,212.88000000000002
7295,37905098,2023-02-07,-37.9,174.98000000000002
5551,37905098,2023-02-08,105.41,280.39
5552,37905098,2023-02-09,109.67,390.06
5553,37905098,2023-02-11,80.85,470.91
7298,37905098,2023-02-12,-170.43,300.48
7297,37905098,2023-02-12,-125.27,175.21
915,37936898,2023-01-31,0.0,745.79
925,37936898,2023-02-01,-104.85,640.9399999999999
926,37936898,2023-02-03,-98.53,542.41
927,37936898,2023-02-06,-999.1,-456.69000000000005
6913,37936898,2023-02-06,159.49,-297.20000000000005
6915,37936898,2023-02-10,62.15,-235.05000000000007
6914,37936898,2023-02-10,163.93,-71.12
928,37936898,2023-02-11,-86.98,-158.10000000000002
6916,37936898,2023-02-13,73.86,-84.24000000000001
916,37945317,2023-01-31,0.0,8.24
3097,37945317,2023-02-02,122.81,131.05
3098,37945317,2023-02-03,529.6,660.6500000000001
6786,37945317,2023-02-06,-120.15,540.5
3099,37945317,2023-02-07,1689.7,2230.2
6787,37945317,2023-02-09,-217.27,2012.93
6788,37945317,2023-02-09,-108.53,1904.4
3100,37945317,2023-02-10,1524.4,3428.8
3101,37945317,2023-02-12,89.44,3518.24
6789,37945317,2023-02-14,-100.7,3417.54
917,37953007,2023-01-31,0.0,440.78
2978,37953007,2023-02-02,-68.21,372.57
2979,37953007,2023-02-04,-786.1,-413.5300000000001
5610,37953007,2023-02-04,130.12,-283.4100000000001
918,38032055,2023-01-31,0.0,416.47
5970,38032055,2023-02-04,-32.51,383.96000000000004
5971,38032055,2023-02-07,-155.12,228.84000000000003
7508,38032055,2023-02-07,12.66,241.50000000000003
5973,38032055,2023-02-10,-386.8,-145.29999999999995
5972,38032055,2023-02-10,-121.29,-266.59000000000003
7509,38032055,2023-02-12,147.01,-119.58000000000004
7510,38032055,2023-02-14,88.36,-31.220000000000027
919,38038623,2023-01-31,0.0,526.98
6561,38038623,2023-02-05,1345.1,1872.08
6834,38038623,2023-02-06,-55.26,1816.82
6835,38038623,2023-02-10,-124.93,1691.8899999999999
6836,38038623,2023-02-13,-148.57,1543.32
6837,38038623,2023-02-14,-195.92,1347.4
920,38124225,2023-01-31,0.0,943.59
6461,38124225,2023-02-05,107.79,1051.38
7715,38124225,2023-02-08,-114.16,937.22
6462,38124225,2023-02-08,91.24,1028.46
7717,38124225,2023-02-09,-145.58,882.88
7716,38124225,2023-02-09,-101.24,781.6400000000001
6463,38124225,2023-02-10,63.35,844.99
6464,38124225,2023-02-10,114.32,959.3100000000001
6465,38124225,2023-02-13,65.9,1025.21
921,38157078,2023-01-31,0.0,756.55
5096,38157078,2023-02-04,664.6,1421.15
7457,38157078,2023-02-07,-86.52,1334.63
7458,38157078,2023-02-13,-169.97,1164.6599999999999
922,38224160,2023-01-31,0.0,701.82
3357,38224160,2023-02-02,-92.9,608.9200000000001
3358,38224160,2023-02-03,-119.1,489.82000000000005
3359,38224160,2023-02-07,-75.95,413.87000000000006
3360,38224160,2023-02-13,-76.04,337.83000000000004
923,38291062,2023-01-31,0.0,486.68
1338,38291062,2023-02-01,-82.42,404.26
1339,38291062,2023-02-05,-78.67,325.59000000000003
6853,38291062,2023-02-06,246.82,572.41
6854,38291062,2023-02-11,1.71,574.12
1340,38291062,2023-02-12,-119.93,454.19
1341,38291062,2023-02-14,-105.25,348.94
6855,38291062,2023-02-14,77.33,426.27
924,38316158,2023-01-31,0.0,138.4
2889,38316158,2023-02-02,74.49,212.89
2891,38316158,2023-02-05,92.28,305.16999999999996
2890,38316158,2023-02-05,227.66,532.83
2892,38316158,2023-02-07,35.98,568.8100000000001
2893,38316158,2023-02-08,24.76,593.57
8664,38316158,2023-02-14,-53.27,540.3
925,38346624,2023-01-31,0.0,740.09
8219,38346624,2023-02-10,185.21,925.3000000000001
8220,38346624,2023-02-10,737.2,1662.5
926,38395807,2023-01-31,0.0,463.52
7522,38395807,2023-02-07,144.93,608.45
7523,38395807,2023-02-08,44.05,652.5
8131,38395807,2023-02-09,-40.77,611.73
7524,38395807,2023-02-12,91.23,702.96
927,38428295,2023-01-31,0.0,690.12
7904,38428295,2023-02-08,-199.46,490.65999999999997
7905,38428295,2023-02-11,-167.56,323.1
7906,38428295,2023-02-13,-128.11,194.99
7907,38428295,2023-02-14,-170.29,24.699999999999932
928,38429514,2023-01-31,0.0,627.62
377,38429514,2023-02-01,-72.18,555.44
378,38429514,2023-02-04,-119.83,435.61
379,38429514,2023-02-08,-108.02,327.59000000000003
380,38429514,2023-02-10,-139.76,187.83000000000004
8482,38429514,2023-02-11,47.32,235.15000000000003
8483,38429514,2023-02-12,102.95,338.1
8484,38429514,2023-02-14,53.96,392.06000000000006
929,38442044,2023-01-31,0.0,106.95
3293,38442044,2023-02-02,64.9,171.85000000000002
4339,38442044,2023-02-03,-23.84,148.01
3294,38442044,2023-02-06,50.95,198.96
4341,38442044,2023-02-07,-152.25,46.71000000000001
4340,38442044,2023-02-07,-144.16,-97.44999999999997
3295,38442044,2023-02-07,113.13,15.679999999999993
3296,38442044,2023-02-08,34.12,49.79999999999999
3297,38442044,2023-02-08,57.77,107.57
3298,38442044,2023-02-12,98.65,206.22
3299,38442044,2023-02-14,860.1,1066.32
930,38487215,2023-01-31,0.0,780.01
1743,38487215,2023-02-01,808.4,1588.4099999999999
4358,38487215,2023-02-03,-128.1,1460.31
1744,38487215,2023-02-03,118.95,1579.26
4359,38487215,2023-02-06,-1543.0,36.25999999999999
931,38495059,2023-01-31,0.0,14.18
2372,38495059,2023-02-02,-36.6,-22.42
2373,38495059,2023-02-06,-42.54,-64.96000000000001
2374,38495059,2023-02-11,-136.0,-200.95999999999998
932,38502892,2023-01-31,0.0,600.32
7162,38502892,2023-02-06,-62.08,538.24
7433,38502892,2023-02-07,71.61,609.85
7163,38502892,2023-02-08,-47.37,562.48
933,38528119,2023-01-31,0.0,165.9
7035,38528119,2023-02-06,-191.25,-25.349999999999994
6768,38528119,2023-02-06,78.29,52.94000000000001
7036,38528119,2023-02-08,-167.66,-114.72
6769,38528119,2023-02-13,168.95,54.23000000000002
6770,38528119,2023-02-14,116.52,170.75
934,38558525,2023-01-31,0.0,833.07
5571,38558525,2023-02-04,62.25,895.32
5572,38558525,2023-02-07,1819.0,2714.32
5573,38558525,2023-02-08,194.3,2908.6200000000003
935,38564653,2023-01-31,0.0,647.95
3765,38564653,2023-02-03,3.5,651.45
3766,38564653,2023-02-05,104.58,756.0300000000001
3767,38564653,2023-02-12,133.45,889.48
3768,38564653,2023-02-13,93.97,983.45
936,38587383,2023-01-31,0.0,579.12
1320,38587383,2023-02-01,-146.1,433.02
1069,38587383,2023-02-01,81.07,514.09
1321,38587383,2023-02-03,-39.37,474.72
1070,38587383,2023-02-03,110.66,585.38
1322,38587383,2023-02-04,-162.1,423.28
1323,38587383,2023-02-07,-166.27,257.01
1071,38587383,2023-02-07,124.31,381.32
1324,38587383,2023-02-09,-118.41,262.90999999999997
1325,38587383,2023-02-12,-82.59,180.32
1326,38587383,2023-02-12,-37.14,143.18
937,38606148,2023-01-31,0.0,956.59
2398,38606148,2023-02-02,-111.16,845.4300000000001
2399,38606148,2023-02-04,-72.53,772.9000000000001
5424,38606148,2023-02-04,67.91,840.8100000000001
2400,38606148,2023-02-06,-26.04,814.77
2401,38606148,2023-02-11,-132.56,682.21
2402,38606148,2023-02-12,-1323.4,-641.1900000000002
5425,38606148,2023-02-12,131.58,-509.61000000000024
938,38627867,2023-01-31,0.0,132.74
6229,38627867,2023-02-05,-99.91,32.83000000000001
6799,38627867,2023-02-06,70.94,103.77000000000001
6230,38627867,2023-02-14,-102.09,1.6800000000000068
939,38690875,2023-01-31,0.0,320.39
4689,38690875,2023-02-03,-126.21,194.18
4690,38690875,2023-02-06,-198.2,-4.019999999999982
4691,38690875,2023-02-11,-147.09,-151.11
4692,38690875,2023-02-13,-104.24,-255.35000000000002
4693,38690875,2023-02-13,-76.09,-331.43999999999994
4694,38690875,2023-02-14,-122.9,-454.34000000000003
940,38740782,2023-01-31,0.0,702.64
5045,38740782,2023-02-04,-133.55,569.0899999999999
5046,38740782,2023-02-05,-61.09,508.0
5047,38740782,2023-02-12,-84.07,423.92999999999995
8602,38740782,2023-02-12,76.1,500.03
941,38749064,2023-01-31,0.0,569.98
133,38749064,2023-02-01,143.97,713.95
2450,38749064,2023-02-02,-1436.3,-722.3499999999999
134,38749064,2023-02-03,89.06,-633.29
135,38749064,2023-02-14,138.71,-494.5799999999999
942,38764064,2023-01-31,0.0,648.12
2018,38764064,2023-02-01,52.17,700.29
2019,38764064,2023-02-02,15.8,716.09
2020,38764064,2023-02-07,106.64,822.73
2021,38764064,2023-02-09,32.87,855.6
2022,38764064,2023-02-11,9.25,864.85
2023,38764064,2023-02-13,96.51,961.36
2024,38764064,2023-02-14,58.88,1020.24
943,38780970,2023-01-31,0.0,846.59
812,38780970,2023-02-01,-118.27,728.32
5731,38780970,2023-02-04,117.26,845.58
5732,38780970,2023-02-07,54.28,899.86
5733,38780970,2023-02-10,47.87,947.73
813,38780970,2023-02-13,-838.9,108.83000000000004
944,38839019,2023-01-31,0.0,187.15
219,38839019,2023-02-01,-52.99,134.16
1177,38839019,2023-02-01,937.1,1071.26
220,38839019,2023-02-02,-156.04,915.22
1178,38839019,2023-02-08,113.98,1029.2
221,38839019,2023-02-11,-164.37,864.83
1179,38839019,2023-02-11,106.4,971.23
1180,38839019,2023-02-14,170.57,1141.8
945,38903150,2023-01-31,0.0,263.28
4649,38903150,2023-02-03,-96.77,166.51
4650,38903150,2023-02-04,-128.19,38.31999999999999
4651,38903150,2023-02-07,-188.36,-150.04000000000002
8242,38903150,2023-02-10,84.17,-65.87
8241,38903150,2023-02-10,153.84,87.96999999999997
4652,38903150,2023-02-11,-133.59,-45.620000000000005
4653,38903150,2023-02-14,-1157.1,-1202.72
946,38921478,2023-01-31,0.0,641.48
3526,38921478,2023-02-02,112.16,753.64
4233,38921478,2023-02-03,-7.7,745.94
4234,38921478,2023-02-04,-90.13,655.8100000000001
4235,38921478,2023-02-05,-1292.8,-636.99
3527,38921478,2023-02-05,69.58,-567.4100000000001
3528,38921478,2023-02-07,46.92,-520.49
4236,38921478,2023-02-10,-114.74,-635.23
3529,38921478,2023-02-12,105.2,-530.03
4237,38921478,2023-02-13,-43.56,-573.5899999999999
4238,38921478,2023-02-14,-130.84,-704.4300000000001
947,38957380,2023-01-31,0.0,37.95
2619,38957380,2023-02-02,-117.9,-79.95
4386,38957380,2023-02-03,75.66,-4.290000000000006
4387,38957380,2023-02-04,88.83,84.53999999999999
2622,38957380,2023-02-07,-133.96,-49.420000000000016
2620,38957380,2023-02-07,-123.7,-173.12
2621,38957380,2023-02-07,-112.51,-285.63000000000005
4388,38957380,2023-02-10,121.27,-164.36
4389,38957380,2023-02-10,167.95,3.589999999999961
2623,38957380,2023-02-13,-128.09,-124.50000000000004
948,38969279,2023-01-31,0.0,195.74
2914,38969279,2023-02-02,148.09,343.83000000000004
5057,38969279,2023-02-04,-5.54,338.29
2915,38969279,2023-02-04,1579.8,1918.09
5058,38969279,2023-02-05,-2160.7,-242.6099999999999
2916,38969279,2023-02-05,177.45,-65.15999999999991
2917,38969279,2023-02-06,1037.3,972.1400000000001
2918,38969279,2023-02-10,1499.1,2471.24
2919,38969279,2023-02-12,103.8,2575.04
949,38990596,2023-01-31,0.0,108.78
4258,38990596,2023-02-03,1462.8,1571.58
7592,38990596,2023-02-07,-24.33,1547.25
4259,38990596,2023-02-07,1348.3,2895.55
4260,38990596,2023-02-10,125.04,3020.59
7593,38990596,2023-02-12,-93.42,2927.17
7594,38990596,2023-02-13,-122.16,2805.01
950,38991889,2023-01-31,0.0,292.35
6431,38991889,2023-02-05,-104.95,187.40000000000003
6432,38991889,2023-02-08,-162.63,24.77000000000004
6433,38991889,2023-02-10,-75.71,-50.93999999999994
8206,38991889,2023-02-10,23.96,-26.97999999999996
8207,38991889,2023-02-12,129.0,102.02000000000004
6434,38991889,2023-02-14,-38.92,63.10000000000002
951,39001531,2023-01-31,0.0,882.34
4586,39001531,2023-02-03,-68.13,814.21
4587,39001531,2023-02-06,-48.43,765.78
4588,39001531,2023-02-10,-167.95,597.83
4589,39001531,2023-02-13,-110.74,487.09000000000003
952,39013360,2023-01-31,0.0,987.76
3502,39013360,2023-02-02,111.21,1098.97
3503,39013360,2023-02-03,183.87,1282.84
7212,39013360,2023-02-07,-80.19,1202.65
7213,39013360,2023-02-12,-1663.0,-460.35000000000014
3506,39013360,2023-02-12,93.42,-366.93000000000006
3505,39013360,2023-02-12,108.16,-258.7700000000002
3507,39013360,2023-02-12,114.77,-144.00000000000023
3504,39013360,2023-02-12,160.33,16.329999999999927
953,39061853,2023-01-31,0.0,353.93
1954,39061853,2023-02-01,98.05,451.98
1955,39061853,2023-02-03,106.6,558.5799999999999
1956,39061853,2023-02-03,118.33,676.9100000000001
5227,39061853,2023-02-04,-58.86,618.05
1958,39061853,2023-02-04,0.23,618.28
1957,39061853,2023-02-04,74.21,692.49
5228,39061853,2023-02-05,-117.54,574.95
5229,39061853,2023-02-07,-100.32,474.63
5230,39061853,2023-02-09,-185.1,289.53
5231,39061853,2023-02-12,-86.65,202.88
5232,39061853,2023-02-14,-82.4,120.47999999999999
954,39093565,2023-01-31,0.0,107.2
5317,39093565,2023-02-04,-178.94,-71.74
5318,39093565,2023-02-08,-1872.8,-1944.5399999999997
8389,39093565,2023-02-10,92.49,-1852.05
955,39097663,2023-01-31,0.0,326.42
2672,39097663,2023-02-02,124.78,451.20000000000005
2673,39097663,2023-02-08,67.17,518.37
8583,39097663,2023-02-12,-40.07,478.3
2674,39097663,2023-02-12,125.48,603.78
956,39122920,2023-01-31,0.0,445.68
7821,39122920,2023-02-08,66.97,512.65
7822,39122920,2023-02-08,124.8,637.45
7823,39122920,2023-02-09,134.75,772.2
7824,39122920,2023-02-10,124.93,897.13
8578,39122920,2023-02-12,-111.7,785.4300000000001
7825,39122920,2023-02-12,56.08,841.51
7827,39122920,2023-02-13,22.49,864.0
7826,39122920,2023-02-13,96.04,960.04
8579,39122920,2023-02-14,-142.18,817.8599999999999
8580,39122920,2023-02-14,-75.01,742.8499999999999
957,39123048,2023-01-31,0.0,687.59
1882,39123048,2023-02-01,-92.64,594.95
931,39123048,2023-02-01,83.41,678.36
1883,39123048,2023-02-03,-513.3,165.06000000000006
1884,39123048,2023-02-03,-87.46,77.60000000000002
1885,39123048,2023-02-08,-135.88,-58.27999999999986
1887,39123048,2023-02-09,-157.79,-216.06999999999994
1886,39123048,2023-02-09,-140.35,-356.41999999999996
1888,39123048,2023-02-10,-13.9,-370.3199999999998
1889,39123048,2023-02-12,-122.43,-492.7499999999999
932,39123048,2023-02-14,140.0,-352.7499999999999
958,39160879,2023-01-31,0.0,444.15
1222,39160879,2023-02-01,-186.89,257.26
5830,39160879,2023-02-04,133.05,390.31
5831,39160879,2023-02-13,838.9,1229.21
5832,39160879,2023-02-14,302.7,1531.9099999999999
959,39161053,2023-01-31,0.0,375.28
1860,39161053,2023-02-01,-156.89,218.39
2040,39161053,2023-02-01,142.14,360.53
2041,39161053,2023-02-02,93.84,454.37
2042,39161053,2023-02-03,103.43,557.8
1861,39161053,2023-02-05,-137.15,420.65
2043,39161053,2023-02-05,480.6,901.25
2044,39161053,2023-02-07,53.14,954.39
1862,39161053,2023-02-14,-114.68,839.71
960,39267013,2023-01-31,0.0,516.74
3707,39267013,2023-02-02,-1495.8,-979.06
3708,39267013,2023-02-03,-67.76,-1046.82
3709,39267013,2023-02-04,-68.14,-1114.96
3710,39267013,2023-02-12,-89.62,-1204.58
3711,39267013,2023-02-14,-143.79,-1348.37
961,39298122,2023-01-31,0.0,607.25
2001,39298122,2023-02-01,135.0,742.25
2002,39298122,2023-02-02,122.54,864.79
2003,39298122,2023-02-03,193.29,1058.08
7193,39298122,2023-02-06,-885.9,172.18
7194,39298122,2023-02-08,-154.47,17.710000000000036
7195,39298122,2023-02-12,-53.57,-35.860000000000014
7196,39298122,2023-02-13,-32.94,-68.79999999999995
962,39360799,2023-01-31,0.0,379.72
143,39360799,2023-02-01,-1634.7,-1254.98
142,39360799,2023-02-01,-137.25,-1392.23
141,39360799,2023-02-01,-98.45,-1490.68
7385,39360799,2023-02-07,43.24,-1447.44
7386,39360799,2023-02-13,117.96,-1329.48
963,39386771,2023-01-31,0.0,171.52
2528,39386771,2023-02-02,-87.3,84.22000000000001
2638,39386771,2023-02-02,99.44,183.66000000000003
2529,39386771,2023-02-04,-162.76,20.900000000000006
2530,39386771,2023-02-04,-94.61,-73.71000000000001
2531,39386771,2023-02-10,-57.19,-130.9
2639,39386771,2023-02-10,85.88,-45.02000000000001
2640,39386771,2023-02-10,107.08,62.06
964,39398476,2023-01-31,0.0,541.52
2795,39398476,2023-02-02,106.61,648.13
2796,39398476,2023-02-07,116.86,764.99
2797,39398476,2023-02-10,100.16,865.15
965,39400991,2023-01-31,0.0,896.44
6543,39400991,2023-02-05,10.32,906.7600000000001
6544,39400991,2023-02-11,38.45,945.21
6545,39400991,2023-02-13,93.58,1038.79
966,39402264,2023-01-31,0.0,993.04
187,39402264,2023-02-01,1255.3,2248.34
188,39402264,2023-02-05,126.99,2375.33
7368,39402264,2023-02-07,-98.93,2276.3999999999996
189,39402264,2023-02-07,99.51,2375.91
7369,39402264,2023-02-11,-1949.6,426.30999999999995
7370,39402264,2023-02-14,-241.71,184.5999999999999
7371,39402264,2023-02-14,-117.68,66.91999999999996
967,39427922,2023-01-31,0.0,794.1
751,39427922,2023-02-01,-131.53,662.57
3475,39427922,2023-02-02,145.85,808.4200000000001
3476,39427922,2023-02-03,140.5,948.9200000000001
752,39427922,2023-02-04,-163.28,785.64
753,39427922,2023-02-07,-146.82,638.82
754,39427922,2023-02-08,-117.07,521.75
3477,39427922,2023-02-13,30.41,552.1600000000001
755,39427922,2023-02-14,-163.28,388.88
968,39491241,2023-01-31,0.0,564.0
2957,39491241,2023-02-02,100.0,664.0
2958,39491241,2023-02-05,122.18,786.1800000000001
2959,39491241,2023-02-06,79.45,865.63
2960,39491241,2023-02-08,115.63,981.26
8532,39491241,2023-02-12,-120.9,860.36
2961,39491241,2023-02-12,80.63,940.99
969,39502821,2023-01-31,0.0,924.88
4227,39502821,2023-02-03,-28.45,896.43
4972,39502821,2023-02-03,321.6,1218.03
4973,39502821,2023-02-05,26.93,1244.96
4229,39502821,2023-02-09,-136.48,1108.48
4228,39502821,2023-02-09,-59.28,1049.2
4230,39502821,2023-02-12,-206.28,842.9200000000001
970,39504855,2023-01-31,0.0,890.63
2433,39504855,2023-02-02,118.6,1009.23
6092,39504855,2023-02-05,-124.37,884.86
2434,39504855,2023-02-06,55.26,940.12
6093,39504855,2023-02-11,-93.32,846.8
2435,39504855,2023-02-11,1000.2,1847.0
2436,39504855,2023-02-12,3.07,1850.0700000000002
6094,39504855,2023-02-14,-72.35,1777.72
971,39516154,2023-01-31,0.0,620.87
2786,39516154,2023-02-02,-1273.1,-652.2299999999999
7148,39516154,2023-02-06,22.66,-629.5699999999998
2787,39516154,2023-02-11,-1094.0,-1723.5699999999997
2788,39516154,2023-02-12,-106.02,-1829.5900000000001
2789,39516154,2023-02-13,-62.08,-1891.67
7149,39516154,2023-02-13,157.09,-1734.58
972,39516203,2023-01-31,0.0,689.19
4006,39516203,2023-02-03,129.19,818.3800000000001
7363,39516203,2023-02-07,-186.08,632.3000000000001
4007,39516203,2023-02-10,93.02,725.32
4008,39516203,2023-02-11,23.0,748.32
4009,39516203,2023-02-11,30.47,778.7900000000001
7364,39516203,2023-02-13,-112.31,666.48
4010,39516203,2023-02-14,172.96,839.44
973,39529729,2023-01-31,0.0,425.66
1739,39529729,2023-02-01,86.44,512.1
1740,39529729,2023-02-02,38.74,550.84
1741,39529729,2023-02-06,35.38,586.22
7617,39529729,2023-02-07,-78.85,507.37
7618,39529729,2023-02-11,-226.92,280.45000000000005
1742,39529729,2023-02-12,100.01,380.46000000000004
7619,39529729,2023-02-13,-63.85,316.61
974,39542358,2023-01-31,0.0,671.28
6954,39542358,2023-02-06,-48.45,622.8299999999999
7570,39542358,2023-02-07,107.26,730.0899999999999
6955,39542358,2023-02-08,-71.61,658.48
7572,39542358,2023-02-08,257.4,915.8799999999999
7571,39542358,2023-02-08,522.3,1438.1799999999998
6956,39542358,2023-02-10,-125.04,1313.1399999999999
6957,39542358,2023-02-11,-62.18,1250.9599999999998
7574,39542358,2023-02-11,1168.2,2419.16
7573,39542358,2023-02-11,2361.6,4780.759999999999
975,39590347,2023-01-31,0.0,180.22
5600,39590347,2023-02-04,-35.8,144.42000000000002
5601,39590347,2023-02-05,-101.45,42.97
5602,39590347,2023-02-09,-165.46,-122.49000000000004
5603,39590347,2023-02-12,-133.67,-256.15999999999997
5604,39590347,2023-02-12,-57.89,-314.04999999999995
976,39602737,2023-01-31,0.0,881.44
6876,39602737,2023-02-06,83.89,965.33
8610,39602737,2023-02-13,-95.71,869.6200000000001
977,39620163,2023-01-31,0.0,126.08
4568,39620163,2023-02-03,-126.76,-0.6800000000000068
4569,39620163,2023-02-05,-193.2,-193.88
4570,39620163,2023-02-09,-59.74,-253.62
8385,39620163,2023-02-10,27.61,-226.01
4571,39620163,2023-02-12,-105.79,-331.8
8386,39620163,2023-02-12,122.43,-209.37
4572,39620163,2023-02-14,-99.23,-308.6
978,39623640,2023-01-31,0.0,617.74
4419,39623640,2023-02-03,-163.12,454.62
3779,39623640,2023-02-03,62.98,517.6
3778,39623640,2023-02-03,141.26,658.86
4420,39623640,2023-02-09,-176.29,482.57
4421,39623640,2023-02-09,-136.79,345.78
4422,39623640,2023-02-10,-186.7,159.08000000000004
3780,39623640,2023-02-11,94.12,253.20000000000005
979,39662559,2023-01-31,0.0,536.88
6988,39662559,2023-02-06,106.77,643.65
7866,39662559,2023-02-08,-45.23,598.42
6990,39662559,2023-02-09,78.03,676.45
6989,39662559,2023-02-09,140.11,816.56
6991,39662559,2023-02-13,45.1,861.6600000000001
980,39684993,2023-01-31,0.0,168.99
4016,39684993,2023-02-03,612.6,781.59
4017,39684993,2023-02-04,102.22,883.8100000000001
4018,39684993,2023-02-05,27.15,910.96
7121,39684993,2023-02-06,-146.22,764.74
4019,39684993,2023-02-08,83.02,847.76
4020,39684993,2023-02-14,47.11,894.87
981,39710099,2023-01-31,0.0,155.88
1681,39710099,2023-02-01,105.76,261.64
3287,39710099,2023-02-02,-191.44,70.2
3288,39710099,2023-02-05,-63.96,6.240000000000009
3289,39710099,2023-02-09,-105.33,-99.09
3290,39710099,2023-02-11,-82.76,-181.85000000000002
3291,39710099,2023-02-13,-211.13,-392.98
982,39744047,2023-01-31,0.0,505.93
7922,39744047,2023-02-08,103.57,609.5
8670,39744047,2023-02-14,-55.79,553.71
7923,39744047,2023-02-14,1583.4,2137.11
983,39749381,2023-01-31,0.0,576.13
3534,39749381,2023-02-02,-70.63,505.5
3535,39749381,2023-02-03,-207.91,297.59000000000003
4266,39749381,2023-02-03,16.93,314.52
4267,39749381,2023-02-04,91.7,406.22
4268,39749381,2023-02-06,142.55,548.77
4269,39749381,2023-02-06,158.11,706.88
4270,39749381,2023-02-08,49.6,756.48
4271,39749381,2023-02-08,183.05,939.53
3536,39749381,2023-02-09,-156.71,782.82
3537,39749381,2023-02-11,-143.94,638.88
4272,39749381,2023-02-14,52.36,691.24
984,39772392,2023-01-31,0.0,370.34
508,39772392,2023-02-01,-116.66,253.67999999999998
2025,39772392,2023-02-01,101.28,354.96
2026,39772392,2023-02-02,179.0,533.96
2027,39772392,2023-02-03,7.7,541.66
2028,39772392,2023-02-08,38.27,579.93
509,39772392,2023-02-09,-108.57,471.36
2029,39772392,2023-02-10,171.22,642.5799999999999
985,39822234,2023-01-31,0.0,718.73
2133,39822234,2023-02-02,97.9,816.63
2134,39822234,2023-02-02,681.0,1497.63
2135,39822234,2023-02-04,113.62,1611.25
2136,39822234,2023-02-05,17.88,1629.13
2137,39822234,2023-02-09,40.77,1669.9
2138,39822234,2023-02-09,159.54,1829.44
8338,39822234,2023-02-10,-849.7,979.74
2139,39822234,2023-02-14,64.1,1043.8400000000001
986,39863459,2023-01-31,0.0,387.4
2503,39863459,2023-02-02,-121.1,266.29999999999995
2504,39863459,2023-02-04,-48.63,217.67
2505,39863459,2023-02-13,-123.49,94.17999999999995
8651,39863459,2023-02-13,101.87,196.04999999999998
987,39875057,2023-01-31,0.0,126.02
6095,39875057,2023-02-05,-149.4,-23.38000000000001
6096,39875057,2023-02-09,-115.89,-139.27000000000004
6097,39875057,2023-02-11,-126.5,-265.77000000000004
8428,39875057,2023-02-11,96.34,-169.43
8429,39875057,2023-02-13,153.16,-16.270000000000024
6098,39875057,2023-02-14,-104.45,-120.72000000000001
988,39920664,2023-01-31,0.0,627.45
7050,39920664,2023-02-06,101.84,729.2900000000001
8230,39920664,2023-02-10,-72.61,656.6800000000001
7051,39920664,2023-02-10,190.65,847.33
989,39974803,2023-01-31,0.0,567.93
5811,39974803,2023-02-04,-39.82,528.1099999999999
5296,39974803,2023-02-04,85.93,614.04
5812,39974803,2023-02-07,-131.84,482.19999999999993
5297,39974803,2023-02-08,86.91,569.1099999999999
5298,39974803,2023-02-10,74.29,643.4
990,40004707,2023-01-31,0.0,206.15
5244,40004707,2023-02-04,74.84,280.99
5245,40004707,2023-02-12,111.7,392.69000000000005
991,40039031,2023-01-31,0.0,124.72
2732,40039031,2023-02-02,792.0,916.72
7657,40039031,2023-02-07,-1581.8,-665.0799999999999
7658,40039031,2023-02-08,-35.13,-700.2099999999999
2733,40039031,2023-02-08,157.28,-542.93
2734,40039031,2023-02-09,97.15,-445.78
7659,40039031,2023-02-12,-43.72,-489.4999999999999
7660,40039031,2023-02-14,-134.52,-624.02
992,40048102,2023-01-31,0.0,519.25
4349,40048102,2023-02-03,103.29,622.54
6879,40048102,2023-02-06,-43.89,578.65
6880,40048102,2023-02-08,-811.2,-232.55000000000007
6881,40048102,2023-02-09,-119.86,-352.4100000000001
4350,40048102,2023-02-10,168.35,-184.06000000000006
4351,40048102,2023-02-12,20.81,-163.2500000000001
993,40082477,2023-01-31,0.0,171.74
859,40082477,2023-02-01,-131.11,40.629999999999995
7289,40082477,2023-02-07,86.16,126.78999999999999
7290,40082477,2023-02-09,135.47,262.26
7291,40082477,2023-02-09,1434.1,1696.36
860,40082477,2023-02-11,-49.15,1647.2099999999998
7292,40082477,2023-02-13,121.9,1769.11
7293,40082477,2023-02-14,120.81,1889.9199999999998
994,40082950,2023-01-31,0.0,322.41
5290,40082950,2023-02-04,-80.37,242.04000000000002
5842,40082950,2023-02-04,40.4,282.44
5843,40082950,2023-02-08,149.73,432.17
5844,40082950,2023-02-08,169.4,601.5699999999999
5845,40082950,2023-02-12,171.12,772.69
995,40091206,2023-01-31,0.0,812.34
1120,40091206,2023-02-01,86.72,899.0600000000001
7760,40091206,2023-02-08,-118.11,780.95
7761,40091206,2023-02-09,-11.2,769.75
7762,40091206,2023-02-11,-36.38,733.37
1121,40091206,2023-02-12,157.02,890.3900000000001
1122,40091206,2023-02-13,67.73,958.1200000000001
996,40098771,2023-01-31,0.0,742.62
4415,40098771,2023-02-03,-47.78,694.84
4416,40098771,2023-02-08,-145.4,549.44
4417,40098771,2023-02-10,-93.3,456.14
8390,40098771,2023-02-10,62.82,518.96
4418,40098771,2023-02-11,-60.09,458.87
8391,40098771,2023-02-14,71.12,529.99
997,40098912,2023-01-31,0.0,951.18
7771,40098912,2023-02-08,54.56,1005.74
7772,40098912,2023-02-10,78.83,1084.57
7773,40098912,2023-02-11,47.98,1132.55
7774,40098912,2023-02-14,109.46,1242.01
998,40112082,2023-01-31,0.0,289.68
5547,40112082,2023-02-04,-97.86,191.82
5548,40112082,2023-02-12,-168.73,23.090000000000032
5549,40112082,2023-02-13,-113.44,-90.34999999999997
999,40127778,2023-01-31,0.0,196.74
1352,40127778,2023-02-01,-85.77,110.97000000000001
1353,40127778,2023-02-02,-205.49,-94.51999999999998
1355,40127778,2023-02-05,-179.9,-274.41999999999996
1354,40127778,2023-02-05,-26.38,-300.8
1356,40127778,2023-02-07,-159.97,-460.77
1357,40127778,2023-02-10,-90.86,-551.63
1358,40127778,2023-02-11,-832.5,-1384.1299999999999
1359,40127778,2023-02-14,-65.19,-1449.32
1000,40176462,2023-01-31,0.0,193.24
2700,40176462,2023-02-02,744.2,937.44
2701,40176462,2023-02-05,276.4,1213.8400000000001
2702,40176462,2023-02-06,77.47,1291.31
2703,40176462,2023-02-08,141.03,1432.34
8281,40176462,2023-02-10,-116.72,1315.6200000000001
2704,40176462,2023-02-13,33.75,1349.3700000000001
1001,40189934,2023-01-31,0.0,804.21
3086,40189934,2023-02-02,1824.3,2628.51
5754,40189934,2023-02-04,-1705.8,922.71
3087,40189934,2023-02-07,64.02,986.73
5755,40189934,2023-02-13,-108.27,878.46
1002,40224914,2023-01-31,0.0,53.1
1473,40224914,2023-02-01,8.07,61.17
6654,40224914,2023-02-05,-104.89,-43.71999999999999
6655,40224914,2023-02-13,-39.74,-83.46000000000001
1474,40224914,2023-02-14,91.53,8.07
1003,40247376,2023-01-31,0.0,209.78
2630,40247376,2023-02-02,58.7,268.48
5051,40247376,2023-02-04,-124.72,143.76
5052,40247376,2023-02-11,-91.93,51.83000000000001
5053,40247376,2023-02-12,-38.33,13.5
5054,40247376,2023-02-13,-49.9,-36.400000000000006
1004,40374724,2023-01-31,0.0,692.58
26,40374724,2023-02-01,-187.15,505.43000000000006
3008,40374724,2023-02-02,36.32,541.75
3009,40374724,2023-02-03,105.36,647.11
27,40374724,2023-02-04,-40.4,606.71
3011,40374724,2023-02-04,84.48,691.19
3010,40374724,2023-02-04,97.05,788.24
28,40374724,2023-02-05,-63.32,724.9200000000001
3012,40374724,2023-02-05,62.34,787.26
29,40374724,2023-02-06,-160.25,627.01
30,40374724,2023-02-09,-60.37,566.6400000000001
3013,40374724,2023-02-10,58.79,625.4300000000001
31,40374724,2023-02-14,-95.2,530.23
3014,40374724,2023-02-14,1139.7,1669.93
1005,40436811,2023-01-31,0.0,445.93
4590,40436811,2023-02-03,-55.47,390.46000000000004
4591,40436811,2023-02-03,-40.33,350.13
4592,40436811,2023-02-08,-66.67,283.46000000000004
8453,40436811,2023-02-11,42.48,325.94
4593,40436811,2023-02-13,-81.01,244.93
8454,40436811,2023-02-13,30.92,275.85
1006,40507682,2023-01-31,0.0,524.63
1468,40507682,2023-02-01,86.68,611.31
3718,40507682,2023-02-02,-83.88,527.4300000000001
1469,40507682,2023-02-08,53.13,580.5600000000001
3719,40507682,2023-02-10,-74.41,506.15000000000003
3720,40507682,2023-02-12,-77.47,428.68
1470,40507682,2023-02-12,118.43,547.11
1471,40507682,2023-02-13,76.49,623.6
1472,40507682,2023-02-14,1514.1,2137.7
1007,40530538,2023-01-31,0.0,364.98
7057,40530538,2023-02-06,-87.21,277.77000000000004
7058,40530538,2023-02-06,-16.08,261.69000000000005
7056,40530538,2023-02-06,-13.61,248.08000000000004
7316,40530538,2023-02-07,27.47,275.55
7315,40530538,2023-02-07,166.24,441.79
7059,40530538,2023-02-13,-112.38,329.41
1008,40548885,2023-01-31,0.0,160.32
5815,40548885,2023-02-04,-25.82,134.5
6263,40548885,2023-02-05,130.7,265.2
6264,40548885,2023-02-07,117.32,382.52
6265,40548885,2023-02-12,56.37,438.89
6266,40548885,2023-02-13,334.9,773.79
5816,40548885,2023-02-14,-68.84,704.95
1009,40550712,2023-01-31,0.0,511.4
6350,40550712,2023-02-05,85.05,596.4499999999999
7117,40550712,2023-02-06,-98.85,497.59999999999997
7118,40550712,2023-02-06,-72.25,425.34999999999997
7119,40550712,2023-02-07,-112.11,313.24
7120,40550712,2023-02-09,-84.03,229.20999999999998
6351,40550712,2023-02-11,149.28,378.49
1010,40551490,2023-01-31,0.0,569.45
5782,40551490,2023-02-04,-761.9,-192.44999999999993
5564,40551490,2023-02-04,95.01,-97.43999999999994
5565,40551490,2023-02-05,101.23,3.7900000000000773
5566,40551490,2023-02-12,76.51,80.30000000000007
1011,40600852,2023-01-31,0.0,15.08
485,40600852,2023-02-01,32.39,47.47
484,40600852,2023-02-01,57.48,104.95
486,40600852,2023-02-06,157.94,262.89
7873,40600852,2023-02-08,-146.43,116.46
487,40600852,2023-02-09,24.49,140.95
7874,40600852,2023-02-10,-34.9,106.05
7876,40600852,2023-02-11,-667.1,-561.05
7875,40600852,2023-02-11,-111.87,-672.92
488,40600852,2023-02-11,154.67,-518.25
7877,40600852,2023-02-13,-93.21,-611.4599999999999
1012,40631802,2023-01-31,0.0,104.96
2799,40631802,2023-02-02,-528.9,-423.94
2725,40631802,2023-02-02,136.28,-287.66
2726,40631802,2023-02-04,189.3,-98.35999999999997
2727,40631802,2023-02-06,136.61,38.25000000000004
2800,40631802,2023-02-08,-714.2,-675.9499999999999
2801,40631802,2023-02-10,-92.9,-768.8499999999999
1013,40673170,2023-01-31,0.0,124.66
1773,40673170,2023-02-01,95.49,220.14999999999998
5644,40673170,2023-02-04,-103.05,117.1
5645,40673170,2023-02-06,-80.15,36.94999999999999
1774,40673170,2023-02-08,123.3,160.25
1775,40673170,2023-02-13,14.09,174.33999999999997
1014,40712298,2023-01-31,0.0,781.72
6844,40712298,2023-02-06,107.96,889.6800000000001
6845,40712298,2023-02-07,74.11,963.79
6846,40712298,2023-02-11,147.09,1110.88
1015,40745545,2023-01-31,0.0,460.29
90,40745545,2023-02-01,-85.94,374.35
91,40745545,2023-02-04,-189.33,185.02000000000004
92,40745545,2023-02-11,-100.04,84.98000000000002
8480,40745545,2023-02-11,159.21,244.19
93,40745545,2023-02-12,-139.58,104.60999999999996
8481,40745545,2023-02-13,121.39,226.0
1016,40745965,2023-01-31,0.0,654.15
1254,40745965,2023-02-01,-1264.3,-610.15
1255,40745965,2023-02-02,-196.6,-806.7499999999999
4001,40745965,2023-02-03,77.07,-729.68
1256,40745965,2023-02-05,-98.72,-828.4
1257,40745965,2023-02-07,-42.04,-870.4399999999999
1258,40745965,2023-02-08,-100.85,-971.2900000000001
1259,40745965,2023-02-09,-81.65,-1052.94
4002,40745965,2023-02-09,111.83,-941.11
1017,40797438,2023-01-31,0.0,679.38
471,40797438,2023-02-01,49.69,729.0699999999999
3518,40797438,2023-02-02,-153.46,575.61
472,40797438,2023-02-03,116.69,692.3
3519,40797438,2023-02-04,-77.37,614.93
473,40797438,2023-02-06,193.06,807.99
474,40797438,2023-02-10,98.45,906.44
475,40797438,2023-02-12,84.72,991.16
3520,40797438,2023-02-14,-154.35,836.81
1018,40813783,2023-01-31,0.0,288.51
4467,40813783,2023-02-03,130.36,418.87
4468,40813783,2023-02-06,32.2,451.07
4469,40813783,2023-02-07,119.18,570.25
8666,40813783,2023-02-14,-182.1,388.15000000000003
1019,40872555,2023-01-31,0.0,115.88
2105,40872555,2023-02-02,89.7,205.57999999999998
3866,40872555,2023-02-03,-27.83,177.75
3867,40872555,2023-02-04,-1218.0,-1040.25
2106,40872555,2023-02-12,61.6,-978.6500000000002
1020,40898013,2023-01-31,0.0,650.33
5356,40898013,2023-02-04,-245.23,405.1
5357,40898013,2023-02-04,-115.27,289.83000000000004
6394,40898013,2023-02-05,28.46,318.2900000000001
5358,40898013,2023-02-06,-68.98,249.31000000000006
5359,40898013,2023-02-09,-30.36,218.95000000000005
6395,40898013,2023-02-11,130.61,349.56000000000006
5360,40898013,2023-02-13,-145.19,204.37000000000006
1021,40906801,2023-01-31,0.0,83.77
1654,40906801,2023-02-01,185.45,269.21999999999997
3086,40906801,2023-02-02,-24.23,244.99
3087,40906801,2023-02-06,-42.19,202.79999999999998
3088,40906801,2023-02-09,-100.36,102.43999999999998
1656,40906801,2023-02-09,39.08,141.51999999999998
1657,40906801,2023-02-09,97.54,239.06
1655,40906801,2023-02-09,1162.9,1401.96
1022,41022448,2023-01-31,0.0,37.89
7579,41022448,2023-02-07,168.78,206.67000000000002
8387,41022448,2023-02-10,-180.01,26.66000000000001
8388,41022448,2023-02-13,-168.95,-142.28999999999996
7580,41022448,2023-02-14,161.34,19.050000000000026
1023,41036701,2023-01-31,0.0,249.29
1822,41036701,2023-02-01,-802.6,-553.3100000000001
8082,41036701,2023-02-09,109.88,-443.43000000000006
8083,41036701,2023-02-14,823.0,379.56999999999994
1024,41038634,2023-01-31,0.0,802.08
2263,41038634,2023-02-02,-37.84,764.24
2264,41038634,2023-02-11,-202.15,562.09
2265,41038634,2023-02-14,-120.81,441.28000000000003
1025,41085190,2023-01-31,0.0,78.73
4524,41085190,2023-02-03,-43.6,35.13
4540,41085190,2023-02-03,113.59,148.72000000000003
4541,41085190,2023-02-05,37.99,186.71000000000004
4525,41085190,2023-02-07,-1522.0,-1335.29
4542,41085190,2023-02-07,143.04,-1192.25
4526,41085190,2023-02-08,-1168.1,-2360.35
4527,41085190,2023-02-08,-118.54,-2478.89
4543,41085190,2023-02-10,1580.9,-897.9899999999998
4544,41085190,2023-02-12,78.26,-819.7299999999998
4545,41085190,2023-02-14,43.95,-775.7799999999997
4546,41085190,2023-02-14,884.5,108.72000000000024
1026,41170515,2023-01-31,0.0,713.46
3921,41170515,2023-02-03,227.05,940.51
8324,41170515,2023-02-10,-1147.5,-206.99
1027,41194009,2023-01-31,0.0,585.15
7423,41194009,2023-02-07,-138.38,446.77
7422,41194009,2023-02-07,-108.31,338.46
7971,41194009,2023-02-09,145.82,484.28
7424,41194009,2023-02-12,-104.69,379.59
7425,41194009,2023-02-13,-53.28,326.30999999999995
1028,41211432,2023-01-31,0.0,205.0
1408,41211432,2023-02-01,-80.9,124.1
34,41211432,2023-02-01,87.59,211.69
35,41211432,2023-02-04,129.37,341.06
1409,41211432,2023-02-07,-60.73,280.33000000000004
36,41211432,2023-02-08,120.67,401.0
1410,41211432,2023-02-10,-97.9,303.1
1411,41211432,2023-02-11,-79.08,224.01999999999998
1029,41245288,2023-01-31,0.0,540.61
6418,41245288,2023-02-05,92.78,633.39
6419,41245288,2023-02-10,34.9,668.29
6420,41245288,2023-02-10,59.42,727.71
6421,41245288,2023-02-11,87.57,815.28
8597,41245288,2023-02-13,-1088.0,-272.72
8596,41245288,2023-02-13,-80.87,-353.59000000000003
1030,41245805,2023-01-31,0.0,753.91
4477,41245805,2023-02-03,-116.55,637.36
4478,41245805,2023-02-04,-176.15,461.21
4479,41245805,2023-02-04,-55.24,405.96999999999997
5567,41245805,2023-02-04,900.7,1306.67
1031,41252281,2023-01-31,0.0,834.88
1782,41252281,2023-02-01,148.34,983.22
3785,41252281,2023-02-03,-89.06,894.16
1783,41252281,2023-02-03,19.31,913.47
1784,41252281,2023-02-03,67.76,981.23
3786,41252281,2023-02-05,-89.54,891.69
1785,41252281,2023-02-09,787.2,1678.8899999999999
1786,41252281,2023-02-10,1052.9,2731.79
1032,41282329,2023-01-31,0.0,80.32
1397,41282329,2023-02-01,-42.27,38.04999999999999
6233,41282329,2023-02-05,1685.4,1723.45
1398,41282329,2023-02-09,-112.38,1611.07
6234,41282329,2023-02-10,75.67,1686.74
6235,41282329,2023-02-13,1023.0,2709.7400000000002
1033,41356963,2023-01-31,0.0,398.3
5354,41356963,2023-02-04,80.86,479.16
6587,41356963,2023-02-05,-98.47,380.69
5355,41356963,2023-02-05,74.98,455.67
6588,41356963,2023-02-06,-125.59,330.08000000000004
5356,41356963,2023-02-09,132.11,462.19000000000005
1034,41420018,2023-01-31,0.0,816.5
3283,41420018,2023-02-02,-118.87,697.63
3284,41420018,2023-02-09,-166.64,530.99
8317,41420018,2023-02-10,114.86,645.85
8318,41420018,2023-02-13,68.86,714.71
8319,41420018,2023-02-14,96.41,811.12
1035,41542689,2023-01-31,0.0,246.73
4027,41542689,2023-02-03,-149.87,96.85999999999999
4312,41542689,2023-02-03,36.94,133.79999999999998
4028,41542689,2023-02-04,-124.08,9.719999999999999
4029,41542689,2023-02-07,-130.23,-120.51000000000002
4313,41542689,2023-02-11,106.87,-13.640000000000015
4314,41542689,2023-02-12,1255.7,1242.06
4030,41542689,2023-02-13,-67.31,1174.75
1036,41561470,2023-01-31,0.0,750.8
541,41561470,2023-02-01,490.9,1241.6999999999998
542,41561470,2023-02-03,144.92,1386.62
543,41561470,2023-02-04,58.38,1445.0
544,41561470,2023-02-05,161.25,1606.25
545,41561470,2023-02-08,195.35,1801.6
546,41561470,2023-02-11,41.42,1843.02
8669,41561470,2023-02-14,-1083.0,760.02
1037,41574018,2023-01-31,0.0,254.89
1149,41574018,2023-02-01,-19.88,235.01
2052,41574018,2023-02-01,160.61,395.62
1150,41574018,2023-02-05,-118.39,277.23
2053,41574018,2023-02-09,18.91,296.14
2054,41574018,2023-02-11,58.37,354.51
2055,41574018,2023-02-12,145.1,499.61
2056,41574018,2023-02-14,40.82,540.4300000000001
1038,41584073,2023-01-31,0.0,561.74
3790,41584073,2023-02-03,-46.59,515.15
5191,41584073,2023-02-04,34.22,549.37
5192,41584073,2023-02-04,91.41,640.78
5193,41584073,2023-02-05,96.95,737.73
3791,41584073,2023-02-08,-245.8,491.93
5194,41584073,2023-02-10,133.89,625.8199999999999
5195,41584073,2023-02-11,114.84,740.66
3792,41584073,2023-02-12,-70.6,670.06
1039,41664336,2023-01-31,0.0,853.37
1131,41664336,2023-02-01,45.11,898.48
1040,41706310,2023-01-31,0.0,126.08
102,41706310,2023-02-01,34.17,160.25
104,41706310,2023-02-01,71.89,232.14
103,41706310,2023-02-01,82.09,314.23
105,41706310,2023-02-03,89.33,403.56
5302,41706310,2023-02-04,-88.18,315.38
106,41706310,2023-02-05,89.54,404.92
5303,41706310,2023-02-06,-114.75,290.17
5304,41706310,2023-02-06,-49.54,240.63
5305,41706310,2023-02-12,-97.82,142.81
1041,41716822,2023-01-31,0.0,418.05
216,41716822,2023-02-01,78.07,496.12
217,41716822,2023-02-06,158.15,654.27
8262,41716822,2023-02-10,-143.3,510.97
218,41716822,2023-02-10,106.77,617.74
219,41716822,2023-02-11,125.71,743.45
8263,41716822,2023-02-12,-68.38,675.0699999999999
8264,41716822,2023-02-13,-47.15,627.92
1042,41741558,2023-01-31,0.0,435.71
2381,41741558,2023-02-02,-43.55,392.15999999999997
2382,41741558,2023-02-05,-97.55,294.61
6055,41741558,2023-02-05,57.79,352.4
2383,41741558,2023-02-06,-86.91,265.49
2384,41741558,2023-02-07,-112.5,152.98999999999995
2386,41741558,2023-02-09,-101.51,51.47999999999996
2385,41741558,2023-02-09,-58.59,-7.110000000000014
2387,41741558,2023-02-10,-151.6,-158.7100000000001
6056,41741558,2023-02-11,989.3,830.5899999999999
1043,41755476,2023-01-31,0.0,72.71
2641,41755476,2023-02-02,62.51,135.22
2642,41755476,2023-02-02,205.22,340.44
2643,41755476,2023-02-06,59.59,400.03
2644,41755476,2023-02-14,71.18,471.21
1044,41773473,2023-01-31,0.0,355.0
280,41773473,2023-02-01,68.47,423.47
281,41773473,2023-02-06,78.99,502.46
8539,41773473,2023-02-12,-118.77,383.69
1045,41778536,2023-01-31,0.0,722.03
2493,41778536,2023-02-02,132.64,854.67
7620,41778536,2023-02-07,-129.29,725.38
2494,41778536,2023-02-07,34.47,759.8499999999999
7621,41778536,2023-02-08,-42.43,717.42
2495,41778536,2023-02-09,859.1,1576.52
7622,41778536,2023-02-11,-160.56,1415.96
7624,41778536,2023-02-12,-1499.6,-83.63999999999987
7623,41778536,2023-02-12,-150.22,-233.8599999999999
2496,41778536,2023-02-13,112.18,-121.67999999999984
2497,41778536,2023-02-14,141.62,19.94000000000017
1046,41852767,2023-01-31,0.0,993.36
1112,41852767,2023-02-01,114.68,1108.04
4703,41852767,2023-02-03,-106.35,1001.69
1113,41852767,2023-02-04,207.89,1209.58
1114,41852767,2023-02-06,155.92,1365.5
1115,41852767,2023-02-10,92.13,1457.63
4704,41852767,2023-02-13,-23.37,1434.26
1047,41879906,2023-01-31,0.0,29.05
1811,41879906,2023-02-01,-80.81,-51.760000000000005
4974,41879906,2023-02-03,105.23,53.47
1812,41879906,2023-02-06,-46.31,7.16
1813,41879906,2023-02-09,-65.76,-58.60000000000001
4976,41879906,2023-02-10,82.73,24.13
4975,41879906,2023-02-10,958.6,982.73
1814,41879906,2023-02-11,-99.31,883.4200000000001
1048,41881442,2023-01-31,0.0,650.34
1720,41881442,2023-02-01,-212.26,438.08000000000004
1721,41881442,2023-02-01,-135.55,302.53000000000003
1722,41881442,2023-02-10,-139.99,162.54000000000002
8442,41881442,2023-02-11,114.97,277.51
8444,41881442,2023-02-12,26.35,303.86
8443,41881442,2023-02-12,50.34,354.20000000000005
1049,41914097,2023-01-31,0.0,921.06
2477,41914097,2023-02-02,87.3,1008.3599999999999
2478,41914097,2023-02-03,84.5,1092.86
5622,41914097,2023-02-04,-95.13,997.7299999999999
5623,41914097,2023-02-07,-61.37,936.3599999999999
2479,41914097,2023-02-07,192.3,1128.6599999999999
5624,41914097,2023-02-08,-86.91,1041.75
5625,41914097,2023-02-08,-25.37,1016.38
5626,41914097,2023-02-10,-111.11,905.27
5627,41914097,2023-02-13,-44.17,861.0999999999999
2480,41914097,2023-02-13,93.82,954.92
1050,41919083,2023-01-31,0.0,884.52
1035,41919083,2023-02-01,-164.31,720.21
1036,41919083,2023-02-03,-99.68,620.53
7261,41919083,2023-02-07,109.89,730.42
7262,41919083,2023-02-07,1738.7,2469.12
1037,41919083,2023-02-14,-69.27,2399.8500000000004
7263,41919083,2023-02-14,86.17,2486.0200000000004
1051,41954037,2023-01-31,0.0,768.8
7893,41954037,2023-02-08,-27.23,741.5699999999999
7719,41954037,2023-02-08,34.38,775.9499999999999
7894,41954037,2023-02-12,-1015.8,-239.85000000000002
7895,41954037,2023-02-14,-145.08,-384.93000000000006
1052,41972741,2023-01-31,0.0,374.09
3392,41972741,2023-02-02,123.02,497.10999999999996
3393,41972741,2023-02-08,88.5,585.6099999999999
3394,41972741,2023-02-09,155.66,741.27
3395,41972741,2023-02-12,57.33,798.5999999999999
3396,41972741,2023-02-13,48.57,847.17
1053,41981752,2023-01-31,0.0,843.61
6482,41981752,2023-02-05,-179.42,664.19
8198,41981752,2023-02-10,114.57,778.76
8199,41981752,2023-02-10,1375.3,2154.06
8200,41981752,2023-02-11,50.91,2204.9700000000003
1054,42017456,2023-01-31,0.0,947.67
5241,42017456,2023-02-04,-132.12,815.55
5240,42017456,2023-02-04,-55.98,759.5699999999999
5242,42017456,2023-02-05,-62.54,697.03
6878,42017456,2023-02-06,222.12,919.15
5243,42017456,2023-02-08,-77.04,842.11
6879,42017456,2023-02-10,66.19,908.3
1055,42181728,2023-01-31,0.0,51.89
3339,42181728,2023-02-02,-87.3,-35.41
3340,42181728,2023-02-04,-88.31,-123.72000000000001
6165,42181728,2023-02-05,116.94,-6.780000000000001
3341,42181728,2023-02-06,-98.97,-105.74999999999999
3342,42181728,2023-02-06,-98.86,-204.61
6166,42181728,2023-02-07,153.16,-51.45
6167,42181728,2023-02-08,50.38,-1.0700000000000003
3343,42181728,2023-02-13,-60.63,-61.7
1056,42202867,2023-01-31,0.0,614.83
7039,42202867,2023-02-06,-82.67,532.1600000000001
7181,42202867,2023-02-06,117.02,649.1800000000001
7182,42202867,2023-02-07,57.45,706.63
7183,42202867,2023-02-07,129.86,836.49
7040,42202867,2023-02-10,-85.13,751.3600000000001
7041,42202867,2023-02-11,-177.1,574.2600000000001
1057,42232896,2023-01-31,0.0,647.99
2947,42232896,2023-02-02,21.71,669.7
5265,42232896,2023-02-04,-84.59,585.11
5264,42232896,2023-02-04,-42.73,542.38
2948,42232896,2023-02-09,97.8,640.1800000000001
2949,42232896,2023-02-10,74.94,715.12
2950,42232896,2023-02-10,130.57,845.69
5266,42232896,2023-02-13,-74.01,771.68
1058,42235537,2023-01-31,0.0,165.2
347,42235537,2023-02-01,807.2,972.4000000000001
3238,42235537,2023-02-02,-101.22,871.1800000000001
3239,42235537,2023-02-02,-92.05,779.1300000000001
3240,42235537,2023-02-04,-127.96,651.1700000000001
3241,42235537,2023-02-06,-161.61,489.56
3242,42235537,2023-02-07,-185.51,304.05000000000007
3244,42235537,2023-02-08,-1244.2,-940.1499999999999
3243,42235537,2023-02-08,-118.58,-1058.7299999999998
349,42235537,2023-02-08,130.54,-928.1899999999998
348,42235537,2023-02-08,167.23,-760.96
350,42235537,2023-02-09,101.12,-659.8399999999999
351,42235537,2023-02-10,118.64,-541.2
352,42235537,2023-02-12,119.03,-422.1699999999999
3245,42235537,2023-02-13,-116.3,-538.47
353,42235537,2023-02-14,88.32,-450.1499999999999
1059,42245590,2023-01-31,0.0,229.01
1253,42245590,2023-02-01,55.09,284.1
1254,42245590,2023-02-02,120.7,404.8
1255,42245590,2023-02-07,639.3,1044.1
8108,42245590,2023-02-09,-137.79,906.31
1256,42245590,2023-02-09,144.93,1051.2399999999998
1257,42245590,2023-02-12,134.05,1185.29
1258,42245590,2023-02-13,0.22,1185.51
1060,42255054,2023-01-31,0.0,550.4
1565,42255054,2023-02-01,126.46,676.86
1564,42255054,2023-02-01,129.39,806.25
1566,42255054,2023-02-04,292.64,1098.8899999999999
1567,42255054,2023-02-05,144.67,1243.56
7288,42255054,2023-02-07,-50.0,1193.56
1568,42255054,2023-02-08,57.72,1251.2799999999997
1061,42268900,2023-01-31,0.0,521.35
394,42268900,2023-02-01,140.67,662.02
4670,42268900,2023-02-03,-97.5,564.52
4671,42268900,2023-02-03,-85.29,479.23
395,42268900,2023-02-03,177.67,656.9
4672,42268900,2023-02-05,-46.87,610.03
4673,42268900,2023-02-08,-103.7,506.33000000000004
396,42268900,2023-02-09,38.42,544.75
1062,42300418,2023-01-31,0.0,151.39
1791,42300418,2023-02-01,-808.4,-657.01
1792,42300418,2023-02-04,-950.2,-1607.21
8517,42300418,2023-02-11,127.49,-1479.7200000000003
1063,42311039,2023-01-31,0.0,98.95
1895,42311039,2023-02-01,156.73,255.68
3800,42311039,2023-02-03,-8.57,247.11
1896,42311039,2023-02-05,160.67,407.78
3801,42311039,2023-02-06,-144.74,263.03999999999996
3802,42311039,2023-02-10,-124.46,138.57999999999998
1897,42311039,2023-02-10,39.22,177.79999999999998
3803,42311039,2023-02-13,-128.84,48.95999999999998
1064,42322494,2023-01-31,0.0,486.58
4615,42322494,2023-02-03,-15.35,471.22999999999996
6874,42322494,2023-02-06,78.93,550.16
4616,42322494,2023-02-07,-47.31,502.84999999999997
4617,42322494,2023-02-12,-101.4,401.45
6875,42322494,2023-02-12,110.14,511.59
1065,42340050,2023-01-31,0.0,935.61
869,42340050,2023-02-01,-3.55,932.0600000000001
569,42340050,2023-02-01,188.33,1120.39
870,42340050,2023-02-03,-41.22,1079.17
570,42340050,2023-02-05,130.71,1209.88
571,42340050,2023-02-07,52.36,1262.24
572,42340050,2023-02-11,174.4,1436.64
871,42340050,2023-02-12,-170.0,1266.64
872,42340050,2023-02-13,-1678.8,-412.15999999999997
1066,42396753,2023-01-31,0.0,628.86
3253,42396753,2023-02-02,-38.42,590.44
7333,42396753,2023-02-07,98.66,689.1
3255,42396753,2023-02-08,-194.3,494.8
3254,42396753,2023-02-08,-95.14,399.66
7334,42396753,2023-02-09,77.75,477.41
1067,42509068,2023-01-31,0.0,890.56
6222,42509068,2023-02-05,-191.47,699.0899999999999
6147,42509068,2023-02-05,127.52,826.6099999999999
6148,42509068,2023-02-06,97.06,923.67
6149,42509068,2023-02-11,137.31,1060.98
6150,42509068,2023-02-12,518.5,1579.48
6151,42509068,2023-02-14,156.79,1736.27
1068,42515631,2023-01-31,0.0,186.74
8185,42515631,2023-02-09,-117.38,69.36000000000001
8186,42515631,2023-02-10,-121.27,-51.90999999999997
8187,42515631,2023-02-10,-64.12,-116.02999999999997
8446,42515631,2023-02-11,116.46,0.4300000000000068
8447,42515631,2023-02-13,186.35,186.78
1069,42546381,2023-01-31,0.0,409.3
6608,42546381,2023-02-05,-128.72,280.58000000000004
6449,42546381,2023-02-05,197.22,477.8
6609,42546381,2023-02-06,-127.85,349.95000000000005
6450,42546381,2023-02-09,61.15,411.1
6451,42546381,2023-02-14,104.78,515.88
1070,42589255,2023-01-31,0.0,282.84
4135,42589255,2023-02-03,101.42,384.26
4134,42589255,2023-02-03,240.55,624.81
8545,42589255,2023-02-12,-134.18,490.63
1071,42602631,2023-01-31,0.0,539.62
5780,42602631,2023-02-04,-196.98,342.64
5781,42602631,2023-02-07,-764.7,-422.06000000000006
1072,42652193,2023-01-31,0.0,566.53
5771,42652193,2023-02-04,1465.5,2032.03
6489,42652193,2023-02-05,-129.51,1902.52
6490,42652193,2023-02-10,-89.09,1813.43
6491,42652193,2023-02-13,-1062.5,750.9300000000001
6492,42652193,2023-02-14,-174.26,576.6700000000001
1073,42726921,2023-01-31,0.0,590.15
6013,42726921,2023-02-05,-99.16,490.99
6534,42726921,2023-02-05,155.76,646.75
6535,42726921,2023-02-12,157.87,804.62
6536,42726921,2023-02-12,1342.4,2147.02
1074,42726928,2023-01-31,0.0,601.3
809,42726928,2023-02-01,102.89,704.1899999999999
5009,42726928,2023-02-04,-210.25,493.93999999999994
5010,42726928,2023-02-04,-63.83,430.10999999999996
5008,42726928,2023-02-04,-55.58,374.53
810,42726928,2023-02-05,181.42,555.9499999999999
5013,42726928,2023-02-06,-75.55,480.3999999999999
5012,42726928,2023-02-06,-63.33,417.06999999999994
5011,42726928,2023-02-06,-52.22,364.8499999999999
811,42726928,2023-02-12,187.21,552.06
5014,42726928,2023-02-14,-163.23,388.8299999999999
1075,42746180,2023-01-31,0.0,12.15
5497,42746180,2023-02-04,-1610.8,-1598.6499999999999
5498,42746180,2023-02-05,-8.72,-1607.37
5499,42746180,2023-02-07,-79.0,-1686.37
5500,42746180,2023-02-08,-92.43,-1778.8
5501,42746180,2023-02-09,-176.97,-1955.77
1076,42752982,2023-01-31,0.0,526.19
6746,42752982,2023-02-06,-106.97,419.22
6747,42752982,2023-02-07,-192.3,226.92000000000007
6748,42752982,2023-02-11,-43.78,183.14000000000004
6749,42752982,2023-02-14,-42.9,140.24000000000007
6750,42752982,2023-02-14,-12.8,127.44000000000005
1077,42783101,2023-01-31,0.0,289.82
385,42783101,2023-02-01,-61.16,228.66
6781,42783101,2023-02-06,92.42,321.08
386,42783101,2023-02-07,-1035.2,-714.1200000000001
6782,42783101,2023-02-11,125.65,-588.47
387,42783101,2023-02-12,-88.66,-677.1300000000001
6783,42783101,2023-02-13,142.63,-534.5
1078,42813808,2023-01-31,0.0,633.08
7950,42813808,2023-02-08,-129.37,503.71000000000004
7951,42813808,2023-02-09,-125.63,378.08000000000004
1079,42838186,2023-01-31,0.0,466.48
1054,42838186,2023-02-01,56.55,523.03
7785,42838186,2023-02-08,-1382.5,-859.47
1055,42838186,2023-02-09,1176.8,317.3299999999999
7786,42838186,2023-02-10,-149.19,168.13999999999993
1080,42882563,2023-01-31,0.0,419.69
7379,42882563,2023-02-07,-77.43,342.26
1081,42889744,2023-01-31,0.0,223.01
2981,42889744,2023-02-02,98.78,321.78999999999996
4944,42889744,2023-02-03,-175.68,146.10999999999999
2982,42889744,2023-02-04,160.12,306.23
1082,43017336,2023-01-31,0.0,935.99
4059,43017336,2023-02-03,-152.86,783.13
4060,43017336,2023-02-12,-122.62,660.51
8620,43017336,2023-02-13,196.46,856.97
4061,43017336,2023-02-14,-96.78,760.19
1083,43017598,2023-01-31,0.0,151.6
2723,43017598,2023-02-02,-148.35,3.25
2724,43017598,2023-02-07,-64.08,-60.83000000000001
7551,43017598,2023-02-07,164.87,104.03999999999999
2725,43017598,2023-02-10,-39.22,64.82
2726,43017598,2023-02-12,-158.31,-93.49000000000001
2727,43017598,2023-02-13,-77.47,-170.96
7552,43017598,2023-02-13,75.37,-95.59
2728,43017598,2023-02-14,-64.61,-160.20000000000002
1084,43032836,2023-01-31,0.0,386.83
463,43032836,2023-02-01,-52.56,334.27
1050,43032836,2023-02-01,132.52,466.78999999999996
1049,43032836,2023-02-01,137.9,604.69
1051,43032836,2023-02-02,148.04,752.73
1053,43032836,2023-02-03,56.07,808.8
1052,43032836,2023-02-03,136.92,945.72
464,43032836,2023-02-04,-49.53,896.19
466,43032836,2023-02-09,-130.36,765.8299999999999
465,43032836,2023-02-09,-42.5,723.3299999999999
1085,43064169,2023-01-31,0.0,555.44
2511,43064169,2023-02-02,27.69,583.1300000000001
3810,43064169,2023-02-03,-141.26,441.87000000000006
2512,43064169,2023-02-03,188.47,630.34
2513,43064169,2023-02-03,772.8,1403.1399999999999
2514,43064169,2023-02-05,974.8,2377.94
3811,43064169,2023-02-07,-124.55,2253.39
3812,43064169,2023-02-07,-109.58,2143.81
3813,43064169,2023-02-10,-1289.6,854.21
2515,43064169,2023-02-11,75.76,929.97
2516,43064169,2023-02-11,110.11,1040.08
3814,43064169,2023-02-13,-103.99,936.09
1086,43074888,2023-01-31,0.0,779.86
2281,43074888,2023-02-02,-130.94,648.9200000000001
6219,43074888,2023-02-05,6.73,655.65
6220,43074888,2023-02-05,112.03,767.6800000000001
6222,43074888,2023-02-11,104.39,872.07
6221,43074888,2023-02-11,991.6,1863.67
6223,43074888,2023-02-13,61.19,1924.8600000000001
1087,43080619,2023-01-31,0.0,426.64
4631,43080619,2023-02-03,-22.57,404.07
6135,43080619,2023-02-05,17.93,422.0
4632,43080619,2023-02-08,-53.32,368.68
4633,43080619,2023-02-09,-112.69,255.98999999999998
6136,43080619,2023-02-13,84.91,340.9
1088,43140934,2023-01-31,0.0,820.81
6202,43140934,2023-02-05,-57.87,762.9399999999999
6250,43140934,2023-02-05,160.91,923.8499999999999
6203,43140934,2023-02-10,-150.39,773.4599999999999
6204,43140934,2023-02-14,-58.12,715.3399999999999
6251,43140934,2023-02-14,97.09,812.43
1089,43257373,2023-01-31,0.0,483.49
5435,43257373,2023-02-04,-135.72,347.77
5097,43257373,2023-02-04,46.93,394.70000000000005
5436,43257373,2023-02-06,-117.11,277.59000000000003
5098,43257373,2023-02-06,116.91,394.5
5099,43257373,2023-02-09,96.17,490.67
5437,43257373,2023-02-12,-129.61,361.06
1090,43265708,2023-01-31,0.0,814.0
3857,43265708,2023-02-03,179.75,993.75
3858,43265708,2023-02-04,95.37,1089.12
3859,43265708,2023-02-13,65.62,1154.74
3860,43265708,2023-02-14,117.3,1272.04
1091,43312288,2023-01-31,0.0,830.91
2914,43312288,2023-02-02,-152.95,677.96
2915,43312288,2023-02-04,-72.87,605.0899999999999
2916,43312288,2023-02-05,-84.4,520.6899999999999
7811,43312288,2023-02-08,110.55,631.24
7812,43312288,2023-02-13,66.09,697.3299999999999
2917,43312288,2023-02-14,-132.36,564.97
1092,43329727,2023-01-31,0.0,477.69
5914,43329727,2023-02-04,-1231.2,-753.51
5915,43329727,2023-02-04,-96.31,-849.8199999999999
5916,43329727,2023-02-07,-141.01,-990.8299999999999
7286,43329727,2023-02-07,144.16,-846.6700000000001
7287,43329727,2023-02-08,99.49,-747.1800000000001
7288,43329727,2023-02-13,42.54,-704.6400000000001
1093,43330367,2023-01-31,0.0,172.38
3521,43330367,2023-02-02,-52.78,119.6
6690,43330367,2023-02-06,88.52,208.12
3522,43330367,2023-02-10,-182.81,25.310000000000002
6691,43330367,2023-02-11,24.9,50.21000000000001
6692,43330367,2023-02-13,87.2,137.41
1094,43338400,2023-01-31,0.0,783.12
1858,43338400,2023-02-01,-80.7,702.42
1859,43338400,2023-02-04,-134.81,567.61
7728,43338400,2023-02-08,98.38,665.99
7729,43338400,2023-02-08,147.81,813.8
7730,43338400,2023-02-14,2197.2,3010.9999999999995
1095,43354643,2023-01-31,0.0,863.38
3515,43354643,2023-02-02,105.59,968.97
6919,43354643,2023-02-06,-51.69,917.28
3516,43354643,2023-02-10,98.85,1016.13
3517,43354643,2023-02-11,125.91,1142.04
1096,43365633,2023-01-31,0.0,57.11
7235,43365633,2023-02-07,-27.88,29.23
7236,43365633,2023-02-10,-107.66,-78.42999999999999
8639,43365633,2023-02-13,111.43,33.000000000000014
1097,43368978,2023-01-31,0.0,133.07
1915,43368978,2023-02-01,55.49,188.56
7009,43368978,2023-02-06,-202.83,-14.27000000000001
7010,43368978,2023-02-06,-172.68,-186.95
1916,43368978,2023-02-11,64.21,-122.74000000000001
1098,43387803,2023-01-31,0.0,646.4
3106,43387803,2023-02-02,57.84,704.24
3107,43387803,2023-02-03,50.38,754.62
6317,43387803,2023-02-05,-81.21,673.41
3108,43387803,2023-02-05,23.02,696.43
3109,43387803,2023-02-05,128.94,825.37
3110,43387803,2023-02-06,71.54,896.9100000000001
6318,43387803,2023-02-10,-249.81,647.1
6319,43387803,2023-02-10,-113.99,533.11
6320,43387803,2023-02-11,-139.14,393.97
3111,43387803,2023-02-14,141.17,535.14
1099,43417466,2023-01-31,0.0,874.02
1941,43417466,2023-02-01,66.84,940.86
7603,43417466,2023-02-07,-84.97,855.89
7604,43417466,2023-02-12,-153.64,702.25
7605,43417466,2023-02-14,-195.84,506.40999999999997
1100,43420385,2023-01-31,0.0,881.49
2441,43420385,2023-02-02,117.9,999.39
6898,43420385,2023-02-06,-71.0,928.39
2442,43420385,2023-02-07,52.52,980.9100000000001
6899,43420385,2023-02-09,-83.64,897.27
2444,43420385,2023-02-09,129.19,1026.46
2443,43420385,2023-02-09,1522.7,2549.16
1101,43453543,2023-01-31,0.0,890.67
1579,43453543,2023-02-01,-98.39,792.28
3478,43453543,2023-02-02,75.16,867.4399999999999
3479,43453543,2023-02-10,130.32,997.76
3480,43453543,2023-02-12,72.09,1069.85
1102,43490748,2023-01-31,0.0,807.92
934,43490748,2023-02-01,-143.86,664.06
7684,43490748,2023-02-07,173.42,837.4799999999999
7685,43490748,2023-02-08,66.93,904.41
7686,43490748,2023-02-10,135.0,1039.4099999999999
936,43490748,2023-02-13,-102.44,936.9699999999999
935,43490748,2023-02-13,-82.37,854.5999999999999
7687,43490748,2023-02-14,77.21,931.81
1103,43499771,2023-01-31,0.0,28.4
243,43499771,2023-02-01,78.47,106.87
7042,43499771,2023-02-06,-65.08,41.79
244,43499771,2023-02-06,77.81,119.6
245,43499771,2023-02-06,1003.2,1122.8000000000002
7043,43499771,2023-02-07,-149.48,973.32
7044,43499771,2023-02-07,-75.13,898.19
7045,43499771,2023-02-11,-118.35,779.84
246,43499771,2023-02-11,143.86,923.7000000000002
7046,43499771,2023-02-12,-157.02,766.6800000000001
7047,43499771,2023-02-12,-154.74,611.94
247,43499771,2023-02-14,228.87,840.8100000000001
1104,43541008,2023-01-31,0.0,413.2
1099,43541008,2023-02-01,105.55,518.75
6445,43541008,2023-02-05,-1144.8,-626.05
6444,43541008,2023-02-05,-56.72,-682.77
6446,43541008,2023-02-11,-42.48,-725.25
1100,43541008,2023-02-13,73.96,-651.29
1105,43597919,2023-01-31,0.0,906.64
4821,43597919,2023-02-03,-95.54,811.1
4822,43597919,2023-02-06,-944.2,-133.10000000000002
7093,43597919,2023-02-06,144.03,10.92999999999995
7094,43597919,2023-02-07,1610.4,1621.33
4823,43597919,2023-02-08,-87.01,1534.3200000000002
4824,43597919,2023-02-12,-114.06,1420.26
7095,43597919,2023-02-12,1323.4,2743.66
7096,43597919,2023-02-14,44.44,2788.1
1106,43616790,2023-01-31,0.0,365.67
2180,43616790,2023-02-02,62.33,428.0
2181,43616790,2023-02-05,61.68,489.68
6730,43616790,2023-02-06,-154.24,335.44
2182,43616790,2023-02-07,139.63,475.07
2184,43616790,2023-02-08,36.72,511.78999999999996
2183,43616790,2023-02-08,943.5,1455.29
6731,43616790,2023-02-09,-1705.6,-250.31
2185,43616790,2023-02-09,74.39,-175.92000000000002
2186,43616790,2023-02-13,104.18,-71.74000000000001
1107,43623061,2023-01-31,0.0,724.39
2296,43623061,2023-02-02,1502.2,2226.59
5729,43623061,2023-02-04,-75.48,2151.11
2297,43623061,2023-02-11,331.8,2482.91
5730,43623061,2023-02-12,-76.84,2406.07
2298,43623061,2023-02-12,66.33,2472.4
5731,43623061,2023-02-13,-129.32,2343.08
5733,43623061,2023-02-14,-124.19,2218.89
5732,43623061,2023-02-14,-49.38,2169.51
1108,43772330,2023-01-31,0.0,701.52
3849,43772330,2023-02-03,-169.95,531.5699999999999
3850,43772330,2023-02-05,-143.73,387.84000000000003
3851,43772330,2023-02-06,-97.33,290.51
7746,43772330,2023-02-08,65.49,356.0
7747,43772330,2023-02-10,98.76,454.76
7748,43772330,2023-02-11,90.71,545.47
7749,43772330,2023-02-12,45.77,591.24
1109,43781476,2023-01-31,0.0,28.83
1145,43781476,2023-02-01,128.49,157.32
1146,43781476,2023-02-02,56.3,213.62
1147,43781476,2023-02-02,115.98,329.59999999999997
1148,43781476,2023-02-04,143.83,473.43
1149,43781476,2023-02-06,45.55,518.98
7902,43781476,2023-02-08,-943.5,-424.52
7903,43781476,2023-02-08,-52.3,-476.82
1150,43781476,2023-02-13,153.14,-323.68
1110,43811112,2023-01-31,0.0,99.92
3248,43811112,2023-02-02,-97.69,2.230000000000004
6007,43811112,2023-02-05,5.44,7.670000000000002
6008,43811112,2023-02-07,1760.8,1768.47
3250,43811112,2023-02-08,-136.68,1631.79
3249,43811112,2023-02-08,-99.77,1532.02
3251,43811112,2023-02-09,-1485.0,47.01999999999991
3252,43811112,2023-02-10,-52.93,-5.910000000000096
6009,43811112,2023-02-13,65.54,59.629999999999924
6010,43811112,2023-02-14,93.12,152.74999999999994
1111,43830772,2023-01-31,0.0,158.17
4856,43830772,2023-02-03,89.74,247.90999999999997
1112,43843937,2023-01-31,0.0,79.03
6889,43843937,2023-02-06,67.96,146.99
6890,43843937,2023-02-09,940.9,1087.89
6891,43843937,2023-02-10,155.28,1243.17
6892,43843937,2023-02-11,518.1,1761.27
6893,43843937,2023-02-13,901.5,2662.77
1113,43858112,2023-01-31,0.0,641.78
665,43858112,2023-02-01,-102.95,538.8299999999999
666,43858112,2023-02-02,-39.75,499.08
667,43858112,2023-02-04,-49.6,449.47999999999996
5167,43858112,2023-02-04,77.7,527.18
668,43858112,2023-02-05,-65.82,461.36
669,43858112,2023-02-08,-99.49,361.87
670,43858112,2023-02-13,-118.46,243.40999999999997
5168,43858112,2023-02-13,90.0,333.40999999999997
671,43858112,2023-02-14,-170.78,162.63
5169,43858112,2023-02-14,171.25,333.88
1114,43860538,2023-01-31,0.0,478.05
2678,43860538,2023-02-02,-89.8,388.25
7855,43860538,2023-02-08,69.75,458.0
2679,43860538,2023-02-12,-53.98,404.02
1115,43892675,2023-01-31,0.0,997.95
5039,43892675,2023-02-03,64.03,1061.98
7459,43892675,2023-02-07,-150.57,911.4100000000001
7460,43892675,2023-02-08,-80.77,830.6400000000001
7461,43892675,2023-02-14,-53.35,777.2900000000001
1116,43930935,2023-01-31,0.0,651.22
5657,43930935,2023-02-04,-120.69,530.53
5658,43930935,2023-02-04,-21.78,508.75
5659,43930935,2023-02-09,-63.04,445.71000000000004
8584,43930935,2023-02-12,69.99,515.7
5660,43930935,2023-02-14,-82.7,433.0
1117,43979238,2023-01-31,0.0,68.08
959,43979238,2023-02-01,170.96,239.04000000000002
4732,43979238,2023-02-03,-64.85,174.19
960,43979238,2023-02-03,49.39,223.57999999999998
961,43979238,2023-02-04,115.27,338.84999999999997
4733,43979238,2023-02-06,-178.37,160.48000000000002
962,43979238,2023-02-12,1486.8,1647.28
1118,44007497,2023-01-31,0.0,331.92
4822,44007497,2023-02-03,41.22,373.14
6182,44007497,2023-02-05,-87.07,286.07000000000005
6183,44007497,2023-02-06,-39.91,246.16000000000003
6184,44007497,2023-02-07,-54.52,191.64000000000001
4824,44007497,2023-02-08,61.39,253.03000000000003
4823,44007497,2023-02-08,88.74,341.77
1119,44009985,2023-01-31,0.0,763.43
2880,44009985,2023-02-02,13.68,777.1099999999999
7946,44009985,2023-02-08,-946.2,-169.09000000000015
2881,44009985,2023-02-10,905.0,735.9099999999999
7947,44009985,2023-02-11,-60.05,675.8599999999999
2882,44009985,2023-02-11,102.26,778.1199999999999
2883,44009985,2023-02-13,106.6,884.7199999999998
7948,44009985,2023-02-14,-104.91,779.8099999999998
1120,44019515,2023-01-31,0.0,312.63
3564,44019515,2023-02-02,116.25,428.88
5250,44019515,2023-02-04,-151.32,277.56
5252,44019515,2023-02-06,-102.12,175.44
5251,44019515,2023-02-06,-38.7,136.74
3565,44019515,2023-02-07,1159.5,1296.24
3566,44019515,2023-02-09,80.13,1376.37
3567,44019515,2023-02-13,101.48,1477.85
1121,44066457,2023-01-31,0.0,18.09
4890,44066457,2023-02-03,-92.94,-74.85
4506,44066457,2023-02-03,78.92,4.070000000000004
4507,44066457,2023-02-03,1179.0,1183.07
4508,44066457,2023-02-04,21.78,1204.85
4509,44066457,2023-02-05,102.9,1307.75
4510,44066457,2023-02-11,103.18,1410.93
4891,44066457,2023-02-13,-1226.1,184.83000000000024
4892,44066457,2023-02-14,-149.95,34.88000000000025
4893,44066457,2023-02-14,-51.9,-17.01999999999975
4511,44066457,2023-02-14,156.38,139.36000000000024
1122,44075619,2023-01-31,0.0,979.0
6215,44075619,2023-02-05,217.15,1196.15
7797,44075619,2023-02-08,-108.51,1087.64
7798,44075619,2023-02-08,-83.96,1003.6800000000001
6216,44075619,2023-02-09,97.39,1101.07
6218,44075619,2023-02-10,50.52,1151.59
6217,44075619,2023-02-10,92.21,1243.8
7799,44075619,2023-02-12,-78.89,1164.91
1123,44130477,2023-01-31,0.0,918.0
5279,44130477,2023-02-04,-66.17,851.83
5236,44130477,2023-02-04,622.4,1474.23
5237,44130477,2023-02-08,129.87,1604.1
5238,44130477,2023-02-08,137.66,1741.76
5280,44130477,2023-02-12,-36.64,1705.12
1124,44133867,2023-01-31,0.0,358.61
4444,44133867,2023-02-03,169.26,527.87
5291,44133867,2023-02-04,-91.11,436.76
4445,44133867,2023-02-11,851.2,1287.96
4446,44133867,2023-02-14,26.02,1313.98
1125,44140049,2023-01-31,0.0,372.02
6819,44140049,2023-02-06,-49.33,322.69
6820,44140049,2023-02-10,-114.57,208.12
8190,44140049,2023-02-10,84.47,292.59
6821,44140049,2023-02-11,-89.98,202.60999999999999
8191,44140049,2023-02-11,122.35,324.96
8192,44140049,2023-02-13,77.8,402.76
1126,44145489,2023-01-31,0.0,635.75
4985,44145489,2023-02-03,87.5,723.25
4986,44145489,2023-02-06,51.69,774.94
8326,44145489,2023-02-10,-79.08,695.86
8327,44145489,2023-02-11,-55.33,640.53
8328,44145489,2023-02-12,-1003.7,-363.1700000000001
1127,44162563,2023-01-31,0.0,325.77
8046,44162563,2023-02-09,-1162.9,-837.1300000000001
8047,44162563,2023-02-11,-41.42,-878.5500000000002
8048,44162563,2023-02-14,-102.55,-981.1000000000001
1128,44164363,2023-01-31,0.0,998.43
2548,44164363,2023-02-02,82.72,1081.1499999999999
2547,44164363,2023-02-02,164.6,1245.75
4605,44164363,2023-02-03,-155.02,1090.73
4606,44164363,2023-02-06,-51.71,1039.02
4607,44164363,2023-02-09,-72.19,966.8299999999999
1129,44228646,2023-01-31,0.0,651.3
4793,44228646,2023-02-03,-53.78,597.52
4574,44228646,2023-02-03,129.77,727.29
4575,44228646,2023-02-04,1315.2,2042.49
4576,44228646,2023-02-05,112.01,2154.5
4577,44228646,2023-02-05,1144.8,3299.3
4578,44228646,2023-02-07,36.15,3335.45
4579,44228646,2023-02-08,105.88,3441.33
4580,44228646,2023-02-08,1244.2,4685.53
4794,44228646,2023-02-09,-101.37,4584.16
4581,44228646,2023-02-10,46.55,4630.71
4795,44228646,2023-02-12,-169.44,4461.27
1130,44234432,2023-01-31,0.0,399.17
1597,44234432,2023-02-01,-127.46,271.71000000000004
6997,44234432,2023-02-06,82.67,354.38
1598,44234432,2023-02-07,-46.31,308.07000000000005
1599,44234432,2023-02-08,-90.88,217.19000000000003
6998,44234432,2023-02-09,95.64,312.83000000000004
6999,44234432,2023-02-09,156.08,468.91
7000,44234432,2023-02-10,180.0,648.9100000000001
7001,44234432,2023-02-11,10.99,659.9000000000001
7002,44234432,2023-02-12,140.79,800.69
1600,44234432,2023-02-14,-191.09,609.6
1131,44239230,2023-01-31,0.0,390.94
98,44239230,2023-02-01,-189.46,201.48
99,44239230,2023-02-06,-68.72,132.76
1132,44242297,2023-01-31,0.0,388.02
1316,44242297,2023-02-01,-136.95,251.07
4298,44242297,2023-02-03,195.91,446.98
4299,44242297,2023-02-05,962.0,1408.98
4300,44242297,2023-02-09,170.19,1579.17
4301,44242297,2023-02-10,46.07,1625.24
4302,44242297,2023-02-11,102.02,1727.26
4304,44242297,2023-02-12,124.55,1851.81
4303,44242297,2023-02-12,1003.7,2855.51
4305,44242297,2023-02-13,147.05,3002.56
4306,44242297,2023-02-14,179.57,3182.13
1133,44243236,2023-01-31,0.0,797.95
560,44243236,2023-02-01,-54.25,743.7
3054,44243236,2023-02-02,108.85,852.5500000000001
3055,44243236,2023-02-04,51.81,904.36
561,44243236,2023-02-11,-123.03,781.33
3056,44243236,2023-02-12,966.7,1748.0300000000002
3057,44243236,2023-02-14,137.37,1885.4
1134,44272912,2023-01-31,0.0,448.18
155,44272912,2023-02-01,-142.26,305.92
157,44272912,2023-02-07,-89.09,216.83
156,44272912,2023-02-07,-18.61,198.22000000000003
7564,44272912,2023-02-07,742.8,941.02
7565,44272912,2023-02-08,113.46,1054.48
158,44272912,2023-02-09,-157.69,896.79
7567,44272912,2023-02-09,38.09,934.8799999999999
7566,44272912,2023-02-09,78.16,1013.04
7568,44272912,2023-02-11,63.8,1076.84
7569,44272912,2023-02-12,882.7,1959.5400000000002
159,44272912,2023-02-14,-118.75,1840.7900000000002
1135,44281556,2023-01-31,0.0,70.7
2096,44281556,2023-02-01,-117.4,-46.7
7917,44281556,2023-02-08,58.6,11.899999999999999
1136,44310966,2023-01-31,0.0,361.02
3423,44310966,2023-02-02,107.8,468.82
4050,44310966,2023-02-03,-136.66,332.15999999999997
3424,44310966,2023-02-05,137.15,469.31
4051,44310966,2023-02-07,-41.35,427.96
4052,44310966,2023-02-09,-117.9,310.05999999999995
3425,44310966,2023-02-13,113.3,423.35999999999996
4053,44310966,2023-02-14,-0.36,423.0
1137,44317934,2023-01-31,0.0,920.21
1536,44317934,2023-02-01,1888.2,2808.41
2955,44317934,2023-02-02,-162.4,2646.01
2956,44317934,2023-02-10,-206.87,2439.1400000000003
1537,44317934,2023-02-13,117.77,2556.91
1138,44331942,2023-01-31,0.0,389.13
2903,44331942,2023-02-02,225.34,614.47
2904,44331942,2023-02-03,60.47,674.94
2905,44331942,2023-02-04,49.6,724.54
2906,44331942,2023-02-12,169.34,893.88
1139,44358901,2023-01-31,0.0,576.73
1056,44358901,2023-02-01,-144.31,432.42
2661,44358901,2023-02-02,137.17,569.59
1057,44358901,2023-02-03,-117.51,452.08
2662,44358901,2023-02-04,73.67,525.75
2663,44358901,2023-02-08,1805.6,2331.35
2664,44358901,2023-02-10,75.3,2406.6499999999996
1058,44358901,2023-02-11,-40.81,2365.84
2665,44358901,2023-02-12,88.66,2454.5
1140,44364430,2023-01-31,0.0,306.44
2057,44364430,2023-02-01,-65.61,240.82999999999998
2058,44364430,2023-02-09,-142.44,98.38999999999999
8502,44364430,2023-02-11,87.14,185.52999999999997
8503,44364430,2023-02-11,116.14,301.66999999999996
8504,44364430,2023-02-13,216.37,518.04
1141,44368280,2023-01-31,0.0,291.54
3906,44368280,2023-02-03,13.52,305.06
8089,44368280,2023-02-09,-46.29,258.77000000000004
8090,44368280,2023-02-11,-92.54,166.23000000000002
8091,44368280,2023-02-11,-84.29,81.94
3907,44368280,2023-02-12,19.56,101.5
1142,44378133,2023-01-31,0.0,721.21
975,44378133,2023-02-01,-12.5,708.71
2094,44378133,2023-02-02,123.2,831.9100000000001
2095,44378133,2023-02-03,66.09,898.0
2096,44378133,2023-02-03,100.38,998.3800000000001
2097,44378133,2023-02-08,44.49,1042.8700000000001
976,44378133,2023-02-11,-633.2,409.67
977,44378133,2023-02-12,-197.45,212.22000000000003
979,44378133,2023-02-14,-107.51,104.71000000000004
978,44378133,2023-02-14,-102.06,2.6499999999999773
1143,44389169,2023-01-31,0.0,978.69
5595,44389169,2023-02-04,-51.81,926.8800000000001
5596,44389169,2023-02-10,-135.0,791.8800000000001
5597,44389169,2023-02-10,-103.67,688.21
1144,44413402,2023-01-31,0.0,75.55
2833,44413402,2023-02-02,23.22,98.77
2834,44413402,2023-02-08,140.73,239.5
8451,44413402,2023-02-11,-126.93,112.56999999999998
1145,44427272,2023-01-31,0.0,970.1
1165,44427272,2023-02-01,-174.19,795.9100000000001
2387,44427272,2023-02-02,2.63,798.54
2388,44427272,2023-02-05,108.26,906.8000000000001
2389,44427272,2023-02-07,97.67,1004.47
1166,44427272,2023-02-10,-15.31,989.1600000000001
1146,44474369,2023-01-31,0.0,663.93
8077,44474369,2023-02-09,-97.79,566.14
8114,44474369,2023-02-09,64.46,630.5999999999999
8078,44474369,2023-02-10,-71.41,559.1899999999999
8079,44474369,2023-02-11,-120.57,438.61999999999995
8116,44474369,2023-02-12,69.4,508.02
8115,44474369,2023-02-12,80.58,588.5999999999999
1147,44516940,2023-01-31,0.0,930.17
79,44516940,2023-02-01,-182.19,747.98
80,44516940,2023-02-06,-172.27,575.7099999999999
7861,44516940,2023-02-08,209.01,784.7199999999999
81,44516940,2023-02-09,-12.71,772.01
82,44516940,2023-02-12,-67.31,704.6999999999999
7863,44516940,2023-02-12,58.82,763.52
7862,44516940,2023-02-12,165.18,928.6999999999999
1148,44537960,2023-01-31,0.0,675.03
701,44537960,2023-02-01,-168.84,506.18999999999994
2788,44537960,2023-02-02,95.09,601.28
702,44537960,2023-02-06,-135.04,466.24
2789,44537960,2023-02-06,147.34,613.5799999999999
703,44537960,2023-02-09,-187.78,425.79999999999995
704,44537960,2023-02-10,-72.06,353.74
705,44537960,2023-02-12,-192.75,160.99
706,44537960,2023-02-13,-116.22,44.76999999999998
1149,44564500,2023-01-31,0.0,355.18
1380,44564500,2023-02-01,215.02,570.2
1381,44564500,2023-02-03,67.38,637.5799999999999
1382,44564500,2023-02-06,34.38,671.96
1383,44564500,2023-02-10,67.6,739.56
1150,44586370,2023-01-31,0.0,440.56
2161,44586370,2023-02-02,-84.65,355.90999999999997
2162,44586370,2023-02-06,-42.82,313.09000000000003
2163,44586370,2023-02-06,-40.91,272.18
7429,44586370,2023-02-07,77.43,349.61
7430,44586370,2023-02-07,1500.0,1849.61
2164,44586370,2023-02-08,-166.36,1683.25
7431,44586370,2023-02-12,117.51,1800.76
2165,44586370,2023-02-13,-105.71,1695.05
2166,44586370,2023-02-14,-52.78,1642.27
7432,44586370,2023-02-14,69.01,1711.28
1151,44626164,2023-01-31,0.0,915.14
7545,44626164,2023-02-07,65.37,980.51
8212,44626164,2023-02-09,-1166.4,-185.8900000000002
8213,44626164,2023-02-14,-124.79,-310.6800000000002
1152,44662337,2023-01-31,0.0,768.12
1390,44662337,2023-02-01,119.68,887.8
8143,44662337,2023-02-09,-140.49,747.31
1391,44662337,2023-02-14,162.09,909.4
1153,44701536,2023-01-31,0.0,995.4
120,44701536,2023-02-01,-76.18,919.22
121,44701536,2023-02-06,-151.44,767.78
122,44701536,2023-02-08,-117.22,650.56
7876,44701536,2023-02-08,110.6,761.16
123,44701536,2023-02-10,-117.1,644.06
124,44701536,2023-02-11,-75.88,568.18
1154,44711172,2023-01-31,0.0,382.83
3473,44711172,2023-02-02,-174.75,208.07999999999998
5745,44711172,2023-02-04,141.33,349.40999999999997
5744,44711172,2023-02-04,150.01,499.41999999999996
3474,44711172,2023-02-08,-81.17,418.25
5746,44711172,2023-02-13,8.94,427.19
1155,44759468,2023-01-31,0.0,962.91
1226,44759468,2023-02-01,-97.92,864.99
5491,44759468,2023-02-04,141.71,1006.6999999999999
5492,44759468,2023-02-07,84.46,1091.1599999999999
1227,44759468,2023-02-09,-35.18,1055.98
1228,44759468,2023-02-10,-105.35,950.63
5493,44759468,2023-02-10,74.15,1024.78
1229,44759468,2023-02-11,-34.81,989.97
1230,44759468,2023-02-12,-169.36,820.6099999999999
1231,44759468,2023-02-13,-110.34,710.27
1156,44794340,2023-01-31,0.0,488.91
8611,44794340,2023-02-13,-71.54,417.37
1157,44812075,2023-01-31,0.0,863.71
1966,44812075,2023-02-01,601.7,1465.41
2670,44812075,2023-02-02,-108.51,1356.9
1967,44812075,2023-02-02,116.1,1473.0
1968,44812075,2023-02-06,127.59,1600.5900000000001
1969,44812075,2023-02-12,127.27,1727.8600000000001
1970,44812075,2023-02-13,64.31,1792.17
1158,44816910,2023-01-31,0.0,185.51
825,44816910,2023-02-01,229.8,415.31
826,44816910,2023-02-04,89.58,504.89
6593,44816910,2023-02-05,-147.37,357.52
6594,44816910,2023-02-05,-9.05,348.46999999999997
827,44816910,2023-02-05,56.62,405.09
828,44816910,2023-02-06,30.45,435.53999999999996
829,44816910,2023-02-07,756.5,1192.04
830,44816910,2023-02-08,110.8,1302.84
6595,44816910,2023-02-13,-118.4,1184.44
6596,44816910,2023-02-13,-32.01,1152.4299999999998
1159,44873253,2023-01-31,0.0,660.51
3769,44873253,2023-02-03,8.57,669.08
3770,44873253,2023-02-03,60.33,729.41
6290,44873253,2023-02-05,-93.57,635.84
6291,44873253,2023-02-07,-113.43,522.41
6293,44873253,2023-02-10,-192.26,330.15
6292,44873253,2023-02-10,-93.74,236.41000000000003
3771,44873253,2023-02-11,726.2,962.6100000000001
1160,44902994,2023-01-31,0.0,790.34
1384,44902994,2023-02-01,85.77,876.11
2759,44902994,2023-02-02,-174.13,701.98
2762,44902994,2023-02-03,-1259.6,-557.6199999999998
2761,44902994,2023-02-03,-58.23,-615.8499999999998
2760,44902994,2023-02-03,-31.0,-646.8499999999998
1385,44902994,2023-02-03,23.84,-623.0099999999999
1387,44902994,2023-02-04,76.17,-546.8399999999998
1386,44902994,2023-02-04,94.29,-452.54999999999984
1388,44902994,2023-02-05,99.16,-353.38999999999976
2763,44902994,2023-02-06,-28.63,-382.01999999999987
1389,44902994,2023-02-08,117.41,-264.6099999999998
2764,44902994,2023-02-13,-61.69,-326.29999999999984
1161,44912164,2023-01-31,0.0,355.61
4781,44912164,2023-02-03,-110.67,244.94
4782,44912164,2023-02-05,-29.75,215.19
4783,44912164,2023-02-07,-50.93,164.26000000000002
8552,44912164,2023-02-12,25.82,190.08
4784,44912164,2023-02-13,-128.76,61.32000000000005
8553,44912164,2023-02-14,49.38,110.70000000000002
8554,44912164,2023-02-14,157.43,268.13
1162,45015534,2023-01-31,0.0,215.54
6715,45015534,2023-02-06,-154.92,60.620000000000005
7485,45015534,2023-02-07,76.2,136.82
7486,45015534,2023-02-08,1032.4,1169.22
7487,45015534,2023-02-09,83.42,1252.64
1163,45015570,2023-01-31,0.0,905.57
309,45015570,2023-02-01,137.72,1043.29
308,45015570,2023-02-01,754.9,1798.19
6985,45015570,2023-02-06,-98.87,1699.3200000000002
6986,45015570,2023-02-06,-72.7,1626.62
310,45015570,2023-02-07,136.3,1762.92
6987,45015570,2023-02-08,-150.64,1612.2800000000002
6988,45015570,2023-02-09,-145.82,1466.46
311,45015570,2023-02-13,159.89,1626.35
312,45015570,2023-02-14,176.37,1802.7200000000003
1164,45020832,2023-01-31,0.0,104.89
3314,45020832,2023-02-02,92.05,196.94
3315,45020832,2023-02-03,89.95,286.89
6278,45020832,2023-02-05,-158.24,128.64999999999998
3316,45020832,2023-02-09,110.01,238.65999999999997
3317,45020832,2023-02-11,16.09,254.75
3318,45020832,2023-02-11,42.85,297.59999999999997
1165,45021115,2023-01-31,0.0,464.27
7588,45021115,2023-02-07,116.04,580.31
7766,45021115,2023-02-08,-189.71,390.59999999999997
7590,45021115,2023-02-10,62.01,452.60999999999996
7589,45021115,2023-02-10,125.47,578.0799999999999
7591,45021115,2023-02-11,1813.6,2391.68
7592,45021115,2023-02-12,41.2,2432.88
7767,45021115,2023-02-13,-18.93,2413.95
1166,45021398,2023-01-31,0.0,783.24
3622,45021398,2023-02-02,77.43,860.6700000000001
3623,45021398,2023-02-04,515.6,1376.27
7920,45021398,2023-02-08,-68.68,1307.5900000000001
7922,45021398,2023-02-10,-344.3,963.2900000000001
7921,45021398,2023-02-10,-72.23,891.0600000000001
3624,45021398,2023-02-10,108.64,999.7
1167,45026430,2023-01-31,0.0,745.31
5335,45026430,2023-02-04,178.94,924.25
7585,45026430,2023-02-07,-36.73,887.52
7586,45026430,2023-02-09,-148.45,739.0699999999999
7587,45026430,2023-02-10,-55.29,683.78
5336,45026430,2023-02-11,626.6,1310.38
7588,45026430,2023-02-13,-85.75,1224.63
1168,45027876,2023-01-31,0.0,80.13
468,45027876,2023-02-01,-170.25,-90.12
467,45027876,2023-02-01,-57.48,-147.6
695,45027876,2023-02-01,72.35,-75.25
469,45027876,2023-02-03,-79.86,-155.11
696,45027876,2023-02-04,176.15,21.04000000000002
470,45027876,2023-02-06,-80.8,-59.75999999999999
471,45027876,2023-02-07,-227.16,-286.91999999999996
697,45027876,2023-02-07,54.35,-232.56999999999994
472,45027876,2023-02-12,-3.07,-235.63999999999993
473,45027876,2023-02-14,-85.41,-321.04999999999995
1169,45029598,2023-01-31,0.0,558.87
6721,45029598,2023-02-06,-119.61,439.26
6722,45029598,2023-02-06,-67.0,372.26
6723,45029598,2023-02-08,-149.83,222.43
6724,45029598,2023-02-09,-64.47,157.96000000000004
8045,45029598,2023-02-09,70.47,228.43
8046,45029598,2023-02-09,76.46,304.89
8047,45029598,2023-02-12,7.46,312.35
6725,45029598,2023-02-14,-1338.4,-1026.0500000000002
8048,45029598,2023-02-14,42.19,-983.86
1170,45067158,2023-01-31,0.0,115.23
5040,45067158,2023-02-04,-102.44,12.790000000000006
5038,45067158,2023-02-04,-101.3,-88.51
5039,45067158,2023-02-04,-78.83,-167.33999999999997
5041,45067158,2023-02-05,-83.99,-251.32999999999998
6520,45067158,2023-02-05,106.32,-145.01
6521,45067158,2023-02-09,184.91,39.90000000000002
6522,45067158,2023-02-10,177.19,217.09000000000003
6523,45067158,2023-02-11,90.72,307.81
1171,45089475,2023-01-31,0.0,676.92
4774,45089475,2023-02-03,-119.64,557.28
4775,45089475,2023-02-13,-1582.4,-1025.1200000000003
4776,45089475,2023-02-13,-125.97,-1151.0900000000001
1172,45111669,2023-01-31,0.0,459.28
920,45111669,2023-02-01,121.91,581.1899999999999
921,45111669,2023-02-03,16.43,597.62
8371,45111669,2023-02-10,-116.33,481.28999999999996
8372,45111669,2023-02-11,-84.36,396.92999999999995
8373,45111669,2023-02-14,-173.04,223.89
1173,45161114,2023-01-31,0.0,282.6
1158,45161114,2023-02-01,134.43,417.03000000000003
1159,45161114,2023-02-06,132.91,549.94
1160,45161114,2023-02-10,126.15,676.09
1174,45196342,2023-01-31,0.0,402.48
2132,45196342,2023-02-01,-64.89,337.59000000000003
2133,45196342,2023-02-03,-104.89,232.70000000000002
5697,45196342,2023-02-04,136.46,369.16
5698,45196342,2023-02-10,120.91,490.07000000000005
2134,45196342,2023-02-11,-112.23,377.84000000000003
2135,45196342,2023-02-12,-1192.7,-814.8600000000001
1175,45238909,2023-01-31,0.0,904.83
5538,45238909,2023-02-04,120.85,1025.68
7901,45238909,2023-02-08,-38.91,986.77
5539,45238909,2023-02-08,751.9,1738.67
5540,45238909,2023-02-13,133.97,1872.64
1176,45242171,2023-01-31,0.0,174.66
5494,45242171,2023-02-04,84.12,258.78
8112,45242171,2023-02-09,-93.14,165.64
5495,45242171,2023-02-13,73.31,238.95
1177,45253870,2023-01-31,0.0,273.37
7265,45253870,2023-02-07,485.9,759.27
8411,45253870,2023-02-11,-78.2,681.0699999999999
7266,45253870,2023-02-12,142.98,824.05
1178,45275334,2023-01-31,0.0,49.55
2970,45275334,2023-02-02,112.23,161.78
4839,45275334,2023-02-03,-89.95,71.83
1179,45397824,2023-01-31,0.0,741.62
1197,45397824,2023-02-01,-130.8,610.8199999999999
3270,45397824,2023-02-02,177.51,788.3299999999999
1198,45397824,2023-02-03,-154.95,633.38
3271,45397824,2023-02-03,20.42,653.8
1199,45397824,2023-02-07,-113.55,540.25
3272,45397824,2023-02-11,46.65,586.9
3273,45397824,2023-02-12,134.97,721.87
1200,45397824,2023-02-14,-625.3,96.57000000000005
1180,45519330,2023-01-31,0.0,840.22
777,45519330,2023-02-01,-180.83,659.39
778,45519330,2023-02-01,-80.88,578.51
4182,45519330,2023-02-03,240.26,818.77
4183,45519330,2023-02-07,85.76,904.53
779,45519330,2023-02-11,-163.65,740.88
4184,45519330,2023-02-13,25.59,766.47
1181,45543867,2023-01-31,0.0,419.92
1368,45543867,2023-02-01,82.42,502.34000000000003
1369,45543867,2023-02-02,117.71,620.05
1371,45543867,2023-02-03,106.43,726.48
1370,45543867,2023-02-03,136.66,863.1400000000001
1372,45543867,2023-02-07,1522.0,2385.14
1373,45543867,2023-02-09,100.78,2485.92
8502,45543867,2023-02-11,-78.66,2407.26
1374,45543867,2023-02-13,562.4,2969.66
1182,45558696,2023-01-31,0.0,760.19
3524,45558696,2023-02-02,1890.0,2650.19
6370,45558696,2023-02-05,-1526.1,1124.0900000000001
6372,45558696,2023-02-07,-173.42,950.6700000000002
6371,45558696,2023-02-07,-144.93,805.7400000000001
3525,45558696,2023-02-07,42.19,847.9300000000002
6373,45558696,2023-02-08,-62.15,785.7800000000002
1183,45611838,2023-01-31,0.0,784.55
4532,45611838,2023-02-03,47.74,832.29
5783,45611838,2023-02-04,-53.51,778.78
4533,45611838,2023-02-04,46.49,825.27
5784,45611838,2023-02-06,-97.64,727.63
5785,45611838,2023-02-07,-69.22,658.41
4534,45611838,2023-02-09,173.88,832.29
4535,45611838,2023-02-14,122.61,954.9
1184,45631973,2023-01-31,0.0,762.7
542,45631973,2023-02-01,-187.01,575.69
5530,45631973,2023-02-04,109.43,685.1200000000001
543,45631973,2023-02-05,-220.0,465.12000000000006
544,45631973,2023-02-08,-1428.0,-962.8799999999999
5531,45631973,2023-02-09,105.79,-857.0899999999999
545,45631973,2023-02-11,-108.78,-965.8699999999999
1185,45639009,2023-01-31,0.0,489.05
5350,45639009,2023-02-04,-108.24,380.81
5351,45639009,2023-02-04,-72.72,308.09000000000003
5353,45639009,2023-02-05,-72.56,235.53000000000003
5352,45639009,2023-02-05,-5.44,230.09000000000003
5354,45639009,2023-02-09,-44.94,185.15000000000003
5355,45639009,2023-02-12,-114.03,71.12
8560,45639009,2023-02-12,205.26,276.38
1186,45688415,2023-01-31,0.0,686.92
1643,45688415,2023-02-01,1393.7,2080.62
1644,45688415,2023-02-03,178.47,2259.09
7590,45688415,2023-02-07,-121.91,2137.18
7591,45688415,2023-02-11,-135.48,2001.6999999999998
1645,45688415,2023-02-11,96.36,2098.06
1646,45688415,2023-02-13,102.31,2200.37
1187,45706674,2023-01-31,0.0,390.73
263,45706674,2023-02-01,-1187.7,-796.97
265,45706674,2023-02-04,-150.84,-947.81
264,45706674,2023-02-04,-141.31,-1089.1200000000001
5463,45706674,2023-02-04,114.54,-974.5799999999999
5464,45706674,2023-02-05,109.63,-864.95
266,45706674,2023-02-06,-60.77,-925.72
267,45706674,2023-02-10,-123.35,-1049.07
268,45706674,2023-02-12,-158.11,-1207.18
1188,45740727,2023-01-31,0.0,904.27
6196,45740727,2023-02-05,149.91,1054.18
7851,45740727,2023-02-08,-220.34,833.8399999999999
6197,45740727,2023-02-13,155.36,989.2
1189,45790907,2023-01-31,0.0,567.67
1273,45790907,2023-02-01,112.34,680.01
1272,45790907,2023-02-01,1264.3,1944.31
5608,45790907,2023-02-04,-45.53,1898.7799999999997
1274,45790907,2023-02-04,133.0,2031.7799999999997
1275,45790907,2023-02-05,58.28,2090.06
1276,45790907,2023-02-05,108.92,2198.98
5609,45790907,2023-02-07,-67.95,2131.0299999999997
5610,45790907,2023-02-10,-1275.4,855.6299999999998
5611,45790907,2023-02-12,-144.32,711.3099999999997
5612,45790907,2023-02-14,-67.85,643.4599999999998
1190,45816894,2023-01-31,0.0,227.68
2968,45816894,2023-02-02,-81.01,146.67000000000002
7877,45816894,2023-02-08,1006.9,1153.57
2969,45816894,2023-02-13,-152.58,1000.99
2970,45816894,2023-02-13,-44.84,956.1500000000001
1191,45822265,2023-01-31,0.0,881.34
2334,45822265,2023-02-02,-180.16,701.1800000000001
2335,45822265,2023-02-03,-113.78,587.4000000000001
2336,45822265,2023-02-05,-1152.5,-565.1
2337,45822265,2023-02-05,-617.7,-1182.8000000000002
6431,45822265,2023-02-05,99.15,-1083.65
2338,45822265,2023-02-11,-140.15,-1223.8000000000002
2339,45822265,2023-02-11,-86.28,-1310.08
6432,45822265,2023-02-12,877.5,-432.58000000000004
1192,45829157,2023-01-31,0.0,361.77
1479,45829157,2023-02-01,-147.6,214.17
1480,45829157,2023-02-03,-183.87,30.299999999999955
6365,45829157,2023-02-05,23.74,54.039999999999964
6366,45829157,2023-02-06,156.97,211.01
1481,45829157,2023-02-08,-80.46,130.55
6367,45829157,2023-02-10,114.0,244.55
6368,45829157,2023-02-12,89.04,333.59000000000003
1482,45829157,2023-02-14,-153.48,180.11
1193,45859156,2023-01-31,0.0,644.5
1929,45859156,2023-02-01,-146.02,498.48
2394,45859156,2023-02-02,120.32,618.8
2395,45859156,2023-02-05,166.03,784.8299999999999
2396,45859156,2023-02-07,102.22,887.05
2397,45859156,2023-02-10,1725.1,2612.1499999999996
1194,45960045,2023-01-31,0.0,853.47
4384,45960045,2023-02-03,49.28,902.75
4383,45960045,2023-02-03,128.1,1030.85
7506,45960045,2023-02-07,-45.38,985.47
4385,45960045,2023-02-09,120.08,1105.55
7508,45960045,2023-02-13,-48.13,1057.42
7507,45960045,2023-02-13,-35.47,1021.95
1195,45974864,2023-01-31,0.0,957.27
4644,45974864,2023-02-03,-108.6,848.67
8349,45974864,2023-02-10,120.81,969.48
8350,45974864,2023-02-13,63.85,1033.33
4645,45974864,2023-02-14,-43.42,989.91
1196,46012936,2023-01-31,0.0,120.79
3757,46012936,2023-02-03,46.59,167.38
5389,46012936,2023-02-04,-113.62,53.760000000000005
3758,46012936,2023-02-06,55.52,109.28
3759,46012936,2023-02-13,62.93,172.21
5390,46012936,2023-02-14,-175.07,-2.859999999999985
1197,46059921,2023-01-31,0.0,905.78
1223,46059921,2023-02-01,-95.21,810.5699999999999
1224,46059921,2023-02-02,-79.3,731.27
8378,46059921,2023-02-10,83.52,814.79
8379,46059921,2023-02-13,9.8,824.5899999999999
1225,46059921,2023-02-14,-147.85,676.74
1198,46064017,2023-01-31,0.0,672.77
2127,46064017,2023-02-02,28.99,701.76
2128,46064017,2023-02-03,129.73,831.49
2129,46064017,2023-02-05,60.9,892.39
2130,46064017,2023-02-10,1575.6,2467.99
8401,46064017,2023-02-11,-471.8,1996.1899999999998
8402,46064017,2023-02-12,-115.87,1880.3199999999997
2131,46064017,2023-02-12,145.68,2025.9999999999998
8403,46064017,2023-02-13,-800.9,1225.1
2132,46064017,2023-02-14,141.13,1366.2299999999998
1199,46067647,2023-01-31,0.0,677.66
3896,46067647,2023-02-03,-98.31,579.3499999999999
3895,46067647,2023-02-03,-88.94,490.40999999999997
3894,46067647,2023-02-03,-54.41,436.0
6646,46067647,2023-02-06,64.29,500.28999999999996
3897,46067647,2023-02-08,-43.9,456.39
6647,46067647,2023-02-13,140.52,596.91
6648,46067647,2023-02-14,101.91,698.8199999999999
1200,46073044,2023-01-31,0.0,957.36
6974,46073044,2023-02-06,-158.15,799.21
6975,46073044,2023-02-08,-265.04,534.17
6976,46073044,2023-02-11,-121.51,412.65999999999997
8658,46073044,2023-02-14,155.82,568.48
8659,46073044,2023-02-14,1879.5,2447.98
1201,46085917,2023-01-31,0.0,340.16
6821,46085917,2023-02-06,104.85,445.01
7746,46085917,2023-02-08,-1374.1,-929.0899999999999
7747,46085917,2023-02-08,-110.8,-1039.8899999999999
7748,46085917,2023-02-09,-155.66,-1195.55
6822,46085917,2023-02-10,90.3,-1105.25
6823,46085917,2023-02-11,155.49,-949.76
6824,46085917,2023-02-13,62.41,-887.3499999999999
6825,46085917,2023-02-13,67.31,-820.04
1202,46100177,2023-01-31,0.0,979.25
2627,46100177,2023-02-02,-681.0,298.25
2626,46100177,2023-02-02,-93.98,204.26999999999998
2628,46100177,2023-02-03,-42.34,161.92999999999995
2629,46100177,2023-02-06,-74.62,87.30999999999995
7754,46100177,2023-02-08,797.2,884.51
7755,46100177,2023-02-09,99.44,983.95
1203,46133743,2023-01-31,0.0,862.26
3007,46133743,2023-02-02,-100.0,762.26
6736,46133743,2023-02-06,93.21,855.47
6737,46133743,2023-02-10,29.52,884.99
1204,46215382,2023-01-31,0.0,549.77
3869,46215382,2023-02-03,-1569.4,-1019.6300000000001
3870,46215382,2023-02-03,-152.95,-1172.5800000000002
3871,46215382,2023-02-03,-76.11,-1248.69
3872,46215382,2023-02-04,-57.41,-1306.1000000000001
3873,46215382,2023-02-05,-114.53,-1420.63
7178,46215382,2023-02-06,171.29,-1249.3400000000001
3874,46215382,2023-02-07,-167.72,-1417.0600000000002
7179,46215382,2023-02-10,2084.1,667.0399999999997
3875,46215382,2023-02-11,-56.36,610.6799999999997
3876,46215382,2023-02-13,-38.78,571.8999999999997
7180,46215382,2023-02-13,135.78,707.6799999999997
1205,46230315,2023-01-31,0.0,4.43
2347,46230315,2023-02-02,120.61,125.03999999999999
5274,46230315,2023-02-04,-153.16,-28.119999999999997
5275,46230315,2023-02-06,-145.42,-173.53999999999996
5276,46230315,2023-02-13,-66.15,-239.69
2348,46230315,2023-02-13,125.25,-114.44
1206,46231176,2023-01-31,0.0,290.35
1430,46231176,2023-02-01,-1397.4,-1107.0500000000002
177,46231176,2023-02-01,162.41,-944.64
178,46231176,2023-02-02,98.15,-846.4900000000001
1431,46231176,2023-02-05,-46.86,-893.35
179,46231176,2023-02-09,625.1,-268.25
1432,46231176,2023-02-11,-17.45,-285.70000000000005
1433,46231176,2023-02-12,-37.7,-323.4
180,46231176,2023-02-12,55.81,-267.59000000000003
1434,46231176,2023-02-13,-16.59,-284.17999999999995
181,46231176,2023-02-13,94.69,-189.49
1207,46255563,2023-01-31,0.0,565.42
1128,46255563,2023-02-01,92.51,657.93
5214,46255563,2023-02-04,-129.16,528.77
5216,46255563,2023-02-14,-89.67,439.09999999999997
5215,46255563,2023-02-14,-52.1,387.0
1208,46322903,2023-01-31,0.0,873.01
6822,46322903,2023-02-06,-179.1,693.91
6823,46322903,2023-02-06,-22.54,671.37
6824,46322903,2023-02-08,-206.07,465.3
7751,46322903,2023-02-08,66.39,531.69
7752,46322903,2023-02-09,143.77,675.46
7753,46322903,2023-02-14,81.74,757.2
1209,46326165,2023-01-31,0.0,571.8
4625,46326165,2023-02-03,-94.28,477.52
6921,46326165,2023-02-06,14.55,492.06999999999994
4626,46326165,2023-02-07,-87.09,404.97999999999996
6922,46326165,2023-02-10,143.62,548.5999999999999
4627,46326165,2023-02-12,-99.3,449.29999999999995
6923,46326165,2023-02-13,185.27,634.5699999999999
1210,46346470,2023-01-31,0.0,787.87
3731,46346470,2023-02-02,-93.94,693.9300000000001
3732,46346470,2023-02-04,-133.0,560.9300000000001
3733,46346470,2023-02-08,-35.51,525.4200000000001
8180,46346470,2023-02-09,70.29,595.71
3734,46346470,2023-02-11,-118.19,477.52
8181,46346470,2023-02-12,81.44,558.96
3735,46346470,2023-02-13,-67.73,491.23
1211,46355307,2023-01-31,0.0,152.4
946,46355307,2023-02-01,-161.31,-8.909999999999997
2694,46355307,2023-02-02,174.13,165.22
947,46355307,2023-02-14,-987.9,-822.68
1212,46442210,2023-01-31,0.0,732.14
2200,46442210,2023-02-02,-118.22,613.92
6836,46442210,2023-02-06,80.8,694.72
2201,46442210,2023-02-09,-899.8,-205.07999999999993
2202,46442210,2023-02-11,-23.58,-228.65999999999997
6837,46442210,2023-02-14,34.84,-193.81999999999994
1213,46479025,2023-01-31,0.0,323.03
5695,46479025,2023-02-04,-45.51,277.52
5394,46479025,2023-02-04,88.89,366.40999999999997
5696,46479025,2023-02-11,-90.03,276.38
5395,46479025,2023-02-12,100.49,376.86999999999995
5697,46479025,2023-02-14,-172.38,204.48999999999998
1214,46525458,2023-01-31,0.0,938.4
6615,46525458,2023-02-05,-1748.6,-810.1999999999999
7446,46525458,2023-02-07,153.96,-656.2399999999999
7445,46525458,2023-02-07,1225.0,568.7600000000001
7447,46525458,2023-02-10,86.14,654.9000000000001
6616,46525458,2023-02-11,-38.25,616.6500000000001
6617,46525458,2023-02-13,-116.37,500.2800000000001
1215,46552077,2023-01-31,0.0,672.51
3566,46552077,2023-02-02,-54.94,617.5699999999999
3567,46552077,2023-02-06,-153.53,464.03999999999996
1216,46561814,2023-01-31,0.0,216.29
1726,46561814,2023-02-01,70.34,286.63
6704,46561814,2023-02-06,-106.0,180.63
6706,46561814,2023-02-07,-214.17,-33.53999999999999
6705,46561814,2023-02-07,-185.39,-218.92999999999998
1727,46561814,2023-02-07,93.93,-124.99999999999997
1728,46561814,2023-02-09,124.56,-0.4399999999999693
6707,46561814,2023-02-13,-159.46,-159.89999999999995
1217,46597215,2023-01-31,0.0,455.5
6886,46597215,2023-02-06,73.5,529.0
6887,46597215,2023-02-07,165.34,694.34
6888,46597215,2023-02-08,1123.1,1817.4399999999998
8025,46597215,2023-02-09,-11.47,1805.9699999999998
1218,46597728,2023-01-31,0.0,920.72
5455,46597728,2023-02-04,110.99,1031.71
5456,46597728,2023-02-05,749.9,1781.6100000000001
5457,46597728,2023-02-06,111.94,1893.55
8604,46597728,2023-02-13,-1856.7,36.84999999999991
8603,46597728,2023-02-13,-165.07,-128.22000000000003
1219,46643937,2023-01-31,0.0,751.73
4452,46643937,2023-02-03,61.92,813.65
7338,46643937,2023-02-07,-1348.3,-534.6499999999999
7339,46643937,2023-02-07,-74.11,-608.7599999999998
4453,46643937,2023-02-07,67.88,-540.8799999999999
4454,46643937,2023-02-11,226.92,-313.9599999999998
4455,46643937,2023-02-12,76.94,-237.01999999999987
4456,46643937,2023-02-12,1041.9,804.8800000000002
7340,46643937,2023-02-14,-110.66,694.2200000000003
1220,46663039,2023-01-31,0.0,989.43
1092,46663039,2023-02-01,49.37,1038.8
4583,46663039,2023-02-03,-119.2,919.5999999999999
4582,46663039,2023-02-03,-52.27,867.3299999999999
1094,46663039,2023-02-06,34.2,901.53
1093,46663039,2023-02-06,161.03,1062.56
4584,46663039,2023-02-09,-813.0,249.55999999999995
1095,46663039,2023-02-12,120.86,370.41999999999996
4585,46663039,2023-02-14,-112.47,257.94999999999993
1221,46730484,2023-01-31,0.0,398.49
5385,46730484,2023-02-04,111.88,510.37
8268,46730484,2023-02-10,-111.05,399.32
8269,46730484,2023-02-11,-63.08,336.24
5386,46730484,2023-02-13,80.9,417.14
8270,46730484,2023-02-14,-79.28,337.86
1222,46741126,2023-01-31,0.0,393.18
3721,46741126,2023-02-02,-114.87,278.31
3722,46741126,2023-02-03,-169.26,109.05000000000001
3723,46741126,2023-02-06,-46.16,62.89000000000004
3724,46741126,2023-02-07,-60.76,2.1299999999999955
8254,46741126,2023-02-10,184.75,186.88000000000002
3725,46741126,2023-02-13,-116.37,70.51000000000005
1223,46768821,2023-01-31,0.0,458.81
4708,46768821,2023-02-03,90.12,548.9300000000001
4709,46768821,2023-02-04,135.11,684.04
4710,46768821,2023-02-06,124.41,808.45
7934,46768821,2023-02-08,-132.61,675.84
4711,46768821,2023-02-13,129.28,805.12
1224,46790294,2023-01-31,0.0,855.42
1137,46790294,2023-02-01,-156.88,698.54
1136,46790294,2023-02-01,-55.85,642.6899999999999
1138,46790294,2023-02-03,-72.41,570.28
7275,46790294,2023-02-07,87.09,657.37
1139,46790294,2023-02-08,-98.38,558.99
7276,46790294,2023-02-09,37.65,596.64
1225,46792863,2023-01-31,0.0,843.5
1038,46792863,2023-02-01,-81.07,762.4300000000001
4093,46792863,2023-02-03,87.36,849.79
4094,46792863,2023-02-06,159.47,1009.26
1039,46792863,2023-02-07,-84.66,924.6
1226,46851905,2023-01-31,0.0,18.23
2152,46851905,2023-02-01,-123.29,-105.06
331,46851905,2023-02-01,216.49,111.43
332,46851905,2023-02-04,196.98,308.41
333,46851905,2023-02-05,140.22,448.63
334,46851905,2023-02-06,441.4,890.03
335,46851905,2023-02-09,50.63,940.66
1227,46854962,2023-01-31,0.0,364.03
1580,46854962,2023-02-01,-81.49,282.53999999999996
57,46854962,2023-02-01,35.88,318.41999999999996
58,46854962,2023-02-02,93.7,412.12
59,46854962,2023-02-13,104.27,516.39
1581,46854962,2023-02-14,-544.0,-27.610000000000014
60,46854962,2023-02-14,111.83,84.21999999999997
1228,46879333,2023-01-31,0.0,462.44
7122,46879333,2023-02-06,-135.77,326.66999999999996
8264,46879333,2023-02-10,38.95,365.62
7124,46879333,2023-02-14,-128.86,236.76
7123,46879333,2023-02-14,-79.28,157.47999999999996
1229,46913859,2023-01-31,0.0,410.19
1360,46913859,2023-02-01,-119.68,290.51
6139,46913859,2023-02-05,88.7,379.21
6140,46913859,2023-02-07,126.94,506.15
6141,46913859,2023-02-08,1127.1,1633.25
1361,46913859,2023-02-09,-107.84,1525.41
1230,46920610,2023-01-31,0.0,124.16
1400,46920610,2023-02-01,124.86,249.01999999999998
1401,46920610,2023-02-02,25.85,274.87
6629,46920610,2023-02-05,-161.25,113.62
1402,46920610,2023-02-05,36.13,149.75
6630,46920610,2023-02-08,-30.53,119.22
6631,46920610,2023-02-09,-93.51,25.710000000000008
1231,46925211,2023-01-31,0.0,509.25
107,46925211,2023-02-01,189.46,698.71
108,46925211,2023-02-09,4.38,703.09
8540,46925211,2023-02-12,-205.26,497.83000000000004
109,46925211,2023-02-13,49.89,547.72
1232,47040996,2023-01-31,0.0,462.95
1629,47040996,2023-02-01,-130.83,332.12
3535,47040996,2023-02-02,173.89,506.01
3536,47040996,2023-02-03,121.3,627.31
1630,47040996,2023-02-04,-98.52,528.79
1631,47040996,2023-02-07,-89.73,439.05999999999995
1632,47040996,2023-02-09,-76.61,362.44999999999993
3537,47040996,2023-02-12,7.66,370.10999999999996
1233,47091705,2023-01-31,0.0,54.6
2092,47091705,2023-02-01,-75.52,-20.919999999999995
2093,47091705,2023-02-02,-88.29,-109.21000000000001
3659,47091705,2023-02-02,41.88,-67.33000000000001
2094,47091705,2023-02-03,-67.38,-134.71
3660,47091705,2023-02-04,95.6,-39.11000000000001
2095,47091705,2023-02-05,-142.28,-181.39000000000001
3661,47091705,2023-02-05,1195.0,1013.61
3662,47091705,2023-02-06,92.29,1105.8999999999999
3663,47091705,2023-02-09,1340.1,2445.9999999999995
3664,47091705,2023-02-14,96.17,2542.1699999999996
1234,47115177,2023-01-31,0.0,759.59
480,47115177,2023-02-01,-137.75,621.84
797,47115177,2023-02-01,81.36,703.2
798,47115177,2023-02-04,110.0,813.2
481,47115177,2023-02-06,-527.4,285.80000000000007
482,47115177,2023-02-09,-136.48,149.32000000000005
799,47115177,2023-02-11,120.95,270.2700000000001
801,47115177,2023-02-13,72.13,342.4000000000001
800,47115177,2023-02-13,165.07,507.4700000000001
802,47115177,2023-02-13,167.82,675.2900000000001
803,47115177,2023-02-14,123.42,798.71
1235,47127756,2023-01-31,0.0,300.02
3655,47127756,2023-02-02,-101.47,198.54999999999998
3656,47127756,2023-02-12,-84.03,114.51999999999998
1236,47133143,2023-01-31,0.0,723.52
617,47133143,2023-02-01,-182.36,541.16
4752,47133143,2023-02-03,33.17,574.3299999999999
618,47133143,2023-02-07,-57.45,516.88
619,47133143,2023-02-13,-31.07,485.80999999999995
620,47133143,2023-02-14,-41.25,444.55999999999995
1237,47172665,2023-01-31,0.0,11.06
7778,47172665,2023-02-08,-130.56,-119.5
7779,47172665,2023-02-08,-80.13,-199.63
7780,47172665,2023-02-13,-25.59,-225.22
8609,47172665,2023-02-13,56.41,-168.81
8610,47172665,2023-02-14,135.61,-33.19999999999999
1238,47226769,2023-01-31,0.0,449.88
316,47226769,2023-02-01,126.5,576.38
5090,47226769,2023-02-04,-132.93,443.45
5091,47226769,2023-02-06,-125.82,317.63
317,47226769,2023-02-06,1065.6,1383.23
318,47226769,2023-02-07,169.12,1552.35
1239,47232232,2023-01-31,0.0,53.44
1018,47232232,2023-02-01,126.4,179.84
7634,47232232,2023-02-07,-134.29,45.55000000000001
7635,47232232,2023-02-10,-136.1,-90.54999999999998
7636,47232232,2023-02-12,-157.46,-248.01
7637,47232232,2023-02-12,-117.55,-365.56
1019,47232232,2023-02-12,153.41,-212.14999999999998
1240,47266645,2023-01-31,0.0,207.15
2403,47266645,2023-02-02,-190.68,16.47
2464,47266645,2023-02-02,876.4,892.87
2465,47266645,2023-02-06,122.69,1015.5599999999998
2404,47266645,2023-02-07,-484.1,531.4599999999999
2466,47266645,2023-02-13,138.4,669.8599999999999
1241,47313428,2023-01-31,0.0,204.67
4956,47313428,2023-02-03,965.4,1170.07
7829,47313428,2023-02-08,-113.3,1056.77
7830,47313428,2023-02-13,-127.61,929.16
1242,47356348,2023-01-31,0.0,65.95
4528,47356348,2023-02-03,1223.8,1289.75
8635,47356348,2023-02-13,-139.98,1149.77
1243,47406737,2023-01-31,0.0,963.14
383,47406737,2023-02-01,844.6,1807.74
4685,47406737,2023-02-03,-68.61,1739.13
4686,47406737,2023-02-06,-1204.5,534.63
384,47406737,2023-02-08,24.94,559.5699999999999
4687,47406737,2023-02-09,-115.75,443.82000000000005
385,47406737,2023-02-09,179.26,623.0799999999999
386,47406737,2023-02-12,52.46,675.54
388,47406737,2023-02-12,128.61,804.15
387,47406737,2023-02-12,144.32,948.47
4688,47406737,2023-02-14,-129.18,819.29
1244,47414258,2023-01-31,0.0,900.7
6739,47414258,2023-02-06,-184.01,716.69
6738,47414258,2023-02-06,-123.37,593.32
6740,47414258,2023-02-06,-27.94,565.3800000000001
6741,47414258,2023-02-07,-1277.4,-712.02
6742,47414258,2023-02-08,-63.1,-775.1199999999999
8501,47414258,2023-02-11,108.92,-666.2
6743,47414258,2023-02-13,-134.58,-800.78
1245,47473145,2023-01-31,0.0,801.43
8516,47473145,2023-02-12,-35.17,766.26
8537,47473145,2023-02-12,132.48,898.7399999999999
1246,47483982,2023-01-31,0.0,661.58
7878,47483982,2023-02-08,-76.6,584.98
8335,47483982,2023-02-10,74.87,659.85
8336,47483982,2023-02-11,159.08,818.9300000000001
8337,47483982,2023-02-13,1017.6,1836.5300000000002
1247,47582488,2023-01-31,0.0,744.99
3407,47582488,2023-02-02,-124.68,620.31
3408,47582488,2023-02-03,-55.81,564.5
3410,47582488,2023-02-05,-110.72,453.78
3409,47582488,2023-02-05,-88.27,365.51
5982,47582488,2023-02-05,1.11,366.62
5983,47582488,2023-02-06,87.2,453.82
5984,47582488,2023-02-07,114.74,568.56
3411,47582488,2023-02-12,-7.97,560.59
3412,47582488,2023-02-13,-101.4,459.19
1248,47654093,2023-01-31,0.0,294.0
5719,47654093,2023-02-04,-63.26,230.74
6013,47654093,2023-02-05,161.8,392.54
6014,47654093,2023-02-10,88.04,480.58000000000004
5720,47654093,2023-02-12,-191.46,289.12
6015,47654093,2023-02-12,109.8,398.92
1249,47763906,2023-01-31,0.0,980.42
2197,47763906,2023-02-02,-187.19,793.23
2198,47763906,2023-02-02,-20.57,772.66
7505,47763906,2023-02-07,99.56,872.22
2199,47763906,2023-02-12,-210.36,661.8599999999999
7506,47763906,2023-02-12,7.97,669.8299999999999
1250,47781255,2023-01-31,0.0,462.62
3451,47781255,2023-02-02,-78.61,384.01
3450,47781255,2023-02-02,-24.87,359.14
2148,47781255,2023-02-02,133.0,492.14
2149,47781255,2023-02-03,101.07,593.21
3452,47781255,2023-02-05,-67.95,525.26
2150,47781255,2023-02-08,63.9,589.16
2151,47781255,2023-02-10,34.35,623.51
2152,47781255,2023-02-14,124.48,747.99
1251,47808992,2023-01-31,0.0,885.16
8033,47808992,2023-02-09,197.63,1082.79
8034,47808992,2023-02-10,106.19,1188.98
8440,47808992,2023-02-11,-121.09,1067.8899999999999
8441,47808992,2023-02-12,-44.96,1022.93
1252,47824990,2023-01-31,0.0,704.97
8545,47824990,2023-02-12,86.17,791.14
8546,47824990,2023-02-13,113.91,905.05
1253,47886866,2023-01-31,0.0,399.75
3390,47886866,2023-02-02,-25.61,374.14
5714,47886866,2023-02-04,105.17,479.31
3391,47886866,2023-02-07,-110.79,368.52
5715,47886866,2023-02-10,51.82,420.34
3392,47886866,2023-02-11,-133.59,286.75
5716,47886866,2023-02-11,125.01,411.76
3393,47886866,2023-02-14,-32.8,378.96000000000004
1254,47902339,2023-01-31,0.0,919.92
6161,47902339,2023-02-05,-65.25,854.67
6162,47902339,2023-02-06,-80.92,773.75
8294,47902339,2023-02-10,165.02,938.77
1255,47932460,2023-01-31,0.0,785.05
1462,47932460,2023-02-01,-99.41,685.64
1463,47932460,2023-02-04,-220.77,464.86999999999995
5224,47932460,2023-02-04,204.89,669.76
1464,47932460,2023-02-07,-81.45,588.31
1465,47932460,2023-02-08,-124.98,463.3299999999999
1466,47932460,2023-02-09,-27.53,435.79999999999995
5225,47932460,2023-02-11,909.1,1344.9
1256,47964895,2023-01-31,0.0,982.97
5373,47964895,2023-02-04,-111.88,871.09
5374,47964895,2023-02-05,-184.78,686.3100000000001
5375,47964895,2023-02-07,-46.27,640.04
5376,47964895,2023-02-14,-109.46,530.58
1257,48018851,2023-01-31,0.0,288.26
6637,48018851,2023-02-05,897.5,1185.76
7227,48018851,2023-02-07,-101.82,1083.94
6638,48018851,2023-02-13,85.75,1169.69
6639,48018851,2023-02-14,144.57,1314.26
1258,48029032,2023-01-31,0.0,422.88
6791,48029032,2023-02-06,27.93,450.81
6792,48029032,2023-02-06,69.2,520.01
8174,48029032,2023-02-09,-168.19,351.82
6793,48029032,2023-02-09,15.37,367.19
6794,48029032,2023-02-09,98.06,465.25
8175,48029032,2023-02-10,-65.29,399.96
8176,48029032,2023-02-12,-7.66,392.3
6795,48029032,2023-02-12,92.12,484.41999999999996
6796,48029032,2023-02-13,142.2,626.62
1259,48050578,2023-01-31,0.0,203.26
6955,48050578,2023-02-06,60.08,263.34
6956,48050578,2023-02-07,101.89,365.23
1260,48056301,2023-01-31,0.0,943.28
4488,48056301,2023-02-03,-98.24,845.04
4705,48056301,2023-02-03,85.06,930.1
4489,48056301,2023-02-13,-114.39,815.71
4706,48056301,2023-02-13,52.77,868.48
1261,48071843,2023-01-31,0.0,997.62
745,48071843,2023-02-01,-387.9,609.72
3375,48071843,2023-02-02,159.22,768.94
746,48071843,2023-02-09,-1877.3,-1108.3600000000001
1262,48075275,2023-01-31,0.0,881.31
1069,48075275,2023-02-01,-98.75,782.56
1070,48075275,2023-02-01,-77.94,704.6199999999999
5488,48075275,2023-02-04,117.79,822.41
5489,48075275,2023-02-09,85.81,908.2199999999999
5490,48075275,2023-02-10,142.07,1050.29
1071,48075275,2023-02-14,-1209.0,-158.71000000000004
1263,48081999,2023-01-31,0.0,290.89
2757,48081999,2023-02-02,96.07,386.96
2758,48081999,2023-02-04,189.06,576.02
2759,48081999,2023-02-05,111.66,687.68
2760,48081999,2023-02-06,27.72,715.4
8462,48081999,2023-02-11,-132.19,583.21
2761,48081999,2023-02-11,72.7,655.91
8464,48081999,2023-02-12,-168.57,487.34
8463,48081999,2023-02-12,-89.43,397.90999999999997
2762,48081999,2023-02-12,1291.9,1689.81
8465,48081999,2023-02-13,-104.18,1585.63
1264,48131431,2023-01-31,0.0,809.8
621,48131431,2023-02-01,-128.93,680.8699999999999
8686,48131431,2023-02-14,404.9,1085.77
1265,48185625,2023-01-31,0.0,822.11
2936,48185625,2023-02-02,-74.49,747.62
2937,48185625,2023-02-03,-106.8,640.82
7403,48185625,2023-02-07,185.51,826.33
2938,48185625,2023-02-13,-98.9,727.4300000000001
1266,48186857,2023-01-31,0.0,518.26
3985,48186857,2023-02-03,145.32,663.5799999999999
3986,48186857,2023-02-06,98.85,762.43
3988,48186857,2023-02-09,69.39,831.8199999999999
3987,48186857,2023-02-09,97.62,929.44
3989,48186857,2023-02-12,110.79,1040.23
1267,48271608,2023-01-31,0.0,343.94
7,48271608,2023-02-01,54.71,398.65
8,48271608,2023-02-03,164.56,563.21
9,48271608,2023-02-07,140.12,703.3299999999999
8243,48271608,2023-02-10,-111.12,592.21
10,48271608,2023-02-10,47.4,639.61
11,48271608,2023-02-10,55.38,694.99
12,48271608,2023-02-13,1665.4,2360.39
13,48271608,2023-02-14,153.15,2513.54
1268,48318402,2023-01-31,0.0,965.28
5271,48318402,2023-02-04,-111.18,854.0999999999999
5272,48318402,2023-02-04,-44.62,809.48
5273,48318402,2023-02-08,-96.4,713.0799999999999
8089,48318402,2023-02-09,30.36,743.4399999999999
8090,48318402,2023-02-14,101.59,845.03
1269,48350476,2023-01-31,0.0,305.2
2922,48350476,2023-02-02,-38.74,266.46
2737,48350476,2023-02-02,95.1,361.56
2923,48350476,2023-02-03,-82.71,278.84999999999997
2924,48350476,2023-02-04,-152.03,126.82
2925,48350476,2023-02-05,-92.4,34.420000000000016
2738,48350476,2023-02-06,39.91,74.32999999999998
2926,48350476,2023-02-10,-57.64,16.689999999999998
2739,48350476,2023-02-10,213.83,230.51999999999998
1270,48399121,2023-01-31,0.0,984.98
8070,48399121,2023-02-09,233.91,1218.89
8659,48399121,2023-02-14,-104.64,1114.25
1271,48429255,2023-01-31,0.0,79.7
7004,48429255,2023-02-06,-110.9,-31.200000000000003
8487,48429255,2023-02-11,99.36,68.16
8488,48429255,2023-02-12,128.19,196.35
7005,48429255,2023-02-14,-88.32,108.03
1272,48434572,2023-01-31,0.0,351.7
1262,48434572,2023-02-01,-113.69,238.01
4223,48434572,2023-02-03,28.45,266.46
4224,48434572,2023-02-04,72.42,338.88
4225,48434572,2023-02-10,75.71,414.59
4226,48434572,2023-02-11,720.7,1135.29
1263,48434572,2023-02-12,-118.43,1016.8600000000001
1273,48444386,2023-01-31,0.0,962.57
6035,48444386,2023-02-05,-91.73,870.84
6994,48444386,2023-02-06,94.25,965.09
6995,48444386,2023-02-11,152.17,1117.26
6996,48444386,2023-02-14,73.36,1190.62
1274,48491614,2023-01-31,0.0,754.45
1227,48491614,2023-02-01,120.88,875.33
7011,48491614,2023-02-06,-738.2,137.13
7012,48491614,2023-02-11,-6.19,130.93999999999994
1275,48500030,2023-01-31,0.0,917.05
8152,48500030,2023-02-09,-125.13,791.92
8638,48500030,2023-02-13,56.68,848.5999999999999
8153,48500030,2023-02-14,-148.05,700.55
1276,48507357,2023-01-31,0.0,980.8
4362,48507357,2023-02-03,80.54,1061.34
6928,48507357,2023-02-06,-80.07,981.27
6929,48507357,2023-02-11,-81.26,900.01
1277,48524535,2023-01-31,0.0,265.03
1593,48524535,2023-02-01,32.75,297.78
1594,48524535,2023-02-02,50.17,347.95
4259,48524535,2023-02-03,-76.66,271.28999999999996
4260,48524535,2023-02-06,-78.99,192.29999999999998
4261,48524535,2023-02-06,-50.95,141.34999999999997
4262,48524535,2023-02-07,-126.03,15.319999999999993
4263,48524535,2023-02-08,-65.85,-50.53000000000003
1595,48524535,2023-02-08,43.73,-6.800000000000011
4264,48524535,2023-02-10,-71.44,-78.24000000000001
4265,48524535,2023-02-11,-24.18,-102.42000000000002
4266,48524535,2023-02-14,-50.36,-152.78000000000003
1596,48524535,2023-02-14,120.62,-32.15999999999997
1278,48532894,2023-01-31,0.0,662.86
3004,48532894,2023-02-02,109.57,772.4300000000001
3005,48532894,2023-02-03,79.16,851.59
3006,48532894,2023-02-11,91.38,942.97
3007,48532894,2023-02-14,597.7,1540.67
1279,48553648,2023-01-31,0.0,80.62
3027,48553648,2023-02-02,-122.23,-41.61
3028,48553648,2023-02-05,-12.08,-53.69
8640,48553648,2023-02-13,89.1,35.41
1280,48569537,2023-01-31,0.0,374.69
1093,48569537,2023-02-01,-1153.0,-778.31
1094,48569537,2023-02-05,-178.08,-956.3899999999999
1095,48569537,2023-02-07,-230.31,-1186.7
1096,48569537,2023-02-07,-173.79,-1360.49
8065,48569537,2023-02-09,938.3,-422.1900000000001
1097,48569537,2023-02-10,-92.21,-514.4000000000001
8066,48569537,2023-02-11,818.2,303.7999999999999
1098,48569537,2023-02-13,-46.16,257.6399999999999
8067,48569537,2023-02-14,50.36,307.9999999999999
1281,48591774,2023-01-31,0.0,422.94
204,48591774,2023-02-01,84.03,506.97
3922,48591774,2023-02-03,-91.97,415.0
205,48591774,2023-02-08,146.43,561.4300000000001
206,48591774,2023-02-09,117.1,678.53
3923,48591774,2023-02-10,-121.67,556.86
3924,48591774,2023-02-10,-90.33,466.53
3925,48591774,2023-02-14,-139.74,326.78999999999996
1282,48625559,2023-01-31,0.0,797.88
3787,48625559,2023-02-03,88.02,885.9
5311,48625559,2023-02-04,-146.29,739.61
3788,48625559,2023-02-07,105.97,845.58
5312,48625559,2023-02-08,-129.99,715.59
3789,48625559,2023-02-08,147.08,862.67
3790,48625559,2023-02-09,44.19,906.86
5313,48625559,2023-02-10,-93.87,812.99
3791,48625559,2023-02-11,187.8,1000.79
3792,48625559,2023-02-12,85.27,1086.06
5314,48625559,2023-02-14,-53.72,1032.3400000000001
1283,48654969,2023-01-31,0.0,83.93
4026,48654969,2023-02-03,43.31,127.24000000000001
7819,48654969,2023-02-08,-119.16,8.080000000000013
4028,48654969,2023-02-10,747.3,755.3799999999999
4027,48654969,2023-02-10,951.2,1706.5800000000002
1284,48722022,2023-01-31,0.0,586.44
1689,48722022,2023-02-01,123.96,710.4000000000001
6589,48722022,2023-02-05,-45.1,665.3000000000001
1690,48722022,2023-02-07,148.28,813.58
6590,48722022,2023-02-12,-61.43,752.1500000000001
1691,48722022,2023-02-12,93.42,845.57
1285,48733708,2023-01-31,0.0,370.74
989,48733708,2023-02-01,-212.62,158.12
990,48733708,2023-02-01,-60.93,97.19
2784,48733708,2023-02-02,6.47,103.66000000000003
2785,48733708,2023-02-03,87.65,191.31
2786,48733708,2023-02-04,5.54,196.85000000000002
991,48733708,2023-02-05,-118.28,78.57000000000005
992,48733708,2023-02-08,-105.76,-27.189999999999998
2787,48733708,2023-02-09,123.28,96.09000000000003
1286,48757991,2023-01-31,0.0,676.6
1647,48757991,2023-02-01,141.6,818.2
1648,48757991,2023-02-07,136.97,955.1700000000001
1649,48757991,2023-02-11,86.98,1042.15
1287,48781678,2023-01-31,0.0,401.55
695,48781678,2023-02-01,-856.5,-454.95
6315,48781678,2023-02-05,150.73,-304.21999999999997
1288,48783408,2023-01-31,0.0,278.34
4107,48783408,2023-02-03,140.36,418.7
4108,48783408,2023-02-04,101.75,520.45
4109,48783408,2023-02-07,185.47,705.9200000000001
4110,48783408,2023-02-08,105.53,811.45
4111,48783408,2023-02-09,163.2,974.6499999999999
4112,48783408,2023-02-11,87.63,1062.28
1289,48799650,2023-01-31,0.0,160.75
477,48799650,2023-02-01,83.35,244.1
7853,48799650,2023-02-08,-154.93,89.16999999999999
1290,48831634,2023-01-31,0.0,146.94
5253,48831634,2023-02-04,-1593.8,-1446.86
5254,48831634,2023-02-04,-90.91,-1537.77
6762,48831634,2023-02-06,141.38,-1396.3899999999999
6763,48831634,2023-02-09,69.64,-1326.75
6764,48831634,2023-02-09,91.85,-1234.8999999999999
5255,48831634,2023-02-11,-1243.0,-2477.9
5256,48831634,2023-02-11,-103.93,-2581.83
5257,48831634,2023-02-13,-148.74,-2730.5699999999997
6765,48831634,2023-02-13,35.46,-2695.1099999999997
1291,48860469,2023-01-31,0.0,730.37
1925,48860469,2023-02-01,-166.48,563.89
7504,48860469,2023-02-07,195.55,759.44
1927,48860469,2023-02-08,-103.37,656.07
1926,48860469,2023-02-08,-55.57,600.5
1928,48860469,2023-02-10,-167.13,433.37
1292,48875351,2023-01-31,0.0,239.7
8544,48875351,2023-02-12,100.25,339.95
1293,48886521,2023-01-31,0.0,827.29
443,48886521,2023-02-01,134.06,961.3499999999999
444,48886521,2023-02-03,98.44,1059.79
445,48886521,2023-02-04,184.38,1244.17
6252,48886521,2023-02-05,-101.6,1142.57
446,48886521,2023-02-08,33.64,1176.21
1294,48906756,2023-01-31,0.0,996.87
2261,48906756,2023-02-02,-34.56,962.31
2330,48906756,2023-02-02,36.6,998.91
2331,48906756,2023-02-05,637.3,1636.21
2262,48906756,2023-02-09,-229.85,1406.36
1295,48911149,2023-01-31,0.0,580.54
6160,48911149,2023-02-05,144.63,725.17
6161,48911149,2023-02-09,82.08,807.25
8480,48911149,2023-02-11,-518.1,289.1499999999999
1296,48930319,2023-01-31,0.0,595.65
354,48930319,2023-02-01,167.53,763.18
355,48930319,2023-02-04,76.06,839.24
6066,48930319,2023-02-05,-177.45,661.79
6067,48930319,2023-02-05,-68.53,593.26
356,48930319,2023-02-08,23.59,616.85
357,48930319,2023-02-12,51.05,667.9
1297,48940493,2023-01-31,0.0,394.19
3610,48940493,2023-02-02,-22.64,371.55
2285,48940493,2023-02-02,217.51,589.06
2287,48940493,2023-02-04,90.44,679.5
2286,48940493,2023-02-04,125.73,805.23
2288,48940493,2023-02-05,174.7,979.9300000000001
2289,48940493,2023-02-05,216.4,1196.33
3611,48940493,2023-02-07,-106.64,1089.69
3612,48940493,2023-02-08,-967.3,122.39000000000004
3613,48940493,2023-02-08,-66.57,55.82000000000005
2290,48940493,2023-02-08,149.31,205.13000000000005
3614,48940493,2023-02-12,-175.32,29.81000000000006
2291,48940493,2023-02-12,970.8,1000.6100000000001
1298,48976336,2023-01-31,0.0,400.12
1604,48976336,2023-02-01,-2027.7,-1627.58
1605,48976336,2023-02-03,-59.2,-1686.7800000000002
7066,48976336,2023-02-06,58.17,-1628.6100000000001
1606,48976336,2023-02-07,-218.78,-1847.3900000000003
1607,48976336,2023-02-08,-91.24,-1938.63
7067,48976336,2023-02-10,117.56,-1821.0700000000002
1299,49031081,2023-01-31,0.0,788.18
3690,49031081,2023-02-02,131.8,919.98
3691,49031081,2023-02-03,127.58,1047.56
5020,49031081,2023-02-04,-97.05,950.51
3692,49031081,2023-02-08,76.81,1027.32
5021,49031081,2023-02-09,-94.81,932.51
3693,49031081,2023-02-10,81.26,1013.77
3694,49031081,2023-02-10,134.24,1148.01
5022,49031081,2023-02-12,-137.83,1010.18
5023,49031081,2023-02-14,-58.59,951.5899999999999
1300,49031379,2023-01-31,0.0,373.63
369,49031379,2023-02-01,67.01,440.64
371,49031379,2023-02-03,96.51,537.15
370,49031379,2023-02-03,135.44,672.59
372,49031379,2023-02-07,46.14,718.73
7935,49031379,2023-02-08,-119.48,599.25
7936,49031379,2023-02-10,-129.69,469.56
1301,49039474,2023-01-31,0.0,574.7
501,49039474,2023-02-01,89.56,664.26
502,49039474,2023-02-03,143.42,807.6800000000001
503,49039474,2023-02-04,56.75,864.4300000000001
6536,49039474,2023-02-05,-1168.4,-303.97
504,49039474,2023-02-07,24.41,-279.56000000000006
6537,49039474,2023-02-11,-1815.0,-2094.5600000000004
1302,49071892,2023-01-31,0.0,909.58
5977,49071892,2023-02-04,-95.76,813.82
5439,49071892,2023-02-04,132.12,945.94
5440,49071892,2023-02-06,50.78,996.72
5441,49071892,2023-02-08,113.3,1110.02
5978,49071892,2023-02-09,-93.18,1016.84
5979,49071892,2023-02-10,-141.83,875.01
1303,49075324,2023-01-31,0.0,301.39
4296,49075324,2023-02-03,-716.6,-415.21000000000004
4295,49075324,2023-02-03,-40.55,-455.76
6982,49075324,2023-02-06,73.4,-382.36
6983,49075324,2023-02-10,55.08,-327.2800000000001
1304,49095464,2023-01-31,0.0,1.3
1029,49095464,2023-02-01,-146.39,-145.08999999999997
1933,49095464,2023-02-01,91.66,-53.42999999999999
1030,49095464,2023-02-06,-168.59,-222.01999999999998
1031,49095464,2023-02-06,-149.41,-371.43
1032,49095464,2023-02-11,-155.81,-527.24
1934,49095464,2023-02-11,43.12,-484.12
1033,49095464,2023-02-12,-140.22,-624.34
1034,49095464,2023-02-13,-1237.4,-1861.74
1936,49095464,2023-02-13,119.03,-1742.71
1935,49095464,2023-02-13,140.3,-1602.41
1305,49127699,2023-01-31,0.0,155.53
87,49127699,2023-02-01,83.63,239.16
88,49127699,2023-02-07,89.31,328.47
7854,49127699,2023-02-08,-122.65,205.82
89,49127699,2023-02-08,110.78,316.6
90,49127699,2023-02-09,108.53,425.13
7855,49127699,2023-02-11,-130.19,294.94
1306,49157903,2023-01-31,0.0,601.62
3941,49157903,2023-02-03,-993.7,-392.08000000000004
6280,49157903,2023-02-05,175.05,-217.0300000000001
3942,49157903,2023-02-06,-103.08,-320.11
6281,49157903,2023-02-12,94.16,-225.95000000000005
1307,49172838,2023-01-31,0.0,136.96
4501,49172838,2023-02-03,-113.68,23.28
8375,49172838,2023-02-10,24.85,48.129999999999995
4502,49172838,2023-02-11,-96.47,-48.34
8376,49172838,2023-02-13,1545.5,1497.16
8377,49172838,2023-02-14,141.48,1638.64
1308,49186099,2023-01-31,0.0,208.24
1534,49186099,2023-02-01,90.07,298.31
1533,49186099,2023-02-01,118.24,416.55
1535,49186099,2023-02-04,92.27,508.82
1309,49216581,2023-01-31,0.0,911.91
286,49216581,2023-02-01,-754.9,157.01
7543,49216581,2023-02-07,1147.4,1304.41
287,49216581,2023-02-10,-1812.5,-508.09000000000003
289,49216581,2023-02-13,-569.6,-1077.69
288,49216581,2023-02-13,-127.19,-1204.88
7544,49216581,2023-02-13,138.94,-1065.94
1310,49253709,2023-01-31,0.0,473.46
1208,49253709,2023-02-01,-120.88,352.58
1819,49253709,2023-02-01,65.02,417.59999999999997
1820,49253709,2023-02-03,134.37,551.97
1822,49253709,2023-02-04,107.78,659.75
1821,49253709,2023-02-04,129.16,788.91
1209,49253709,2023-02-05,-209.45,579.46
1823,49253709,2023-02-07,129.29,708.75
1210,49253709,2023-02-12,-87.33,621.42
1211,49253709,2023-02-12,-52.81,568.61
1824,49253709,2023-02-12,151.37,719.98
1212,49253709,2023-02-13,-109.33,610.65
1311,49310474,2023-01-31,0.0,929.16
1401,49310474,2023-02-01,-84.68,844.48
2080,49310474,2023-02-01,131.27,975.75
1402,49310474,2023-02-06,-79.45,896.3
1403,49310474,2023-02-07,-49.81,846.49
2081,49310474,2023-02-07,124.51,971.0
2082,49310474,2023-02-13,165.82,1136.82
1404,49310474,2023-02-14,-88.77,1048.05
2083,49310474,2023-02-14,32.96,1081.01
1312,49400211,2023-01-31,0.0,460.24
1014,49400211,2023-02-01,212.62,672.86
1015,49400211,2023-02-02,155.92,828.78
1016,49400211,2023-02-08,192.5,1021.28
1017,49400211,2023-02-09,67.33,1088.6100000000001
8257,49400211,2023-02-10,-102.74,985.87
1313,49410021,2023-01-31,0.0,508.72
1922,49410021,2023-02-01,112.52,621.24
7006,49410021,2023-02-06,-121.6,499.64000000000004
7007,49410021,2023-02-12,-129.45,370.19000000000005
7008,49410021,2023-02-14,-72.61,297.58000000000004
1314,49427302,2023-01-31,0.0,468.73
4261,49427302,2023-02-03,79.37,548.1
5750,49427302,2023-02-04,-76.17,471.93
5751,49427302,2023-02-06,-93.16,378.77000000000004
4262,49427302,2023-02-06,1045.4,1424.17
4263,49427302,2023-02-07,51.11,1475.2800000000002
4264,49427302,2023-02-08,81.34,1556.6200000000001
5752,49427302,2023-02-11,-112.24,1444.38
4265,49427302,2023-02-12,49.41,1493.79
1315,49441522,2023-01-31,0.0,75.3
1851,49441522,2023-02-01,159.64,234.94
2541,49441522,2023-02-02,-132.64,102.3
1852,49441522,2023-02-03,183.44,285.74
1853,49441522,2023-02-09,35.02,320.76
1854,49441522,2023-02-10,10.96,331.72
2542,49441522,2023-02-11,-152.11,179.61
1316,49454023,2023-01-31,0.0,798.72
1132,49454023,2023-02-01,780.9,1579.62
2439,49454023,2023-02-02,-123.95,1455.67
2441,49454023,2023-02-02,-92.61,1363.06
2440,49454023,2023-02-02,-50.17,1312.8899999999999
1133,49454023,2023-02-03,111.24,1424.13
1134,49454023,2023-02-06,155.88,1580.01
1135,49454023,2023-02-07,1070.1,2650.1099999999997
2442,49454023,2023-02-08,-751.9,1898.2099999999998
2443,49454023,2023-02-10,-86.78,1811.4299999999998
1136,49454023,2023-02-12,57.5,1868.9299999999998
1317,49459559,2023-01-31,0.0,467.56
7502,49459559,2023-02-07,808.1,1275.66
8425,49459559,2023-02-11,-96.16,1179.5
8426,49459559,2023-02-12,-144.16,1035.34
8427,49459559,2023-02-13,-107.55,927.79
7503,49459559,2023-02-14,68.56,996.3500000000001
1318,49467252,2023-01-31,0.0,444.92
5383,49467252,2023-02-04,64.43,509.35
5384,49467252,2023-02-05,59.15,568.5
6764,49467252,2023-02-06,-51.78,516.72
6765,49467252,2023-02-10,-17.18,499.54
1319,49516533,2023-01-31,0.0,7.4
2709,49516533,2023-02-02,-65.93,-58.53000000000001
2708,49516533,2023-02-02,-65.53,-124.06
2710,49516533,2023-02-04,-578.6,-702.6600000000001
6063,49516533,2023-02-05,61.84,-640.82
6064,49516533,2023-02-07,42.04,-598.7800000000001
2711,49516533,2023-02-08,-141.86,-740.6400000000001
2712,49516533,2023-02-09,-106.29,-846.9300000000001
2713,49516533,2023-02-11,-20.99,-867.9200000000001
6065,49516533,2023-02-11,187.53,-680.3900000000001
2714,49516533,2023-02-13,-1188.4,-1868.79
1320,49520335,2023-01-31,0.0,198.79
1672,49520335,2023-02-01,77.78,276.57
4136,49520335,2023-02-03,-104.62,171.95
4137,49520335,2023-02-08,-14.84,157.10999999999999
1673,49520335,2023-02-10,1795.9,1953.01
1674,49520335,2023-02-12,88.2,2041.21
4138,49520335,2023-02-14,-88.67,1952.54
1321,49533543,2023-01-31,0.0,190.64
5293,49533543,2023-02-04,-164.38,26.25999999999999
5292,49533543,2023-02-04,-45.03,-18.77000000000001
5294,49533543,2023-02-05,-986.7,-1005.4700000000001
5296,49533543,2023-02-11,-139.2,-1144.67
5295,49533543,2023-02-11,-77.77,-1222.44
8507,49533543,2023-02-11,57.11,-1165.33
1322,49534905,2023-01-31,0.0,383.91
7438,49534905,2023-02-07,106.1,490.01
1323,49536707,2023-01-31,0.0,37.3
1768,49536707,2023-02-01,-136.75,-99.45
1769,49536707,2023-02-02,-104.98,-204.43
1771,49536707,2023-02-03,-173.01,-377.44
1770,49536707,2023-02-03,-120.86,-498.3
6549,49536707,2023-02-05,147.37,-350.93
6550,49536707,2023-02-08,35.81,-315.12
1772,49536707,2023-02-11,-113.2,-428.32
1774,49536707,2023-02-14,-228.87,-657.19
1773,49536707,2023-02-14,-120.83,-778.0200000000001
1775,49536707,2023-02-14,-101.69,-879.71
1324,49540328,2023-01-31,0.0,458.12
2661,49540328,2023-02-02,-98.11,360.01
2662,49540328,2023-02-04,-122.19,237.82
2663,49540328,2023-02-05,-93.03,144.79000000000002
7961,49540328,2023-02-09,110.51,255.3
2664,49540328,2023-02-13,-172.54,82.75999999999999
1325,49550154,2023-01-31,0.0,178.14
1824,49550154,2023-02-01,-122.7,55.43999999999998
6575,49550154,2023-02-05,76.04,131.48
1825,49550154,2023-02-08,-79.16,52.31999999999999
1826,49550154,2023-02-08,-63.41,-11.090000000000003
1827,49550154,2023-02-10,-179.95,-191.03999999999996
6576,49550154,2023-02-13,151.76,-39.28
6577,49550154,2023-02-14,166.38,127.1
1326,49581833,2023-01-31,0.0,117.56
1759,49581833,2023-02-01,-52.0,65.56
1761,49581833,2023-02-02,-1640.2,-1574.64
1760,49581833,2023-02-02,-185.74,-1760.38
1762,49581833,2023-02-04,-56.75,-1817.13
8613,49581833,2023-02-13,1013.4,-803.73
1763,49581833,2023-02-14,-138.71,-942.44
1327,49696722,2023-01-31,0.0,142.69
3465,49696722,2023-02-02,153.46,296.15
5136,49696722,2023-02-04,-88.15,208.0
5137,49696722,2023-02-07,-127.37,80.63
3466,49696722,2023-02-11,126.93,207.56
5138,49696722,2023-02-13,-44.2,163.36
3467,49696722,2023-02-13,1291.4,1454.7600000000002
1328,49834565,2023-01-31,0.0,51.12
5036,49834565,2023-02-03,72.44,123.56
8576,49834565,2023-02-12,-76.93,46.62999999999999
1329,49840526,2023-01-31,0.0,461.64
4252,49840526,2023-02-03,95.71,557.35
6256,49840526,2023-02-05,-200.77,356.58
4253,49840526,2023-02-08,2591.7,2948.2799999999997
6257,49840526,2023-02-09,-58.39,2889.89
4255,49840526,2023-02-09,168.65,3058.5399999999995
4256,49840526,2023-02-09,229.85,3288.39
4254,49840526,2023-02-09,1530.9,4819.29
4257,49840526,2023-02-10,107.56,4926.85
1330,49941860,2023-01-31,0.0,655.66
1392,49941860,2023-02-01,60.93,716.5899999999999
1393,49941860,2023-02-03,66.9,783.49
8010,49941860,2023-02-08,-34.93,748.56
1331,49961732,2023-01-31,0.0,673.71
1123,49961732,2023-02-01,49.48,723.19
1124,49961732,2023-02-01,99.06,822.25
7916,49961732,2023-02-08,-133.54,688.71
1125,49961732,2023-02-08,48.01,736.72
1126,49961732,2023-02-09,22.93,759.6500000000001
7917,49961732,2023-02-11,-68.14,691.51
1127,49961732,2023-02-11,107.51,799.02
1332,49966528,2023-01-31,0.0,641.18
670,49966528,2023-02-01,133.29,774.4699999999999
4190,49966528,2023-02-03,-92.73,681.7399999999999
4191,49966528,2023-02-04,-115.54,566.1999999999999
671,49966528,2023-02-05,176.37,742.5699999999999
4192,49966528,2023-02-06,-161.12,581.4499999999999
672,49966528,2023-02-06,152.43,733.8799999999999
673,49966528,2023-02-07,180.28,914.16
674,49966528,2023-02-09,115.5,1029.6599999999999
675,49966528,2023-02-12,114.03,1143.69
1333,50018070,2023-01-31,0.0,450.64
4646,50018070,2023-02-03,-656.3,-205.65999999999997
6338,50018070,2023-02-05,112.93,-92.7299999999999
4647,50018070,2023-02-08,-92.25,-184.9799999999999
4648,50018070,2023-02-10,-90.3,-275.28
1334,50024545,2023-01-31,0.0,867.21
4838,50024545,2023-02-03,84.79,952.0
7573,50024545,2023-02-07,-605.2,346.79999999999995
7572,50024545,2023-02-07,-113.13,233.66999999999996
4839,50024545,2023-02-09,180.04,413.7099999999999
7575,50024545,2023-02-11,-1733.6,-1319.8899999999999
7574,50024545,2023-02-11,-122.19,-1442.08
7576,50024545,2023-02-13,-71.7,-1513.7799999999997
7577,50024545,2023-02-13,-37.47,-1551.25
1335,50031425,2023-01-31,0.0,695.18
3807,50031425,2023-02-03,115.16,810.3399999999999
3806,50031425,2023-02-03,493.5,1303.84
3808,50031425,2023-02-07,124.56,1428.4
3809,50031425,2023-02-10,180.01,1608.4099999999999
8584,50031425,2023-02-12,-124.59,1483.82
3810,50031425,2023-02-14,42.03,1525.85
1336,50114041,2023-01-31,0.0,60.83
7026,50114041,2023-02-06,-152.43,-91.60000000000001
1337,50115324,2023-01-31,0.0,329.32
20,50115324,2023-02-01,80.86,410.18
4790,50115324,2023-02-03,-130.53,279.65
21,50115324,2023-02-03,46.85,326.5
22,50115324,2023-02-08,120.55,447.04999999999995
23,50115324,2023-02-12,170.71,617.76
4792,50115324,2023-02-13,-813.5,-195.73999999999995
4791,50115324,2023-02-13,-130.18,-325.92
24,50115324,2023-02-13,33.78,-292.13999999999993
1338,50122119,2023-01-31,0.0,264.61
795,50122119,2023-02-01,774.6,1039.21
4708,50122119,2023-02-03,-33.17,1006.0400000000001
4709,50122119,2023-02-12,-970.8,35.24000000000012
796,50122119,2023-02-12,18.99,54.23000000000013
1339,50132654,2023-01-31,0.0,562.17
3490,50132654,2023-02-02,177.5,739.67
5322,50132654,2023-02-04,-97.84,641.8299999999999
3491,50132654,2023-02-05,168.74,810.5699999999999
3492,50132654,2023-02-07,88.86,899.43
3493,50132654,2023-02-08,63.1,962.53
5323,50132654,2023-02-09,-89.08,873.4499999999999
3494,50132654,2023-02-12,117.48,990.93
5324,50132654,2023-02-14,-88.1,902.8299999999999
1340,50150279,2023-01-31,0.0,567.24
6022,50150279,2023-02-05,-74.52,492.72
6775,50150279,2023-02-06,106.53,599.25
6776,50150279,2023-02-09,62.92,662.1700000000001
1341,50161801,2023-01-31,0.0,180.69
3404,50161801,2023-02-02,100.46,281.15
3403,50161801,2023-02-02,174.75,455.9
3405,50161801,2023-02-03,89.51,545.41
3406,50161801,2023-02-03,108.09,653.5
3407,50161801,2023-02-03,172.24,825.74
3408,50161801,2023-02-07,113.43,939.1700000000001
3409,50161801,2023-02-08,78.98,1018.1500000000001
8107,50161801,2023-02-09,-188.3,829.8500000000001
3410,50161801,2023-02-10,144.1,973.95
3411,50161801,2023-02-11,105.27,1079.22
3412,50161801,2023-02-14,1674.0,2753.22
1342,50217872,2023-01-31,0.0,667.95
3048,50217872,2023-02-02,65.93,733.8800000000001
4448,50217872,2023-02-03,-625.5,108.38000000000011
4449,50217872,2023-02-07,-70.62,37.760000000000105
4450,50217872,2023-02-08,-120.31,-82.54999999999995
4451,50217872,2023-02-10,-63.32,-145.8699999999999
4452,50217872,2023-02-11,-47.32,-193.18999999999994
3049,50217872,2023-02-11,139.07,-54.11999999999989
4453,50217872,2023-02-13,-119.03,-173.14999999999986
3050,50217872,2023-02-14,735.5,562.3500000000001
1343,50219545,2023-01-31,0.0,548.12
812,50219545,2023-02-01,1057.7,1605.8200000000002
6886,50219545,2023-02-06,-50.67,1555.15
813,50219545,2023-02-07,124.42,1679.5700000000002
6887,50219545,2023-02-11,-818.2,861.37
814,50219545,2023-02-14,1209.0,2070.37
1344,50231864,2023-01-31,0.0,117.34
3475,50231864,2023-02-02,-128.36,-11.02000000000001
2776,50231864,2023-02-02,135.95,124.92999999999998
3476,50231864,2023-02-04,-134.46,-9.53000000000003
2777,50231864,2023-02-07,29.79,20.259999999999962
2778,50231864,2023-02-07,150.57,170.82999999999996
2779,50231864,2023-02-10,148.04,318.86999999999995
2780,50231864,2023-02-14,178.04,496.90999999999997
1345,50276595,2023-01-31,0.0,686.91
499,50276595,2023-02-01,-102.6,584.31
500,50276595,2023-02-03,-98.41,485.9
501,50276595,2023-02-03,-88.33,397.57
5477,50276595,2023-02-04,86.9,484.46999999999997
5478,50276595,2023-02-06,1107.9,1592.37
502,50276595,2023-02-11,-146.95,1445.42
503,50276595,2023-02-11,-81.2,1364.22
5479,50276595,2023-02-11,88.16,1452.38
504,50276595,2023-02-12,-55.85,1396.53
1346,50324230,2023-01-31,0.0,945.15
6334,50324230,2023-02-05,-145.13,800.02
6333,50324230,2023-02-05,-64.51,735.51
6335,50324230,2023-02-07,-1380.5,-644.9899999999999
6336,50324230,2023-02-09,-95.64,-740.63
1347,50335174,2023-01-31,0.0,650.98
6421,50335174,2023-02-05,-99.24,551.74
8106,50335174,2023-02-09,157.79,709.53
8105,50335174,2023-02-09,176.84,886.37
8107,50335174,2023-02-11,194.38,1080.75
8108,50335174,2023-02-14,14.98,1095.73
1348,50360111,2023-01-31,0.0,193.83
3300,50360111,2023-02-02,40.94,234.77
3301,50360111,2023-02-05,183.09,417.86
3302,50360111,2023-02-12,26.59,444.45000000000005
1349,50402197,2023-01-31,0.0,717.07
829,50402197,2023-02-01,-469.6,247.47000000000003
830,50402197,2023-02-01,-65.02,182.45000000000005
831,50402197,2023-02-02,-962.8,-780.35
6026,50402197,2023-02-05,69.93,-710.42
6025,50402197,2023-02-05,75.06,-635.3599999999998
6028,50402197,2023-02-11,66.39,-568.9699999999999
6027,50402197,2023-02-11,167.56,-401.40999999999997
832,50402197,2023-02-12,-109.08,-510.4899999999999
1350,50428641,2023-01-31,0.0,271.51
6597,50428641,2023-02-05,-102.38,169.13
6598,50428641,2023-02-07,-119.18,49.94999999999999
7396,50428641,2023-02-07,62.85,112.79999999999998
6599,50428641,2023-02-09,-126.46,-13.659999999999968
7397,50428641,2023-02-10,186.7,173.04
7398,50428641,2023-02-13,101.21,274.25
1351,50463777,2023-01-31,0.0,143.45
5613,50463777,2023-02-04,-83.95,59.499999999999986
7698,50463777,2023-02-08,64.87,124.36999999999999
5614,50463777,2023-02-09,-90.79,33.579999999999984
5615,50463777,2023-02-13,-80.9,-47.32000000000002
5617,50463777,2023-02-14,-154.58,-201.90000000000003
5618,50463777,2023-02-14,-150.33,-352.2300000000001
5616,50463777,2023-02-14,-73.71,-425.94
1352,50520009,2023-01-31,0.0,892.55
5244,50520009,2023-02-04,-68.1,824.4499999999999
5245,50520009,2023-02-06,-136.61,687.8399999999999
7946,50520009,2023-02-08,1808.4,2496.24
5246,50520009,2023-02-12,-68.89,2427.35
7947,50520009,2023-02-13,145.1,2572.45
7948,50520009,2023-02-14,137.73,2710.1800000000003
1353,50547726,2023-01-31,0.0,675.06
5173,50547726,2023-02-04,46.13,721.1899999999999
5172,50547726,2023-02-04,143.88,865.0699999999999
7284,50547726,2023-02-07,-1070.1,-205.02999999999997
7285,50547726,2023-02-08,-121.72,-326.75
7286,50547726,2023-02-10,-106.19,-432.94000000000005
7287,50547726,2023-02-11,-132.76,-565.7
1354,50610780,2023-01-31,0.0,536.41
2772,50610780,2023-02-02,-166.35,370.05999999999995
2263,50610780,2023-02-02,133.59,503.65
2773,50610780,2023-02-05,-2112.8,-1609.1500000000005
2774,50610780,2023-02-06,-436.1,-2045.2500000000005
2264,50610780,2023-02-07,737.4,-1307.8500000000004
2775,50610780,2023-02-08,-251.9,-1559.7500000000005
2776,50610780,2023-02-10,-127.71,-1687.4600000000005
2265,50610780,2023-02-12,81.53,-1605.9300000000007
2266,50610780,2023-02-13,89.42,-1516.5100000000007
1355,50624960,2023-01-31,0.0,5.03
5921,50624960,2023-02-04,-26.76,-21.73
5922,50624960,2023-02-11,-119.87,-141.6
8457,50624960,2023-02-11,159.09,17.48999999999998
5923,50624960,2023-02-12,-113.72,-96.23000000000002
5924,50624960,2023-02-13,-126.46,-222.69000000000003
8458,50624960,2023-02-13,167.76,-54.930000000000035
1356,50627436,2023-01-31,0.0,183.41
2169,50627436,2023-02-02,30.52,213.93
2170,50627436,2023-02-04,48.4,262.33
6005,50627436,2023-02-05,-103.36,158.96999999999997
2171,50627436,2023-02-07,62.35,221.32
2172,50627436,2023-02-07,146.5,367.82
6006,50627436,2023-02-08,-162.59,205.23
2173,50627436,2023-02-08,473.2,678.43
6007,50627436,2023-02-09,-113.82,564.61
6008,50627436,2023-02-10,-90.73,473.88
2174,50627436,2023-02-14,105.03,578.91
1357,50647892,2023-01-31,0.0,540.71
4418,50647892,2023-02-03,121.58,662.2900000000001
5059,50647892,2023-02-04,-180.29,482.00000000000006
4421,50647892,2023-02-05,23.88,505.88000000000005
4419,50647892,2023-02-05,95.98,601.86
4420,50647892,2023-02-05,212.21,814.07
4422,50647892,2023-02-06,120.78,934.85
4423,50647892,2023-02-10,94.84,1029.69
1358,50693024,2023-01-31,0.0,171.87
3280,50693024,2023-02-02,147.71,319.58000000000004
6030,50693024,2023-02-05,-100.33,219.25
6031,50693024,2023-02-09,-54.92,164.33
3281,50693024,2023-02-09,115.1,279.43
6032,50693024,2023-02-10,-98.76,180.67000000000002
3282,50693024,2023-02-13,35.47,216.14
3283,50693024,2023-02-14,139.82,355.96
1359,50756739,2023-01-31,0.0,177.65
3543,50756739,2023-02-02,79.3,256.95
6888,50756739,2023-02-06,-159.04,97.91000000000001
3544,50756739,2023-02-07,78.73,176.64000000000001
3545,50756739,2023-02-07,94.27,270.91
3546,50756739,2023-02-09,167.25,438.15999999999997
3547,50756739,2023-02-12,20.21,458.37
3548,50756739,2023-02-13,25.66,484.03
3549,50756739,2023-02-13,106.08,590.11
1360,50772829,2023-01-31,0.0,47.57
8208,50772829,2023-02-10,115.74,163.31
8435,50772829,2023-02-11,-63.01,100.3
8436,50772829,2023-02-12,-1278.9,-1178.6000000000001
8209,50772829,2023-02-12,76.84,-1101.7600000000002
8210,50772829,2023-02-12,200.04,-901.72
8212,50772829,2023-02-13,66.5,-835.22
8211,50772829,2023-02-13,79.92,-755.3000000000001
8213,50772829,2023-02-14,836.0,80.69999999999987
1361,50813708,2023-01-31,0.0,339.04
1829,50813708,2023-02-01,172.78,511.82000000000005
4121,50813708,2023-02-03,-140.36,371.46000000000004
4122,50813708,2023-02-04,-97.67,273.79
4123,50813708,2023-02-05,-108.33,165.46
1830,50813708,2023-02-05,45.47,210.93
4124,50813708,2023-02-06,-28.34,182.59
1831,50813708,2023-02-08,167.66,350.25
1832,50813708,2023-02-10,9.75,360.0
4125,50813708,2023-02-13,-84.2,275.8
1362,50837270,2023-01-31,0.0,613.53
3261,50837270,2023-02-02,147.44,760.97
5768,50837270,2023-02-04,-105.81,655.16
3262,50837270,2023-02-12,114.06,769.22
5769,50837270,2023-02-13,-437.5,331.71999999999997
3263,50837270,2023-02-14,66.68,398.4
1363,50880352,2023-01-31,0.0,12.46
6475,50880352,2023-02-05,-133.1,-120.63999999999999
6476,50880352,2023-02-06,-59.59,-180.23
7800,50880352,2023-02-08,19.59,-160.64
7801,50880352,2023-02-09,205.74,45.100000000000016
1364,50887252,2023-01-31,0.0,464.78
4795,50887252,2023-02-03,56.35,521.13
5222,50887252,2023-02-04,-119.53,401.59999999999997
4796,50887252,2023-02-05,772.5,1174.1
4797,50887252,2023-02-06,210.36,1384.46
4798,50887252,2023-02-09,137.17,1521.63
4799,50887252,2023-02-09,175.48,1697.11
4800,50887252,2023-02-10,104.93,1802.04
5223,50887252,2023-02-14,-129.59,1672.45
1365,50893310,2023-01-31,0.0,185.13
7041,50893310,2023-02-06,90.19,275.32
7042,50893310,2023-02-08,104.32,379.64
7043,50893310,2023-02-12,130.06,509.7
8609,50893310,2023-02-13,-69.71,439.99
1366,50959802,2023-01-31,0.0,821.37
1143,50959802,2023-02-01,-97.11,724.26
2400,50959802,2023-02-02,1436.3,2160.56
1144,50959802,2023-02-10,-221.22,1939.3400000000001
2401,50959802,2023-02-14,1157.1,3096.4399999999996
1367,51079213,2023-01-31,0.0,783.58
1332,51079213,2023-02-01,-70.27,713.3100000000001
4743,51079213,2023-02-03,80.5,793.8100000000001
1333,51079213,2023-02-05,-184.06,609.75
1334,51079213,2023-02-05,-144.1,465.6500000000001
1335,51079213,2023-02-07,-61.01,404.64000000000004
4744,51079213,2023-02-08,187.24,591.8800000000001
1336,51079213,2023-02-11,-26.87,565.0100000000001
1337,51079213,2023-02-14,-70.52,494.49000000000007
1368,51102699,2023-01-31,0.0,626.91
3678,51102699,2023-02-02,-56.94,569.97
3679,51102699,2023-02-08,-168.14,401.83
8341,51102699,2023-02-10,94.45,496.28
3680,51102699,2023-02-12,-66.33,429.95
8342,51102699,2023-02-13,38.04,467.99
1369,51122335,2023-01-31,0.0,219.24
2524,51122335,2023-02-02,-150.2,69.04000000000002
7705,51122335,2023-02-08,42.88,111.92000000000002
2525,51122335,2023-02-10,-88.04,23.880000000000024
1370,51198722,2023-01-31,0.0,559.63
6873,51198722,2023-02-06,-1045.4,-485.7700000000001
6874,51198722,2023-02-06,-995.2,-1480.9700000000003
6875,51198722,2023-02-07,-19.21,-1500.1799999999998
7613,51198722,2023-02-07,1035.2,-464.98000000000013
1371,51266306,2023-01-31,0.0,163.99
1064,51266306,2023-02-01,-92.86,71.13000000000001
278,51266306,2023-02-01,1187.7,1258.8300000000002
279,51266306,2023-02-04,118.6,1377.43
1065,51266306,2023-02-05,-118.23,1259.2
1372,51272805,2023-01-31,0.0,135.47
408,51272805,2023-02-01,-103.94,31.53
1269,51272805,2023-02-01,153.9,185.43
409,51272805,2023-02-03,-718.2,-532.77
1270,51272805,2023-02-05,43.28,-489.49
410,51272805,2023-02-12,-82.2,-571.6899999999999
1271,51272805,2023-02-13,105.95,-465.74
1373,51298007,2023-01-31,0.0,427.17
5117,51298007,2023-02-04,73.7,500.87
6223,51298007,2023-02-05,-848.7,-347.83
6224,51298007,2023-02-07,-1613.2,-1961.0299999999997
5118,51298007,2023-02-09,96.82,-1864.21
5119,51298007,2023-02-09,137.44,-1726.77
6225,51298007,2023-02-12,-104.78,-1831.5500000000002
5120,51298007,2023-02-12,89.55,-1742.0
1374,51313899,2023-01-31,0.0,189.04
2040,51313899,2023-02-01,-1072.7,-883.6600000000001
2041,51313899,2023-02-02,-52.11,-935.77
4968,51313899,2023-02-03,1488.0,552.23
4969,51313899,2023-02-04,128.26,680.49
2042,51313899,2023-02-05,-119.88,560.61
2043,51313899,2023-02-06,-91.53,469.08000000000004
4970,51313899,2023-02-07,283.4,752.48
4971,51313899,2023-02-09,1653.1,2405.58
1375,51325070,2023-01-31,0.0,933.4
1964,51325070,2023-02-01,-83.77,849.63
945,51325070,2023-02-01,104.85,954.48
1965,51325070,2023-02-02,-154.85,799.63
947,51325070,2023-02-03,4.02,803.65
946,51325070,2023-02-03,61.29,864.9399999999999
948,51325070,2023-02-04,183.25,1048.19
949,51325070,2023-02-05,40.03,1088.22
1966,51325070,2023-02-06,-8.04,1080.18
951,51325070,2023-02-06,28.71,1108.8899999999999
950,51325070,2023-02-06,53.53,1162.42
1967,51325070,2023-02-07,-99.21,1063.21
952,51325070,2023-02-08,31.2,1094.4099999999999
953,51325070,2023-02-08,96.43,1190.84
954,51325070,2023-02-11,106.02,1296.8600000000001
1968,51325070,2023-02-12,-99.56,1197.3
1376,51353910,2023-01-31,0.0,523.88
7595,51353910,2023-02-07,-146.17,377.71000000000004
8071,51353910,2023-02-09,40.77,418.48
1377,51358248,2023-01-31,0.0,222.93
2639,51358248,2023-02-02,-179.19,43.74000000000001
8346,51358248,2023-02-10,127.71,171.45
8347,51358248,2023-02-14,42.94,214.39
8348,51358248,2023-02-14,130.09,344.48
1378,51389636,2023-01-31,0.0,917.98
3051,51389636,2023-02-02,-177.36,740.62
3050,51389636,2023-02-02,-109.29,631.3299999999999
3052,51389636,2023-02-09,-79.33,552.0
1379,51398784,2023-01-31,0.0,909.2
7546,51398784,2023-02-07,313.5,1222.7
7547,51398784,2023-02-13,11.11,1233.81
1380,51401655,2023-01-31,0.0,877.47
2589,51401655,2023-02-02,-121.58,755.89
5452,51401655,2023-02-04,62.69,818.58
5453,51401655,2023-02-04,97.26,915.84
5454,51401655,2023-02-05,200.77,1116.6100000000001
1381,51435617,2023-01-31,0.0,140.46
4817,51435617,2023-02-03,110.67,251.13
6668,51435617,2023-02-05,-87.66,163.47000000000003
4818,51435617,2023-02-06,133.2,296.66999999999996
6669,51435617,2023-02-12,-76.51,220.15999999999997
6670,51435617,2023-02-12,-55.39,164.76999999999998
4819,51435617,2023-02-13,18.93,183.7
1382,51450938,2023-01-31,0.0,157.37
6842,51450938,2023-02-06,98.21,255.57999999999998
6843,51450938,2023-02-07,150.92,406.5
8258,51450938,2023-02-10,-67.01,339.48999999999995
1383,51471469,2023-01-31,0.0,611.19
6110,51471469,2023-02-05,-103.21,507.9800000000001
6111,51471469,2023-02-10,-1725.1,-1217.12
6112,51471469,2023-02-12,-50.94,-1268.06
1384,51493379,2023-01-31,0.0,436.15
2039,51493379,2023-02-01,69.52,505.66999999999996
7955,51493379,2023-02-08,-49.64,456.03
1385,51504474,2023-01-31,0.0,153.25
1027,51504474,2023-02-01,219.71,372.96000000000004
1028,51504474,2023-02-04,18.25,391.21000000000004
1029,51504474,2023-02-04,68.14,459.35
7427,51504474,2023-02-07,-123.24,336.11
7428,51504474,2023-02-08,-1254.7,-918.5900000000001
1030,51504474,2023-02-09,134.52,-784.0699999999999
7429,51504474,2023-02-12,-126.99,-911.06
7430,51504474,2023-02-13,-69.63,-980.6899999999998
1386,51653690,2023-01-31,0.0,280.41
331,51653690,2023-02-01,-78.4,202.01000000000002
2719,51653690,2023-02-02,127.6,329.61
332,51653690,2023-02-06,-179.58,150.03
2720,51653690,2023-02-08,837.3,987.3299999999999
1387,51653868,2023-01-31,0.0,410.88
3538,51653868,2023-02-02,-179.94,230.94
4884,51653868,2023-02-03,104.0,334.94
4885,51653868,2023-02-04,77.66,412.6
3539,51653868,2023-02-06,-138.83,273.77
3540,51653868,2023-02-07,-43.63,230.14
4886,51653868,2023-02-07,89.6,319.74
4887,51653868,2023-02-09,53.97,373.71
3541,51653868,2023-02-10,-624.8,-251.09000000000003
3542,51653868,2023-02-10,-91.66,-342.75
4888,51653868,2023-02-10,1046.8,704.05
3543,51653868,2023-02-12,-48.09,655.9599999999999
4889,51653868,2023-02-13,30.31,686.27
3544,51653868,2023-02-14,-132.75,553.52
4890,51653868,2023-02-14,159.73,713.25
1388,51718829,2023-01-31,0.0,260.45
5556,51718829,2023-02-04,-905.4,-644.95
5557,51718829,2023-02-05,-860.7,-1505.6499999999999
6531,51718829,2023-02-05,181.23,-1324.42
5558,51718829,2023-02-06,-58.84,-1383.26
6532,51718829,2023-02-08,189.92,-1193.34
5559,51718829,2023-02-09,-1043.8,-2237.1400000000003
6533,51718829,2023-02-13,813.5,-1423.6399999999999
5560,51718829,2023-02-14,-99.88,-1523.5199999999998
1389,51771015,2023-01-31,0.0,876.29
5402,51771015,2023-02-04,87.1,963.39
6689,51771015,2023-02-05,-159.59,803.8
5403,51771015,2023-02-07,100.32,904.1199999999999
5404,51771015,2023-02-11,147.31,1051.4299999999998
5405,51771015,2023-02-11,1035.1,2086.5299999999997
5406,51771015,2023-02-12,115.87,2202.3999999999996
6690,51771015,2023-02-14,-85.81,2116.5899999999997
1390,51774315,2023-01-31,0.0,291.01
7003,51774315,2023-02-06,98.97,389.98
7004,51774315,2023-02-07,38.62,428.6
7005,51774315,2023-02-10,55.88,484.48
8395,51774315,2023-02-11,-101.84,382.64
8396,51774315,2023-02-12,-78.98,303.65999999999997
1391,51793205,2023-01-31,0.0,715.25
3397,51793205,2023-02-02,1902.2,2617.45
7646,51793205,2023-02-07,-176.26,2441.19
7647,51793205,2023-02-08,-133.59,2307.6000000000004
1392,51906599,2023-01-31,0.0,174.48
1009,51906599,2023-02-01,-125.14,49.33999999999999
5883,51906599,2023-02-04,36.24,85.57999999999998
1011,51906599,2023-02-06,-84.58,1.0
1010,51906599,2023-02-06,-55.84,-54.84
5884,51906599,2023-02-08,53.25,-1.5900000000000034
1012,51906599,2023-02-10,-86.75,-88.34
5885,51906599,2023-02-13,157.9,69.56
1393,52104303,2023-01-31,0.0,810.97
3902,52104303,2023-02-03,99.85,910.82
5172,52104303,2023-02-04,-77.13,833.69
5173,52104303,2023-02-06,-87.57,746.12
5174,52104303,2023-02-09,-1530.9,-784.78
1394,52117174,2023-01-31,0.0,932.96
4166,52117174,2023-02-03,-120.56,812.4000000000001
4167,52117174,2023-02-05,-91.78,720.62
4168,52117174,2023-02-08,-43.73,676.8900000000001
4169,52117174,2023-02-09,-1131.6,-454.7099999999998
4170,52117174,2023-02-09,-59.54,-514.2499999999998
1395,52125171,2023-01-31,0.0,973.17
1490,52125171,2023-02-01,112.77,1085.94
1491,52125171,2023-02-02,132.64,1218.58
1492,52125171,2023-02-05,101.6,1320.1799999999998
8118,52125171,2023-02-09,-63.75,1256.4299999999998
1396,52127978,2023-01-31,0.0,84.8
8002,52127978,2023-02-08,-603.0,-518.2
8003,52127978,2023-02-09,-25.95,-544.1500000000001
8004,52127978,2023-02-12,-134.36,-678.51
8591,52127978,2023-02-12,13.57,-664.94
1397,52141048,2023-01-31,0.0,102.68
4036,52141048,2023-02-03,153.58,256.26
4037,52141048,2023-02-04,31.94,288.20000000000005
4038,52141048,2023-02-07,852.6,1140.8000000000002
4039,52141048,2023-02-08,122.19,1262.99
4040,52141048,2023-02-11,144.17,1407.16
1398,52146995,2023-01-31,0.0,322.52
2004,52146995,2023-02-01,69.4,391.91999999999996
2290,52146995,2023-02-02,-71.52,320.4
2005,52146995,2023-02-02,507.1,827.5
2291,52146995,2023-02-05,-108.08,719.4200000000001
2292,52146995,2023-02-05,-49.2,670.22
2006,52146995,2023-02-07,135.72,805.94
2007,52146995,2023-02-09,36.71,842.65
2293,52146995,2023-02-11,-93.53,749.12
2294,52146995,2023-02-12,-934.0,-184.88
2008,52146995,2023-02-14,108.65,-76.23000000000002
1399,52203356,2023-01-31,0.0,899.39
4924,52203356,2023-02-03,83.25,982.64
6571,52203356,2023-02-05,-168.74,813.9
4925,52203356,2023-02-05,189.35,1003.25
4926,52203356,2023-02-08,1316.4,2319.65
4927,52203356,2023-02-11,51.73,2371.38
1400,52213806,2023-01-31,0.0,597.62
8597,52213806,2023-02-12,54.1,651.72
8599,52213806,2023-02-14,10.22,661.94
8598,52213806,2023-02-14,97.06,759.0
1401,52230539,2023-01-31,0.0,394.34
4682,52230539,2023-02-03,-23.24,371.09999999999997
8566,52230539,2023-02-12,197.45,568.55
4683,52230539,2023-02-13,-149.9,418.65
4684,52230539,2023-02-14,-87.3,331.34999999999997
1402,52264506,2023-01-31,0.0,934.07
3174,52264506,2023-02-02,-12.87,921.2
6211,52264506,2023-02-05,139.1,1060.3
3175,52264506,2023-02-06,-105.25,955.0500000000001
6212,52264506,2023-02-08,132.78,1087.83
3176,52264506,2023-02-09,-57.45,1030.38
6213,52264506,2023-02-09,139.7,1170.08
3177,52264506,2023-02-13,-35.46,1134.6200000000001
6214,52264506,2023-02-14,60.97,1195.5900000000001
1403,52310499,2023-01-31,0.0,954.51
2487,52310499,2023-02-02,53.0,1007.51
2488,52310499,2023-02-06,81.6,1089.11
2489,52310499,2023-02-14,73.19,1162.3
1404,52317175,2023-01-31,0.0,25.94
8347,52317175,2023-02-10,-90.04,-64.10000000000001
8348,52317175,2023-02-12,-1145.7,-1209.8
8349,52317175,2023-02-12,-145.55,-1355.35
8350,52317175,2023-02-14,-92.17,-1447.52
1405,52365238,2023-01-31,0.0,822.17
8177,52365238,2023-02-09,85.45,907.62
8178,52365238,2023-02-12,92.42,1000.04
1406,52366360,2023-01-31,0.0,465.67
3506,52366360,2023-02-02,-61.66,404.01
4895,52366360,2023-02-03,88.74,492.75
3507,52366360,2023-02-06,-72.88,419.87
4896,52366360,2023-02-06,172.68,592.5500000000001
3508,52366360,2023-02-07,-64.41,528.14
1407,52390463,2023-01-31,0.0,172.82
1738,52390463,2023-02-01,147.58,320.4
2310,52390463,2023-02-02,-534.5,-214.09999999999997
2312,52390463,2023-02-03,-220.83,-434.93
2311,52390463,2023-02-03,-79.16,-514.0899999999999
2313,52390463,2023-02-04,-30.36,-544.45
2314,52390463,2023-02-14,-117.12,-661.5699999999999
1408,52436120,2023-01-31,0.0,904.47
4320,52436120,2023-02-03,109.66,1014.13
4321,52436120,2023-02-07,115.4,1129.53
8428,52436120,2023-02-11,-560.2,569.3299999999999
1409,52442629,2023-01-31,0.0,617.92
4254,52442629,2023-02-03,-1462.8,-844.88
4840,52442629,2023-02-03,196.73,-648.15
4255,52442629,2023-02-11,-145.45,-793.6
4841,52442629,2023-02-12,90.28,-703.32
4842,52442629,2023-02-14,1290.4,587.08
1410,52461586,2023-01-31,0.0,596.3
3067,52461586,2023-02-02,755.8,1352.1
7180,52461586,2023-02-06,-59.42,1292.6799999999998
7181,52461586,2023-02-08,-1026.8,265.88
3068,52461586,2023-02-08,101.89,367.77
1411,52468167,2023-01-31,0.0,369.42
2091,52468167,2023-02-01,-102.76,266.66
2901,52468167,2023-02-02,162.4,429.06
2902,52468167,2023-02-10,48.91,477.97
1412,52480554,2023-01-31,0.0,263.38
5162,52480554,2023-02-04,-130.57,132.81
5163,52480554,2023-02-06,-629.3,-496.4899999999999
5164,52480554,2023-02-10,-85.31,-581.7999999999998
8515,52480554,2023-02-11,122.42,-459.3799999999999
8516,52480554,2023-02-12,68.07,-391.30999999999995
1413,52560688,2023-01-31,0.0,622.16
4843,52560688,2023-02-03,55.81,677.97
4844,52560688,2023-02-04,115.54,793.51
8271,52560688,2023-02-10,-1220.5,-426.9900000000001
8272,52560688,2023-02-11,-1058.7,-1485.6900000000005
8273,52560688,2023-02-11,-108.41,-1594.1000000000004
8274,52560688,2023-02-12,-115.87,-1709.9700000000003
4845,52560688,2023-02-12,127.2,-1582.7700000000004
1414,52747145,2023-01-31,0.0,546.71
3483,52747145,2023-02-02,-107.8,438.91
5788,52747145,2023-02-04,163.28,602.19
3484,52747145,2023-02-09,-155.0,447.19000000000005
3485,52747145,2023-02-11,-107.54,339.65000000000003
3486,52747145,2023-02-12,-165.18,174.47000000000003
1415,52756904,2023-01-31,0.0,428.77
5817,52756904,2023-02-04,-118.08,310.69
6051,52756904,2023-02-05,114.03,424.71999999999997
5819,52756904,2023-02-13,-87.03,337.69
5818,52756904,2023-02-13,-51.57,286.12
5820,52756904,2023-02-14,-67.55,218.57
1416,52805510,2023-01-31,0.0,580.66
8123,52805510,2023-02-09,-85.32,495.34
7965,52805510,2023-02-09,35.39,530.73
8124,52805510,2023-02-10,-153.19,377.53999999999996
7966,52805510,2023-02-13,851.7,1229.24
1417,52814597,2023-01-31,0.0,899.39
459,52814597,2023-02-01,-1821.6,-922.2099999999999
460,52814597,2023-02-06,-25.86,-948.0699999999998
461,52814597,2023-02-10,-831.4,-1779.4699999999998
462,52814597,2023-02-11,-1129.9,-2909.3700000000003
8419,52814597,2023-02-11,43.89,-2865.48
8420,52814597,2023-02-14,7.09,-2858.3900000000003
1418,52835507,2023-01-31,0.0,306.68
211,52835507,2023-02-01,-86.91,219.77
212,52835507,2023-02-03,-32.77,187.0
213,52835507,2023-02-05,-806.2,-619.2
6436,52835507,2023-02-05,109.41,-509.79000000000013
6437,52835507,2023-02-08,95.66,-414.13000000000017
6438,52835507,2023-02-10,1098.2,684.0699999999999
214,52835507,2023-02-13,-262.4,421.6699999999999
6439,52835507,2023-02-14,1053.5,1475.1699999999998
1419,52840001,2023-01-31,0.0,746.12
1633,52840001,2023-02-01,88.19,834.31
5652,52840001,2023-02-04,-101.52,732.79
1634,52840001,2023-02-07,814.4,1547.19
1420,52855120,2023-01-31,0.0,880.21
1454,52855120,2023-02-01,160.48,1040.69
1455,52855120,2023-02-02,161.91,1202.6
5125,52855120,2023-02-04,-72.24,1130.3600000000001
1456,52855120,2023-02-09,105.82,1236.18
5126,52855120,2023-02-10,-61.16,1175.02
5127,52855120,2023-02-11,-174.19,1000.83
5128,52855120,2023-02-12,-1640.8,-639.9699999999998
1421,52911248,2023-01-31,0.0,430.16
184,52911248,2023-02-01,-161.89,268.27000000000004
185,52911248,2023-02-03,-105.36,162.91000000000003
186,52911248,2023-02-05,-131.72,31.190000000000055
187,52911248,2023-02-07,-162.23,-131.0399999999999
7907,52911248,2023-02-08,72.19,-58.849999999999966
191,52911248,2023-02-10,-2084.1,-2142.95
188,52911248,2023-02-10,-951.2,-3094.1500000000005
189,52911248,2023-02-10,-134.99,-3229.1400000000003
190,52911248,2023-02-10,-83.95,-3313.09
193,52911248,2023-02-12,-129.73,-3442.82
192,52911248,2023-02-12,-125.47,-3568.2900000000004
7908,52911248,2023-02-13,63.98,-3504.3100000000004
1422,52973634,2023-01-31,0.0,417.09
2770,52973634,2023-02-02,80.01,497.09999999999997
2771,52973634,2023-02-02,104.98,602.0799999999999
2772,52973634,2023-02-03,372.2,974.28
8469,52973634,2023-02-11,-129.35,844.9300000000001
2773,52973634,2023-02-11,6.54,851.47
2774,52973634,2023-02-12,172.13,1023.5999999999999
2775,52973634,2023-02-13,134.58,1158.18
1423,52996436,2023-01-31,0.0,883.35
330,52996436,2023-02-01,86.03,969.38
3950,52996436,2023-02-03,-173.67,795.71
3951,52996436,2023-02-08,-95.66,700.0500000000001
3952,52996436,2023-02-14,-1290.4,-590.35
1424,53006272,2023-01-31,0.0,761.95
4641,53006272,2023-02-03,134.35,896.3000000000001
7096,53006272,2023-02-06,-90.64,805.6600000000001
7097,53006272,2023-02-08,-88.99,716.6700000000001
4642,53006272,2023-02-08,160.1,876.77
4643,53006272,2023-02-14,157.14,1033.91
1425,53010345,2023-01-31,0.0,131.63
7079,53010345,2023-02-06,-123.61,8.019999999999996
7080,53010345,2023-02-10,-145.54,-137.51999999999998
8226,53010345,2023-02-10,169.0,31.47999999999999
8227,53010345,2023-02-14,88.77,120.24999999999999
1426,53046005,2023-01-31,0.0,669.82
922,53046005,2023-02-01,36.43,706.25
923,53046005,2023-02-02,52.25,758.5
5530,53046005,2023-02-04,-58.03,700.47
5531,53046005,2023-02-06,-129.51,570.96
5532,53046005,2023-02-13,-125.85,445.11000000000007
925,53046005,2023-02-13,74.51,519.6200000000001
924,53046005,2023-02-13,157.27,676.8900000000001
1427,53059420,2023-01-31,0.0,531.72
963,53059420,2023-02-01,-97.79,433.93
964,53059420,2023-02-02,-129.83,304.1
7478,53059420,2023-02-07,140.37,444.47
7479,53059420,2023-02-07,198.21,642.6800000000001
1428,53079883,2023-01-31,0.0,489.35
6386,53079883,2023-02-05,-150.73,338.62
6387,53079883,2023-02-05,-115.08,223.54000000000002
6388,53079883,2023-02-09,-257.1,-33.56000000000006
6389,53079883,2023-02-10,-550.8,-584.36
8664,53079883,2023-02-14,10.57,-573.7900000000001
1429,53085668,2023-01-31,0.0,199.11
6102,53085668,2023-02-05,-75.06,124.05000000000001
6620,53085668,2023-02-05,106.54,230.59000000000003
6103,53085668,2023-02-07,-945.2,-714.61
6104,53085668,2023-02-10,-101.56,-816.17
6105,53085668,2023-02-11,-117.16,-933.33
6106,53085668,2023-02-14,-24.04,-957.37
6621,53085668,2023-02-14,41.25,-916.12
1430,53086727,2023-01-31,0.0,408.74
3581,53086727,2023-02-02,115.29,524.03
8370,53086727,2023-02-10,-1362.1,-838.0699999999999
1431,53089607,2023-01-31,0.0,567.87
207,53089607,2023-02-01,161.89,729.76
208,53089607,2023-02-02,147.42,877.18
6360,53089607,2023-02-05,-176.88,700.3
209,53089607,2023-02-11,161.33,861.63
6361,53089607,2023-02-12,-137.14,724.49
210,53089607,2023-02-13,71.18,795.6700000000001
1432,53091928,2023-01-31,0.0,235.6
2793,53091928,2023-02-02,-248.7,-13.099999999999994
2794,53091928,2023-02-06,-128.13,-141.23
2795,53091928,2023-02-07,-166.24,-307.4699999999999
7668,53091928,2023-02-07,1741.9,1434.43
2796,53091928,2023-02-09,-114.01,1320.42
7669,53091928,2023-02-11,28.8,1349.22
7670,53091928,2023-02-12,37.22,1386.44
1433,53107499,2023-01-31,0.0,237.09
1040,53107499,2023-02-01,83.86,320.95
8014,53107499,2023-02-09,-58.86,262.09000000000003
8015,53107499,2023-02-13,-70.54,191.55
1041,53107499,2023-02-13,168.68,360.23
8016,53107499,2023-02-14,-40.13,320.1
1434,53161068,2023-01-31,0.0,945.53
3575,53161068,2023-02-02,177.36,1122.8899999999999
3574,53161068,2023-02-02,962.8,2085.6899999999996
4985,53161068,2023-02-03,-1566.6,519.0899999999999
3576,53161068,2023-02-03,62.59,581.68
4986,53161068,2023-02-04,-69.83,511.8499999999999
4988,53161068,2023-02-05,-480.6,31.249999999999886
4987,53161068,2023-02-05,-81.18,-49.930000000000064
3577,53161068,2023-02-05,91.56,41.62999999999988
3578,53161068,2023-02-07,108.31,149.93999999999983
3580,53161068,2023-02-10,50.5,200.43999999999983
3579,53161068,2023-02-10,107.66,308.0999999999999
1435,53170488,2023-01-31,0.0,219.2
5476,53170488,2023-02-04,-73.5,145.7
7900,53170488,2023-02-08,50.31,196.01
1436,53192110,2023-01-31,0.0,588.04
6733,53192110,2023-02-06,117.46,705.5
7644,53192110,2023-02-07,-53.78,651.7199999999999
7645,53192110,2023-02-14,-88.36,563.3599999999999
1437,53204515,2023-01-31,0.0,689.65
2178,53204515,2023-02-02,83.33,772.98
5756,53204515,2023-02-04,-136.51,636.47
2179,53204515,2023-02-06,114.15,750.62
1438,53211412,2023-01-31,0.0,69.51
6201,53211412,2023-02-05,93.57,163.07999999999998
7231,53211412,2023-02-07,-101.5,61.58
7232,53211412,2023-02-09,-20.18,41.4
7233,53211412,2023-02-11,-197.9,-156.5
6202,53211412,2023-02-11,41.89,-114.61
6203,53211412,2023-02-12,121.68,7.069999999999993
7234,53211412,2023-02-13,-50.68,-43.61
6204,53211412,2023-02-13,902.0,858.39
1439,53234515,2023-01-31,0.0,854.67
38,53234515,2023-02-01,-70.5,784.17
2841,53234515,2023-02-02,54.57,838.74
2842,53234515,2023-02-04,1349.2,2187.94
2843,53234515,2023-02-05,148.33,2336.27
2844,53234515,2023-02-06,8.35,2344.62
1440,53240505,2023-01-31,0.0,188.87
4808,53240505,2023-02-03,119.64,308.51
8653,53240505,2023-02-14,-88.35,220.16000000000003
8652,53240505,2023-02-14,-37.21,182.95000000000002
1441,53260868,2023-01-31,0.0,966.85
400,53260868,2023-02-01,208.23,1175.08
401,53260868,2023-02-02,134.24,1309.3200000000002
7436,53260868,2023-02-07,-1429.1,-119.77999999999986
402,53260868,2023-02-10,97.78,-21.999999999999886
7437,53260868,2023-02-12,-25.98,-47.979999999999905
1442,53332086,2023-01-31,0.0,273.51
4945,53332086,2023-02-03,-98.44,175.07
6804,53332086,2023-02-06,114.95,290.02
6805,53332086,2023-02-06,116.99,407.01
4946,53332086,2023-02-09,-85.45,321.56
4947,53332086,2023-02-12,-79.05,242.51
4948,53332086,2023-02-14,-59.91,182.6
1443,53366488,2023-01-31,0.0,337.18
1475,53366488,2023-02-01,115.41,452.59000000000003
3004,53366488,2023-02-02,-104.72,347.87
1476,53366488,2023-02-03,110.54,458.41
3005,53366488,2023-02-04,-134.24,324.17
1477,53366488,2023-02-07,107.54,431.71000000000004
3006,53366488,2023-02-10,-102.92,328.79
1478,53366488,2023-02-13,76.11,404.9
1444,53376344,2023-01-31,0.0,228.65
2910,53376344,2023-02-02,81.01,309.66
4864,53376344,2023-02-03,-133.94,175.72000000000003
2911,53376344,2023-02-04,35.52,211.24
2912,53376344,2023-02-05,85.78,297.02
2913,53376344,2023-02-14,1365.0,1662.02
1445,53380359,2023-01-31,0.0,0.81
651,53380359,2023-02-01,-133.29,-132.48
5647,53380359,2023-02-04,78.39,-54.08999999999999
653,53380359,2023-02-08,-128.8,-182.89
654,53380359,2023-02-08,-113.92,-296.81
652,53380359,2023-02-08,-49.6,-346.40999999999997
5648,53380359,2023-02-08,134.23,-212.18
5649,53380359,2023-02-13,384.8,172.62
5650,53380359,2023-02-13,767.3,939.9199999999998
1446,53421312,2023-01-31,0.0,937.86
4149,53421312,2023-02-03,-40.39,897.47
4150,53421312,2023-02-04,-199.43,698.04
5776,53421312,2023-02-04,44.37,742.4100000000001
4151,53421312,2023-02-07,-13.71,728.7
5777,53421312,2023-02-08,135.45,864.15
4152,53421312,2023-02-11,-69.79,794.36
5778,53421312,2023-02-12,126.99,921.35
1447,53496996,2023-01-31,0.0,303.15
1407,53496996,2023-02-01,146.28,449.42999999999995
1408,53496996,2023-02-02,74.71,524.14
5982,53496996,2023-02-05,-106.43,417.71
1409,53496996,2023-02-07,95.78,513.49
1410,53496996,2023-02-11,149.19,662.68
1411,53496996,2023-02-12,107.03,769.7099999999999
1448,53502347,2023-01-31,0.0,18.89
510,53502347,2023-02-01,-490.9,-472.01
1946,53502347,2023-02-01,84.14,-387.87
511,53502347,2023-02-08,-123.06,-510.92999999999995
1947,53502347,2023-02-10,133.46,-377.46999999999997
512,53502347,2023-02-14,-1469.3,-1846.7699999999998
513,53502347,2023-02-14,-208.0,-2054.77
1449,53513558,2023-01-31,0.0,235.44
2630,53513558,2023-02-02,-100.89,134.55
2631,53513558,2023-02-04,-155.63,-21.079999999999984
2632,53513558,2023-02-05,-700.4,-721.48
7809,53513558,2023-02-08,161.43,-560.05
7810,53513558,2023-02-09,59.28,-500.7699999999999
1450,53518299,2023-01-31,0.0,953.96
1016,53518299,2023-02-01,-116.27,837.69
7795,53518299,2023-02-08,46.43,884.12
1017,53518299,2023-02-10,-134.33,749.79
1451,53538823,2023-01-31,0.0,750.37
6441,53538823,2023-02-05,-78.82,671.55
6442,53538823,2023-02-06,-405.7,265.85
6928,53538823,2023-02-06,23.13,288.98
6443,53538823,2023-02-08,-57.77,231.21000000000004
1452,53634705,2023-01-31,0.0,853.12
5987,53634705,2023-02-05,63.21,916.33
5986,53634705,2023-02-05,151.27,1067.6
8650,53634705,2023-02-14,-223.99,843.61
1453,53665038,2023-01-31,0.0,624.95
2845,53665038,2023-02-02,27.52,652.47
7440,53665038,2023-02-07,-27.75,624.72
7441,53665038,2023-02-09,-255.62,369.1
2846,53665038,2023-02-13,113.04,482.14000000000004
1454,53727603,2023-01-31,0.0,517.25
3346,53727603,2023-02-02,124.68,641.9300000000001
3347,53727603,2023-02-04,92.05,733.98
3348,53727603,2023-02-08,63.18,797.1600000000001
8265,53727603,2023-02-10,-2476.1,-1678.94
8266,53727603,2023-02-11,-1137.9,-2816.84
8267,53727603,2023-02-13,-75.37,-2892.21
3349,53727603,2023-02-13,66.54,-2825.67
1455,53753986,2023-01-31,0.0,252.69
4431,53753986,2023-02-03,-120.33,132.36
4432,53753986,2023-02-04,-1059.1,-926.7399999999998
4433,53753986,2023-02-06,-165.67,-1092.4099999999999
8434,53753986,2023-02-11,80.75,-1011.6599999999999
8435,53753986,2023-02-12,860.8,-150.85999999999984
1456,53754887,2023-01-31,0.0,162.05
3088,53754887,2023-02-02,102.25,264.3
3089,53754887,2023-02-06,149.07,413.37
3090,53754887,2023-02-09,54.92,468.29
1457,53762957,2023-01-31,0.0,245.78
631,53762957,2023-02-01,-101.12,144.66
632,53762957,2023-02-09,-179.65,-34.98999999999998
633,53762957,2023-02-10,-100.16,-135.15
8257,53762957,2023-02-10,149.19,14.039999999999992
634,53762957,2023-02-11,-142.72,-128.68000000000004
635,53762957,2023-02-11,-108.92,-237.6
8258,53762957,2023-02-11,134.16,-103.44000000000003
636,53762957,2023-02-12,-150.86,-254.30000000000004
637,53762957,2023-02-14,-155.82,-410.1200000000001
8259,53762957,2023-02-14,51.9,-358.22
1458,53764356,2023-01-31,0.0,447.88
904,53764356,2023-02-01,83.37,531.25
3061,53764356,2023-02-02,-74.82,456.43
905,53764356,2023-02-02,197.62,654.05
3062,53764356,2023-02-04,-75.94,578.11
906,53764356,2023-02-04,136.2,714.31
3063,53764356,2023-02-07,-84.19,630.12
3064,53764356,2023-02-08,-144.78,485.34000000000003
907,53764356,2023-02-10,65.52,550.86
3065,53764356,2023-02-11,-159.34,391.52
3066,53764356,2023-02-12,-179.93,211.58999999999997
1459,53831793,2023-01-31,0.0,799.66
6774,53831793,2023-02-06,-143.57,656.0899999999999
6776,53831793,2023-02-08,-159.35,496.74
6775,53831793,2023-02-08,-110.44,386.29999999999995
8126,53831793,2023-02-09,103.19,489.49
8127,53831793,2023-02-10,135.89,625.38
8128,53831793,2023-02-13,127.43,752.81
8129,53831793,2023-02-13,1226.1,1978.9099999999999
1460,53845552,2023-01-31,0.0,285.52
6800,53845552,2023-02-06,967.8,1253.32
8173,53845552,2023-02-09,-82.54,1170.78
1461,53845615,2023-01-31,0.0,597.04
6610,53845615,2023-02-05,-47.51,549.53
6611,53845615,2023-02-06,-63.7,485.8299999999999
6828,53845615,2023-02-06,71.0,556.8299999999999
6612,53845615,2023-02-07,-151.21,405.61999999999995
6613,53845615,2023-02-07,-100.78,304.8399999999999
6614,53845615,2023-02-10,-1052.9,-748.0600000000002
6829,53845615,2023-02-10,7.29,-740.7700000000002
1462,53858816,2023-01-31,0.0,539.38
953,53858816,2023-02-01,-92.2,447.18
954,53858816,2023-02-03,-98.53,348.65
955,53858816,2023-02-05,-105.91,242.74
6080,53858816,2023-02-05,33.32,276.06
956,53858816,2023-02-09,-156.03,120.02999999999997
6081,53858816,2023-02-11,1231.3,1351.33
957,53858816,2023-02-12,-113.78,1237.55
1463,53884266,2023-01-31,0.0,21.72
8601,53884266,2023-02-12,185.51,207.23
8624,53884266,2023-02-13,-107.98,99.24999999999999
8623,53884266,2023-02-13,-85.84,13.409999999999982
1464,53884626,2023-01-31,0.0,478.38
3670,53884626,2023-02-02,-1413.6,-935.2199999999999
4981,53884626,2023-02-03,115.71,-819.5099999999999
3671,53884626,2023-02-07,-88.86,-908.37
4982,53884626,2023-02-09,134.0,-774.37
4983,53884626,2023-02-13,74.01,-700.36
4984,53884626,2023-02-13,1525.2,824.84
1465,53887772,2023-01-31,0.0,541.43
3672,53887772,2023-02-02,-109.3,432.12999999999994
2310,53887772,2023-02-02,65.2,497.3299999999999
3673,53887772,2023-02-04,-136.2,361.13
3674,53887772,2023-02-06,-114.95,246.17999999999995
3675,53887772,2023-02-06,-55.36,190.81999999999994
3676,53887772,2023-02-11,-142.53,48.289999999999964
3677,53887772,2023-02-11,-42.19,6.100000000000023
2311,53887772,2023-02-14,102.09,108.18999999999994
1466,53959112,2023-01-31,0.0,103.99
7016,53959112,2023-02-06,60.77,164.76
7017,53959112,2023-02-06,159.06,323.82
7266,53959112,2023-02-07,-71.14,252.68
7018,53959112,2023-02-07,135.7,388.38
7019,53959112,2023-02-08,52.99,441.37
7020,53959112,2023-02-09,102.59,543.96
7267,53959112,2023-02-10,-74.94,469.02
1467,53960481,2023-01-31,0.0,490.82
5590,53960481,2023-02-04,103.05,593.87
5591,53960481,2023-02-06,102.12,695.99
5592,53960481,2023-02-08,74.39,770.38
1468,53971767,2023-01-31,0.0,958.87
42,53971767,2023-02-01,-124.24,834.63
43,53971767,2023-02-02,-61.97,772.6600000000001
1469,53977562,2023-01-31,0.0,398.76
2559,53977562,2023-02-02,-15.93,382.83
2561,53977562,2023-02-06,-173.03,209.79999999999998
2560,53977562,2023-02-06,-140.83,68.96999999999997
7318,53977562,2023-02-07,113.03,181.99999999999997
2562,53977562,2023-02-08,-149.31,32.68999999999994
2563,53977562,2023-02-14,-25.28,7.409999999999968
7319,53977562,2023-02-14,145.08,152.48999999999998
1470,54032229,2023-01-31,0.0,176.12
4937,54032229,2023-02-03,-87.5,88.62
6429,54032229,2023-02-05,148.46,237.08
6430,54032229,2023-02-08,74.13,311.21000000000004
4938,54032229,2023-02-09,-96.2,215.01
4939,54032229,2023-02-13,-1503.4,-1288.3899999999999
1471,54033811,2023-01-31,0.0,534.83
539,54033811,2023-02-01,-188.33,346.5
540,54033811,2023-02-03,-148.95,197.55000000000007
541,54033811,2023-02-03,-62.89,134.66000000000003
6678,54033811,2023-02-06,28.63,163.29000000000002
6677,54033811,2023-02-06,114.86,278.15000000000003
6679,54033811,2023-02-08,133.59,411.74
6680,54033811,2023-02-09,64.47,476.21000000000004
1472,54067346,2023-01-31,0.0,180.91
3399,54067346,2023-02-02,96.8,277.71
3400,54067346,2023-02-08,91.53,369.24
3401,54067346,2023-02-10,57.19,426.42999999999995
8406,54067346,2023-02-11,-158.58,267.85
3402,54067346,2023-02-11,1635.6,1903.45
8407,54067346,2023-02-12,-25.82,1877.63
1473,54071589,2023-01-31,0.0,765.81
4249,54071589,2023-02-03,-117.22,648.5899999999999
4250,54071589,2023-02-09,-107.22,541.3699999999999
4251,54071589,2023-02-11,-726.2,-184.83000000000015
8418,54071589,2023-02-11,58.94,-125.8900000000001
8417,54071589,2023-02-11,119.83,-6.060000000000173
1474,54137851,2023-01-31,0.0,30.67
6014,54137851,2023-02-05,-81.18,-50.510000000000005
8624,54137851,2023-02-13,71.54,21.03
1475,54154999,2023-01-31,0.0,962.14
1172,54154999,2023-02-01,107.18,1069.32
3387,54154999,2023-02-02,-49.14,1020.18
3388,54154999,2023-02-03,-41.91,978.27
3389,54154999,2023-02-05,-142.79,835.48
1173,54154999,2023-02-05,27.88,863.36
1174,54154999,2023-02-07,39.54,902.9
1175,54154999,2023-02-07,102.54,1005.44
1176,54154999,2023-02-08,35.13,1040.57
1476,54189995,2023-01-31,0.0,401.27
4360,54189995,2023-02-03,-13.61,387.65999999999997
5348,54189995,2023-02-04,97.67,485.33
5349,54189995,2023-02-09,158.61,643.94
4361,54189995,2023-02-14,-143.03,500.90999999999997
5350,54189995,2023-02-14,117.23,618.14
1477,54230889,2023-01-31,0.0,597.31
8156,54230889,2023-02-09,-12.69,584.6199999999999
8511,54230889,2023-02-11,75.03,659.65
1478,54278560,2023-01-31,0.0,161.8
1167,54278560,2023-02-01,-167.46,-5.659999999999997
7450,54278560,2023-02-07,92.55,86.89
1168,54278560,2023-02-08,-134.23,-47.339999999999975
1479,54288062,2023-01-31,0.0,336.75
3793,54288062,2023-02-03,-46.54,290.21
4937,54288062,2023-02-03,104.89,395.1
3794,54288062,2023-02-04,-1266.4,-871.3000000000002
4938,54288062,2023-02-04,153.16,-718.1400000000001
4939,54288062,2023-02-07,152.25,-565.8900000000002
3795,54288062,2023-02-14,-136.73,-702.6200000000001
4940,54288062,2023-02-14,120.16,-582.4600000000002
1480,54300071,2023-01-31,0.0,317.35
1603,54300071,2023-02-01,588.3,905.65
1604,54300071,2023-02-03,87.44,993.09
1605,54300071,2023-02-03,111.46,1104.55
6352,54300071,2023-02-05,-82.64,1021.91
1606,54300071,2023-02-05,58.45,1080.3600000000001
6353,54300071,2023-02-06,-93.21,987.15
1607,54300071,2023-02-08,154.2,1141.35
1608,54300071,2023-02-09,1576.6,2717.95
6354,54300071,2023-02-12,-134.97,2582.98
6355,54300071,2023-02-12,-117.45,2465.5299999999997
1609,54300071,2023-02-13,173.36,2638.89
1610,54300071,2023-02-13,1535.7,4174.59
1481,54301151,2023-01-31,0.0,408.16
7402,54301151,2023-02-07,-480.0,-71.83999999999997
8581,54301151,2023-02-12,1619.3,1547.46
1482,54307382,2023-01-31,0.0,452.52
3174,54307382,2023-02-02,97.69,550.21
4459,54307382,2023-02-03,-160.1,390.11
4461,54307382,2023-02-07,-153.27,236.83999999999997
4460,54307382,2023-02-07,-114.28,122.55999999999995
4462,54307382,2023-02-13,-535.9,-413.34000000000003
1483,54349805,2023-01-31,0.0,752.49
2582,54349805,2023-02-02,-96.32,656.1700000000001
5250,54349805,2023-02-04,99.5,755.6700000000001
2583,54349805,2023-02-07,-115.39,640.28
5251,54349805,2023-02-08,687.1,1327.38
2584,54349805,2023-02-09,-148.56,1178.82
5252,54349805,2023-02-09,10.05,1188.87
5253,54349805,2023-02-09,62.59,1251.46
2585,54349805,2023-02-10,-149.81,1101.65
5254,54349805,2023-02-13,59.45,1161.1
1484,54377130,2023-01-31,0.0,425.86
4777,54377130,2023-02-03,-91.66,334.20000000000005
4778,54377130,2023-02-04,-16.51,317.69
6016,54377130,2023-02-05,124.37,442.06
6017,54377130,2023-02-06,123.37,565.4300000000001
4779,54377130,2023-02-08,-1119.6,-554.17
6018,54377130,2023-02-11,27.58,-526.5899999999999
4780,54377130,2023-02-12,-183.41,-709.9999999999999
1485,54377538,2023-01-31,0.0,845.93
3025,54377538,2023-02-02,-1145.1,-299.16999999999996
3026,54377538,2023-02-02,-91.57,-390.7399999999999
3568,54377538,2023-02-02,75.99,-314.7499999999999
3569,54377538,2023-02-07,178.2,-136.54999999999995
3570,54377538,2023-02-11,112.1,-24.449999999999932
1486,54405539,2023-01-31,0.0,397.2
4097,54405539,2023-02-03,87.6,484.79999999999995
4096,54405539,2023-02-03,106.8,591.5999999999999
5646,54405539,2023-02-04,-80.75,510.84999999999997
4098,54405539,2023-02-10,189.51,700.3599999999999
5647,54405539,2023-02-11,-78.29,622.0699999999999
5648,54405539,2023-02-13,-84.66,537.41
1487,54452317,2023-01-31,0.0,358.39
5175,54452317,2023-02-04,-33.69,324.7
6388,54452317,2023-02-05,56.72,381.41999999999996
6389,54452317,2023-02-06,140.78,522.2
5176,54452317,2023-02-07,-98.66,423.53999999999996
6390,54452317,2023-02-07,106.48,530.02
5177,54452317,2023-02-09,-859.1,-329.08000000000004
6391,54452317,2023-02-11,139.14,-189.94000000000005
1488,54458410,2023-01-31,0.0,973.1
5185,54458410,2023-02-04,-129.56,843.54
8182,54458410,2023-02-09,138.8,982.34
5186,54458410,2023-02-10,-87.63,894.71
8183,54458410,2023-02-12,68.8,963.51
5187,54458410,2023-02-13,-97.77,865.74
1489,54541943,2023-01-31,0.0,433.92
3158,54541943,2023-02-02,156.5,590.4200000000001
4372,54541943,2023-02-03,-77.36,513.0600000000001
3159,54541943,2023-02-08,1686.0,2199.06
4373,54541943,2023-02-09,-74.96,2124.1
3160,54541943,2023-02-10,202.69,2326.79
3161,54541943,2023-02-11,121.09,2447.88
3162,54541943,2023-02-14,58.63,2506.51
1490,54565625,2023-01-31,0.0,472.76
2067,54565625,2023-02-01,148.64,621.4
4490,54565625,2023-02-03,-79.68,541.72
2068,54565625,2023-02-06,1947.3,2489.02
4491,54565625,2023-02-07,-62.17,2426.85
2069,54565625,2023-02-08,104.18,2531.0299999999997
4492,54565625,2023-02-09,-109.08,2421.95
4493,54565625,2023-02-10,-152.17,2269.7799999999997
4495,54565625,2023-02-11,-246.42,2023.36
4494,54565625,2023-02-11,-170.89,1852.47
2070,54565625,2023-02-11,42.95,1895.42
4496,54565625,2023-02-13,-77.52,1817.9
2071,54565625,2023-02-13,70.85,1888.75
4497,54565625,2023-02-14,-100.41,1788.34
1491,54570251,2023-01-31,0.0,430.68
4900,54570251,2023-02-03,-79.51,351.17
4770,54570251,2023-02-03,109.86,461.03
4771,54570251,2023-02-04,25.74,486.77
4901,54570251,2023-02-06,-105.34,381.43
4903,54570251,2023-02-09,-166.16,215.26999999999998
4902,54570251,2023-02-09,-129.85,85.42000000000002
4904,54570251,2023-02-14,-51.9,33.52000000000004
1492,54589543,2023-01-31,0.0,817.51
3302,54589543,2023-02-02,-1117.0,-299.49
7024,54589543,2023-02-06,977.0,677.51
7025,54589543,2023-02-08,96.45,773.96
7026,54589543,2023-02-10,154.39,928.35
3304,54589543,2023-02-12,-180.17,748.18
3303,54589543,2023-02-12,-106.92,641.26
3305,54589543,2023-02-13,-125.92,515.3399999999999
1493,54673873,2023-01-31,0.0,71.58
5930,54673873,2023-02-05,73.99,145.57
8410,54673873,2023-02-11,-32.2,113.36999999999999
5931,54673873,2023-02-11,55.02,168.39
5932,54673873,2023-02-14,134.69,303.08
1494,54720837,2023-01-31,0.0,166.15
5061,54720837,2023-02-04,133.55,299.70000000000005
6494,54720837,2023-02-05,-142.54,157.16000000000003
5062,54720837,2023-02-10,121.97,279.13
6495,54720837,2023-02-11,-409.8,-130.67
5064,54720837,2023-02-13,93.53,-37.139999999999986
5063,54720837,2023-02-13,125.97,88.83000000000001
1495,54786481,2023-01-31,0.0,96.87
5843,54786481,2023-02-04,-146.68,-49.81
7661,54786481,2023-02-07,134.29,84.47999999999999
7662,54786481,2023-02-08,68.63,153.10999999999999
7663,54786481,2023-02-09,36.48,189.58999999999997
7664,54786481,2023-02-11,121.25,310.84
5844,54786481,2023-02-12,-37.05,273.78999999999996
5845,54786481,2023-02-13,-99.06,174.72999999999996
1496,54824933,2023-01-31,0.0,721.47
6027,54824933,2023-02-05,-130.71,590.76
8164,54824933,2023-02-09,1549.1,2139.8599999999997
8166,54824933,2023-02-10,11.9,2151.76
8165,54824933,2023-02-10,106.03,2257.79
6028,54824933,2023-02-12,-120.78,2137.01
1497,54852109,2023-01-31,0.0,521.7
7974,54852109,2023-02-09,993.4,1515.1
7975,54852109,2023-02-13,70.25,1585.3500000000001
1498,54868017,2023-01-31,0.0,789.86
6771,54868017,2023-02-06,49.33,839.19
7816,54868017,2023-02-08,-1024.6,-185.40999999999985
6772,54868017,2023-02-08,165.57,-19.839999999999804
6773,54868017,2023-02-10,158.94,139.10000000000014
7817,54868017,2023-02-11,-143.78,-4.679999999999836
6774,54868017,2023-02-11,181.68,177.0000000000001
7818,54868017,2023-02-13,-148.43,28.570000000000164
1499,54878364,2023-01-31,0.0,80.24
4610,54878364,2023-02-03,85.24,165.48
7600,54878364,2023-02-07,-1689.7,-1524.22
4611,54878364,2023-02-08,63.42,-1460.8
1500,54910290,2023-01-31,0.0,11.12
5436,54910290,2023-02-04,950.2,961.32
7073,54910290,2023-02-06,-120.17,841.1500000000001
7071,54910290,2023-02-06,-51.05,790.1
7072,54910290,2023-02-06,-48.88,741.22
7074,54910290,2023-02-07,-129.66,611.5600000000001
5437,54910290,2023-02-08,85.98,697.5400000000001
7075,54910290,2023-02-09,-62.92,634.62
5438,54910290,2023-02-12,165.42,800.0400000000001
1501,54932317,2023-01-31,0.0,378.86
5790,54932317,2023-02-04,15.32,394.18
5791,54932317,2023-02-06,52.94,447.12
5792,54932317,2023-02-08,10.18,457.3
5793,54932317,2023-02-09,82.57,539.87
8382,54932317,2023-02-10,-116.53,423.34000000000003
8383,54932317,2023-02-11,-858.7,-435.36
5794,54932317,2023-02-13,44.84,-390.52
8384,54932317,2023-02-14,-158.33,-548.85
1502,54937975,2023-01-31,0.0,218.66
7532,54937975,2023-02-07,-62.35,156.31
7533,54937975,2023-02-09,-37.53,118.78
7534,54937975,2023-02-11,-1507.4,-1388.6200000000001
8663,54937975,2023-02-14,96.78,-1291.8400000000001
8662,54937975,2023-02-14,195.92,-1095.92
1503,54958511,2023-01-31,0.0,454.61
7190,54958511,2023-02-06,-157.18,297.43
7191,54958511,2023-02-08,-44.34,253.09
8044,54958511,2023-02-09,180.82,433.90999999999997
7192,54958511,2023-02-12,-81.37,352.53999999999996
1504,54958587,2023-01-31,0.0,874.83
4404,54958587,2023-02-03,-106.51,768.32
4405,54958587,2023-02-04,-81.63,686.69
4406,54958587,2023-02-06,-50.78,635.9100000000001
4407,54958587,2023-02-07,-117.45,518.46
4408,54958587,2023-02-08,-50.71,467.75000000000006
7783,54958587,2023-02-08,110.15,577.9000000000001
4409,54958587,2023-02-14,-112.23,465.67
1505,54997427,2023-01-31,0.0,825.84
2457,54997427,2023-02-02,-37.62,788.22
2458,54997427,2023-02-08,-110.6,677.62
1506,55009163,2023-01-31,0.0,435.8
6613,55009163,2023-02-05,123.78,559.58
7262,55009163,2023-02-07,-77.09,482.49
7263,55009163,2023-02-08,-187.67,294.82000000000005
7264,55009163,2023-02-08,-44.05,250.77000000000004
6615,55009163,2023-02-10,86.61,337.38
6614,55009163,2023-02-10,137.34,474.72
7265,55009163,2023-02-13,-23.17,451.55
1507,55022533,2023-01-31,0.0,341.29
6107,55022533,2023-02-05,-174.7,166.59000000000003
6108,55022533,2023-02-05,-35.44,131.15000000000003
7317,55022533,2023-02-07,140.77,271.9200000000001
6109,55022533,2023-02-09,-98.03,173.89000000000004
1508,55088029,2023-01-31,0.0,920.53
415,55088029,2023-02-01,-152.86,767.67
5010,55088029,2023-02-03,556.5,1324.17
5011,55088029,2023-02-11,122.71,1446.88
1509,55106431,2023-01-31,0.0,460.48
5389,55106431,2023-02-04,150.02,610.5
5390,55106431,2023-02-04,163.15,773.6500000000001
5391,55106431,2023-02-08,101.87,875.52
1510,55122249,2023-01-31,0.0,43.86
8490,55122249,2023-02-11,-66.07,-22.209999999999994
8530,55122249,2023-02-12,84.75,62.540000000000006
8532,55122249,2023-02-14,68.84,131.38
8531,55122249,2023-02-14,152.84,284.22
1511,55168205,2023-01-31,0.0,578.4
2082,55168205,2023-02-01,-78.1,500.29999999999995
2083,55168205,2023-02-04,-120.38,379.91999999999996
7077,55168205,2023-02-06,95.11,475.03
7078,55168205,2023-02-07,88.15,563.18
7079,55168205,2023-02-13,66.15,629.33
2084,55168205,2023-02-14,-1137.7,-508.37
7080,55168205,2023-02-14,24.04,-484.33000000000004
1512,55304418,2023-01-31,0.0,968.71
7444,55304418,2023-02-07,-88.15,880.5600000000001
7445,55304418,2023-02-08,-107.41,773.1500000000001
8112,55304418,2023-02-09,57.36,830.51
7446,55304418,2023-02-10,-1795.9,-965.3900000000001
7447,55304418,2023-02-11,-1214.6,-2179.99
8113,55304418,2023-02-12,158.82,-2021.17
7448,55304418,2023-02-13,-871.5,-2892.67
1513,55341552,2023-01-31,0.0,768.94
2369,55341552,2023-02-02,48.35,817.2900000000001
2370,55341552,2023-02-02,755.3,1572.5900000000001
2371,55341552,2023-02-04,567.7,2140.29
8092,55341552,2023-02-09,-168.65,1971.64
8093,55341552,2023-02-12,-70.46,1901.18
8094,55341552,2023-02-13,-142.04,1759.14
1514,55353228,2023-01-31,0.0,923.38
6099,55353228,2023-02-05,-540.8,382.58000000000004
6100,55353228,2023-02-09,-29.71,352.87
6101,55353228,2023-02-11,-132.96,219.90999999999997
8648,55353228,2023-02-13,105.18,325.09000000000003
1515,55397453,2023-01-31,0.0,820.88
1976,55397453,2023-02-01,96.77,917.65
1977,55397453,2023-02-02,1413.6,2331.25
1978,55397453,2023-02-06,198.2,2529.45
7276,55397453,2023-02-07,-132.91,2396.54
1979,55397453,2023-02-07,121.46,2518.0
7277,55397453,2023-02-08,-151.99,2366.0099999999998
1981,55397453,2023-02-08,80.46,2446.47
1980,55397453,2023-02-08,143.22,2589.69
1982,55397453,2023-02-14,194.38,2784.0699999999997
1516,55398856,2023-01-31,0.0,663.43
826,55398856,2023-02-01,-645.5,17.92999999999995
3124,55398856,2023-02-02,884.3,902.2299999999999
3125,55398856,2023-02-03,95.54,997.77
827,55398856,2023-02-04,-19.13,978.6399999999999
3126,55398856,2023-02-07,47.31,1025.9499999999998
828,55398856,2023-02-11,-88.16,937.79
3127,55398856,2023-02-12,139.58,1077.37
1517,55459151,2023-01-31,0.0,451.21
3321,55459151,2023-02-02,-162.1,289.11
3322,55459151,2023-02-06,-78.08,211.02999999999997
7252,55459151,2023-02-06,161.61,372.64
3324,55459151,2023-02-09,-897.0,-524.3599999999999
3323,55459151,2023-02-09,-46.3,-570.6599999999999
7253,55459151,2023-02-14,64.45,-506.21
7254,55459151,2023-02-14,144.85,-361.35999999999996
1518,55472786,2023-01-31,0.0,634.29
1519,55513887,2023-01-31,0.0,722.45
2189,55513887,2023-02-02,-116.43,606.02
2190,55513887,2023-02-03,-74.5,531.52
2191,55513887,2023-02-11,-50.13,481.39000000000004
8472,55513887,2023-02-11,218.81,700.2
8473,55513887,2023-02-13,116.37,816.57
2192,55513887,2023-02-14,-76.32,740.25
1520,55552232,2023-01-31,0.0,953.87
600,55552232,2023-02-01,152.59,1106.46
6924,55552232,2023-02-06,-167.46,939.0
601,55552232,2023-02-06,51.75,990.75
6925,55552232,2023-02-10,-679.8,310.95000000000005
6926,55552232,2023-02-12,-149.57,161.38
1521,55590263,2023-01-31,0.0,605.12
429,55590263,2023-02-01,189.32,794.44
4719,55590263,2023-02-03,-215.09,579.35
4720,55590263,2023-02-07,-76.2,503.15
430,55590263,2023-02-07,116.74,619.89
431,55590263,2023-02-09,78.22,698.11
1522,55607955,2023-01-31,0.0,274.23
7632,55607955,2023-02-07,-89.17,185.06
7633,55607955,2023-02-12,-0.94,184.12
8625,55607955,2023-02-13,53.93,238.05
1523,55714753,2023-01-31,0.0,703.59
4099,55714753,2023-02-03,-64.43,639.1600000000001
4100,55714753,2023-02-06,-30.38,608.78
7468,55714753,2023-02-07,38.04,646.82
4101,55714753,2023-02-10,-26.55,620.27
1524,55753843,2023-01-31,0.0,524.57
5399,55753843,2023-02-04,-158.04,366.5300000000001
5400,55753843,2023-02-05,-147.75,218.7800000000001
5401,55753843,2023-02-10,-194.97,23.81000000000006
5402,55753843,2023-02-11,-127.25,-103.43999999999994
1525,55791547,2023-01-31,0.0,758.17
7527,55791547,2023-02-07,-85.35,672.8199999999999
7949,55791547,2023-02-08,1565.7,2238.52
7950,55791547,2023-02-09,58.39,2296.9100000000003
7528,55791547,2023-02-11,-125.71,2171.2000000000003
7951,55791547,2023-02-13,188.62,2359.82
1526,55795603,2023-01-31,0.0,241.17
3572,55795603,2023-02-02,-112.16,129.01
3573,55795603,2023-02-04,-482.7,-353.69000000000005
7766,55795603,2023-02-08,179.3,-174.38999999999996
3574,55795603,2023-02-10,-40.02,-214.40999999999994
3575,55795603,2023-02-12,-272.8,-487.2099999999999
1527,55819086,2023-01-31,0.0,608.13
197,55819086,2023-02-01,90.71,698.84
198,55819086,2023-02-01,209.89,908.73
4427,55819086,2023-02-03,-130.36,778.3699999999999
199,55819086,2023-02-03,218.15,996.52
200,55819086,2023-02-03,510.1,1506.62
201,55819086,2023-02-04,88.18,1594.8000000000002
4428,55819086,2023-02-09,-135.23,1459.5700000000002
202,55819086,2023-02-10,98.96,1558.53
4429,55819086,2023-02-13,-51.71,1506.8200000000002
203,55819086,2023-02-14,84.96,1591.78
1528,55912413,2023-01-31,0.0,297.61
3787,55912413,2023-02-03,-90.58,207.03000000000003
4221,55912413,2023-02-03,77.0,284.03000000000003
3788,55912413,2023-02-11,-102.08,181.95000000000002
3789,55912413,2023-02-13,-25.66,156.29000000000002
4222,55912413,2023-02-13,97.05,253.34000000000003
1529,55916056,2023-01-31,0.0,377.36
6825,55916056,2023-02-06,-178.4,198.96
6826,55916056,2023-02-06,-60.08,138.88
6718,55916056,2023-02-06,143.44,282.32
6717,55916056,2023-02-06,1338.0,1620.3200000000002
6719,55916056,2023-02-08,103.03,1723.35
6827,55916056,2023-02-10,-79.86,1643.4900000000002
1530,55975906,2023-01-31,0.0,112.69
3834,55975906,2023-02-03,-94.79,17.89999999999999
3835,55975906,2023-02-04,-44.5,-26.600000000000023
6085,55975906,2023-02-05,74.28,47.67999999999999
6086,55975906,2023-02-14,148.63,196.31
1531,55986027,2023-01-31,0.0,38.94
4031,55986027,2023-02-03,-100.38,-61.44
6040,55986027,2023-02-05,98.72,37.28
4032,55986027,2023-02-06,-840.3,-803.02
4033,55986027,2023-02-09,-94.29,-897.31
4034,55986027,2023-02-11,-90.72,-988.03
4035,55986027,2023-02-12,-39.77,-1027.8
4036,55986027,2023-02-13,-1619.8,-2647.6
1532,55986093,2023-01-31,0.0,586.34
7562,55986093,2023-02-07,1298.9,1885.2400000000002
7804,55986093,2023-02-08,-88.74,1796.5
7563,55986093,2023-02-11,139.86,1936.3600000000001
7805,55986093,2023-02-14,-135.61,1800.75
7806,55986093,2023-02-14,-7.29,1793.46
1533,56041976,2023-01-31,0.0,56.45
5869,56041976,2023-02-04,55.94,112.39
7292,56041976,2023-02-07,-122.99,-10.599999999999994
5870,56041976,2023-02-08,107.83,97.23
5871,56041976,2023-02-09,93.51,190.74
7293,56041976,2023-02-10,-10.96,179.78000000000003
1534,56070421,2023-01-31,0.0,286.85
4796,56070421,2023-02-03,-65.15,221.70000000000002
8615,56070421,2023-02-13,113.44,335.14
1535,56094156,2023-01-31,0.0,531.43
7259,56094156,2023-02-07,-140.77,390.65999999999997
7841,56094156,2023-02-08,258.6,649.26
7260,56094156,2023-02-09,-45.07,604.1899999999999
7842,56094156,2023-02-10,193.16,797.3499999999999
7843,56094156,2023-02-13,1237.4,2034.75
1536,56116199,2023-01-31,0.0,615.98
1298,56116199,2023-02-01,-129.83,486.15
1299,56116199,2023-02-03,-35.32,450.83000000000004
1300,56116199,2023-02-06,-126.54,324.28999999999996
8359,56116199,2023-02-10,91.04,415.33
1537,56120063,2023-01-31,0.0,94.32
2594,56120063,2023-02-02,179.69,274.01
5689,56120063,2023-02-04,-89.11,184.89999999999998
2595,56120063,2023-02-06,137.1,322.0
2597,56120063,2023-02-07,98.42,420.41999999999996
2596,56120063,2023-02-07,122.13,542.55
5690,56120063,2023-02-08,-174.24,368.30999999999995
5691,56120063,2023-02-11,-41.23,327.0799999999999
1538,56189750,2023-01-31,0.0,365.48
7411,56189750,2023-02-07,-121.65,243.83
7412,56189750,2023-02-10,-50.54,193.29000000000002
8585,56189750,2023-02-12,155.17,348.46000000000004
8586,56189750,2023-02-14,2237.0,2585.46
1539,56297850,2023-01-31,0.0,320.47
1091,56297850,2023-02-01,-114.68,205.79000000000002
6209,56297850,2023-02-05,52.34,258.13
6210,56297850,2023-02-08,30.53,288.66
1092,56297850,2023-02-12,-21.61,267.05
1540,56422161,2023-01-31,0.0,990.84
7529,56422161,2023-02-07,46.29,1037.13
7530,56422161,2023-02-08,62.89,1100.02
7531,56422161,2023-02-09,110.83,1210.85
7532,56422161,2023-02-10,38.38,1249.23
7533,56422161,2023-02-14,95.91,1345.1399999999999
7534,56422161,2023-02-14,195.84,1540.98
1541,56453199,2023-01-31,0.0,605.38
270,56453199,2023-02-01,-71.22,534.16
272,56453199,2023-02-08,-697.8,-163.64
271,56453199,2023-02-08,-105.53,-269.16999999999996
273,56453199,2023-02-10,-55.02,-324.18999999999994
1542,56458213,2023-01-31,0.0,731.3
1592,56458213,2023-02-01,-588.3,143.0
1593,56458213,2023-02-02,-1351.2,-1208.2
1594,56458213,2023-02-06,-141.23,-1349.43
1595,56458213,2023-02-10,-120.81,-1470.24
1596,56458213,2023-02-12,-121.0,-1591.24
8656,56458213,2023-02-14,181.24,-1410.0000000000002
1543,56468624,2023-01-31,0.0,655.33
4847,56468624,2023-02-03,-88.74,566.59
3861,56468624,2023-02-03,16.2,582.7900000000001
3862,56468624,2023-02-08,92.38,675.1700000000001
3863,56468624,2023-02-12,910.1,1585.27
4848,56468624,2023-02-13,-68.93,1516.3400000000001
1544,56483442,2023-01-31,0.0,151.85
2935,56483442,2023-02-02,-1298.8,-1146.95
8315,56483442,2023-02-10,163.18,-983.7699999999999
1545,56573058,2023-01-31,0.0,34.66
664,56573058,2023-02-01,129.52,164.18
3493,56573058,2023-02-02,-61.2,102.98
666,56573058,2023-02-04,37.75,140.73000000000002
665,56573058,2023-02-04,163.58,304.31000000000006
667,56573058,2023-02-06,48.88,353.19000000000005
3494,56573058,2023-02-07,-137.57,215.62
3495,56573058,2023-02-09,-118.82,96.80000000000001
669,56573058,2023-02-12,214.19,310.99
668,56573058,2023-02-12,907.1,1218.0900000000001
3496,56573058,2023-02-13,-53.93,1164.16
1546,56609826,2023-01-31,0.0,14.24
6168,56609826,2023-02-05,174.96,189.20000000000002
6169,56609826,2023-02-09,134.28,323.48
8581,56609826,2023-02-12,-136.93,186.55
6170,56609826,2023-02-14,87.3,273.85
1547,56723864,2023-01-31,0.0,246.21
1127,56723864,2023-02-01,-128.49,117.72
3617,56723864,2023-02-02,137.59,255.31
3618,56723864,2023-02-03,164.36,419.67
3619,56723864,2023-02-06,167.46,587.13
1128,56723864,2023-02-07,-76.84,510.2900000000001
3621,56723864,2023-02-11,69.79,580.08
3620,56723864,2023-02-11,117.62,697.7
1129,56723864,2023-02-12,-104.46,593.24
1130,56723864,2023-02-14,-70.03,523.21
1548,56751728,2023-01-31,0.0,610.52
2180,56751728,2023-02-02,-128.71,481.80999999999995
2181,56751728,2023-02-02,-93.7,388.10999999999996
6946,56751728,2023-02-06,83.83,471.93999999999994
2182,56751728,2023-02-07,-63.12,408.81999999999994
2183,56751728,2023-02-08,-974.3,-565.48
2184,56751728,2023-02-13,-120.16,-685.6400000000001
1549,56759680,2023-01-31,0.0,479.7
8449,56759680,2023-02-11,90.65,570.35
1550,56760248,2023-01-31,0.0,571.55
4785,56760248,2023-02-03,-49.32,522.2299999999999
3742,56760248,2023-02-03,5.38,527.6099999999999
3743,56760248,2023-02-03,56.89,584.5
4786,56760248,2023-02-06,-173.92,410.58
4787,56760248,2023-02-06,-109.59,300.98999999999995
3744,56760248,2023-02-06,111.41,412.4
4788,56760248,2023-02-08,-38.27,374.12999999999994
3745,56760248,2023-02-09,89.08,463.2099999999999
4789,56760248,2023-02-12,-101.83,361.37999999999994
3746,56760248,2023-02-13,357.3,718.68
1551,56842874,2023-01-31,0.0,22.02
7185,56842874,2023-02-06,-69.2,-47.18000000000001
7186,56842874,2023-02-12,-127.2,-174.38
1552,56843498,2023-01-31,0.0,509.55
1760,56843498,2023-02-01,122.7,632.25
1761,56843498,2023-02-02,104.79,737.04
1762,56843498,2023-02-04,101.52,838.56
6605,56843498,2023-02-05,-1345.1,-506.5399999999999
6606,56843498,2023-02-05,-160.23,-666.77
1764,56843498,2023-02-09,135.23,-531.54
1763,56843498,2023-02-09,1156.9,625.3600000000001
6607,56843498,2023-02-13,-121.9,503.46000000000015
1553,56875373,2023-01-31,0.0,633.79
1647,56875373,2023-02-01,-71.73,562.06
4413,56875373,2023-02-03,103.79,665.8499999999999
1648,56875373,2023-02-04,-100.66,565.1899999999999
1649,56875373,2023-02-07,-69.39,495.79999999999995
4414,56875373,2023-02-11,159.77,655.5699999999999
1554,56878640,2023-01-31,0.0,846.85
4202,56878640,2023-02-03,139.16,986.01
4203,56878640,2023-02-05,99.24,1085.25
4204,56878640,2023-02-10,121.71,1206.96
8563,56878640,2023-02-12,-151.09,1055.87
4205,56878640,2023-02-12,36.64,1092.51
1555,56899079,2023-01-31,0.0,445.39
8144,56899079,2023-02-09,-827.3,-381.90999999999997
1556,56922739,2023-01-31,0.0,174.07
4054,56922739,2023-02-03,-220.14,-46.06999999999999
6387,56922739,2023-02-05,102.17,56.10000000000001
4055,56922739,2023-02-07,-80.94,-24.839999999999975
4056,56922739,2023-02-11,-107.01,-131.84999999999997
1557,56936624,2023-01-31,0.0,503.74
2965,56936624,2023-02-02,1921.4,2425.1400000000003
4410,56936624,2023-02-03,-101.8,2323.34
2966,56936624,2023-02-03,73.31,2396.65
2967,56936624,2023-02-07,105.18,2501.83
2968,56936624,2023-02-12,125.27,2627.1000000000004
4411,56936624,2023-02-14,-166.38,2460.7200000000003
1558,56946115,2023-01-31,0.0,298.13
2396,56946115,2023-02-02,-45.22,252.91
7511,56946115,2023-02-07,74.35,327.26
2397,56946115,2023-02-12,-92.42,234.83999999999997
1559,57027965,2023-01-31,0.0,979.57
3414,57027965,2023-02-02,-115.29,864.2800000000001
3413,57027965,2023-02-02,-111.9,752.3800000000001
2522,57027965,2023-02-02,103.75,856.13
3415,57027965,2023-02-05,-109.24,746.8900000000001
3416,57027965,2023-02-06,-197.61,549.28
3417,57027965,2023-02-08,-92.59,456.69000000000005
2523,57027965,2023-02-09,54.69,511.38
3418,57027965,2023-02-10,-210.62,300.76
2524,57027965,2023-02-11,151.02,451.7800000000001
3419,57027965,2023-02-14,-127.34,324.44000000000005
1560,57043647,2023-01-31,0.0,552.06
1487,57043647,2023-02-01,-103.35,448.7099999999999
4195,57043647,2023-02-03,58.81,507.52
4196,57043647,2023-02-03,124.18,631.6999999999999
1488,57043647,2023-02-09,-53.56,578.14
4197,57043647,2023-02-11,152.46,730.5999999999999
4198,57043647,2023-02-12,14.26,744.8599999999999
1489,57043647,2023-02-13,-1207.6,-462.74
4199,57043647,2023-02-13,107.17,-355.57000000000005
1561,57063886,2023-01-31,0.0,384.17
5141,57063886,2023-02-04,134.46,518.63
5142,57063886,2023-02-07,33.98,552.61
8164,57063886,2023-02-09,-110.14,442.47
5143,57063886,2023-02-10,182.75,625.22
8165,57063886,2023-02-13,-98.44,526.78
1562,57071366,2023-01-31,0.0,911.45
128,57071366,2023-02-01,76.18,987.6300000000001
129,57071366,2023-02-01,80.58,1068.21
4001,57071366,2023-02-03,-19.89,1048.3200000000002
130,57071366,2023-02-03,96.63,1144.95
131,57071366,2023-02-08,88.56,1233.51
4003,57071366,2023-02-09,-125.68,1107.83
4002,57071366,2023-02-09,-55.83,1052.0
132,57071366,2023-02-11,49.96,1101.96
1563,57084496,2023-01-31,0.0,58.05
840,57084496,2023-02-01,802.6,860.65
839,57084496,2023-02-01,1058.7,1919.3500000000001
5335,57084496,2023-02-04,-121.83,1797.52
841,57084496,2023-02-07,18.61,1816.1299999999999
5336,57084496,2023-02-10,-82.33,1733.8
842,57084496,2023-02-10,8.85,1742.6499999999999
5337,57084496,2023-02-12,-1251.2,491.4499999999999
5338,57084496,2023-02-14,-63.0,428.4499999999999
1564,57096259,2023-01-31,0.0,540.54
2187,57096259,2023-02-02,168.98,709.52
2188,57096259,2023-02-03,101.3,810.8199999999999
6306,57096259,2023-02-05,-907.1,-96.28000000000009
2189,57096259,2023-02-05,77.95,-18.33000000000004
6307,57096259,2023-02-06,-24.84,-43.17000000000007
2190,57096259,2023-02-09,97.89,54.719999999999914
1565,57108303,2023-01-31,0.0,737.04
4897,57108303,2023-02-03,118.63,855.67
5904,57108303,2023-02-04,-1795.8,-940.1300000000001
4898,57108303,2023-02-05,49.78,-890.3499999999999
4899,57108303,2023-02-13,97.98,-792.3699999999999
1566,57121657,2023-01-31,0.0,847.9
1804,57121657,2023-02-01,135.55,983.45
1805,57121657,2023-02-05,54.79,1038.24
7977,57121657,2023-02-08,-9.98,1028.26
1806,57121657,2023-02-08,100.27,1128.53
1807,57121657,2023-02-08,796.3,1924.83
7979,57121657,2023-02-12,-134.36,1790.4699999999998
7978,57121657,2023-02-12,-65.93,1724.54
1808,57121657,2023-02-13,154.58,1879.12
1809,57121657,2023-02-14,96.98,1976.1
1567,57133159,2023-01-31,0.0,734.4
8110,57133159,2023-02-09,102.35,836.75
8111,57133159,2023-02-13,128.11,964.86
1568,57145139,2023-01-31,0.0,708.46
2246,57145139,2023-02-02,-62.33,646.13
2247,57145139,2023-02-04,-186.01,460.12000000000006
2248,57145139,2023-02-05,-1233.7,-773.5799999999999
2249,57145139,2023-02-07,-81.96,-855.54
7296,57145139,2023-02-07,108.88,-746.6599999999999
7295,57145139,2023-02-07,143.04,-603.6199999999999
2250,57145139,2023-02-08,-100.27,-703.8899999999999
1569,57148382,2023-01-31,0.0,638.49
1971,57148382,2023-02-01,81.16,719.65
5460,57148382,2023-02-04,-126.18,593.47
5461,57148382,2023-02-05,-155.64,437.83000000000004
5462,57148382,2023-02-06,-876.5,-438.6700000000001
5463,57148382,2023-02-07,-85.25,-523.9199999999998
1972,57148382,2023-02-10,105.08,-418.8399999999999
1973,57148382,2023-02-12,144.16,-274.67999999999995
1570,57160773,2023-01-31,0.0,802.9
447,57160773,2023-02-01,96.2,899.1
4797,57160773,2023-02-03,-472.5,426.59999999999997
448,57160773,2023-02-05,119.28,545.88
4798,57160773,2023-02-08,-77.84,468.03999999999996
449,57160773,2023-02-10,167.51,635.55
4799,57160773,2023-02-13,-45.56,589.99
1571,57186194,2023-01-31,0.0,824.69
202,57186194,2023-02-01,-106.33,718.36
203,57186194,2023-02-02,-109.06,609.3000000000001
204,57186194,2023-02-05,-111.92,497.38000000000005
205,57186194,2023-02-09,-181.31,316.07000000000005
8635,57186194,2023-02-13,48.13,364.20000000000005
206,57186194,2023-02-14,-756.9,-392.6999999999998
8636,57186194,2023-02-14,158.38,-234.31999999999994
1572,57224848,2023-01-31,0.0,30.59
3195,57224848,2023-02-02,-74.5,-43.91
3308,57224848,2023-02-02,96.85,52.94
3196,57224848,2023-02-05,-77.0,-24.060000000000006
3309,57224848,2023-02-07,85.73,61.67
3197,57224848,2023-02-10,-1987.3,-1925.63
3199,57224848,2023-02-12,-112.58,-2038.2100000000003
3198,57224848,2023-02-12,-27.74,-2065.95
1573,57273397,2023-01-31,0.0,403.21
7060,57273397,2023-02-06,-134.08,269.13
6682,57273397,2023-02-06,154.24,423.37
6683,57273397,2023-02-09,36.49,459.85999999999996
6685,57273397,2023-02-11,81.26,541.12
6684,57273397,2023-02-11,117.16,658.28
7061,57273397,2023-02-13,-186.3,471.97999999999996
7062,57273397,2023-02-14,-97.09,374.89
1574,57300901,2023-01-31,0.0,302.87
1712,57300901,2023-02-01,-65.35,237.52
1713,57300901,2023-02-03,-72.03,165.49
4050,57300901,2023-02-03,108.13,273.62
1714,57300901,2023-02-04,-1320.2,-1046.58
4051,57300901,2023-02-04,213.8,-832.7800000000001
1715,57300901,2023-02-09,-78.1,-910.88
1716,57300901,2023-02-10,-162.36,-1073.2400000000002
4053,57300901,2023-02-12,100.81,-972.43
4052,57300901,2023-02-12,137.14,-835.2900000000001
1575,57302841,2023-01-31,0.0,341.02
1556,57302841,2023-02-01,72.19,413.21
7952,57302841,2023-02-08,-91.11,322.09999999999997
1557,57302841,2023-02-08,152.99,475.09
7953,57302841,2023-02-13,-134.97,340.12
1576,57372684,2023-01-31,0.0,249.26
1412,57372684,2023-02-01,111.48,360.74
1413,57372684,2023-02-02,237.02,597.76
6808,57372684,2023-02-06,-141.38,456.38
6809,57372684,2023-02-08,-52.45,403.93
6810,57372684,2023-02-10,-94.14,309.79
1414,57372684,2023-02-10,121.29,431.08000000000004
6811,57372684,2023-02-12,-93.57,337.51000000000005
1577,57395511,2023-01-31,0.0,747.89
3119,57395511,2023-02-02,-151.59,596.3
3120,57395511,2023-02-06,-91.85,504.45
7596,57395511,2023-02-07,120.5,624.95
3121,57395511,2023-02-09,-82.57,542.38
7597,57395511,2023-02-11,85.36,627.74
3122,57395511,2023-02-12,-95.25,532.49
7598,57395511,2023-02-13,123.69,656.18
3123,57395511,2023-02-14,-83.11,573.0699999999999
1578,57413609,2023-01-31,0.0,219.01
7674,57413609,2023-02-08,-30.21,188.79999999999998
7675,57413609,2023-02-12,-68.21,120.59
1579,57426365,2023-01-31,0.0,606.03
169,57426365,2023-02-01,65.35,671.38
168,57426365,2023-02-01,94.29,765.67
170,57426365,2023-02-01,123.23,888.9
171,57426365,2023-02-03,52.27,941.17
6438,57426365,2023-02-05,-76.24,864.93
172,57426365,2023-02-05,6.87,871.8
6439,57426365,2023-02-06,-126.49,745.31
173,57426365,2023-02-10,52.93,798.24
6440,57426365,2023-02-12,-100.61,697.63
174,57426365,2023-02-14,37.59,735.22
1580,57436108,2023-01-31,0.0,899.46
3037,57436108,2023-02-02,-98.78,800.6800000000001
3373,57436108,2023-02-02,49.76,850.44
3038,57436108,2023-02-04,-1349.2,-498.76
3039,57436108,2023-02-05,-129.49,-628.25
3040,57436108,2023-02-10,-103.49,-731.74
3374,57436108,2023-02-13,127.61,-604.1300000000001
1581,57446648,2023-01-31,0.0,542.41
2571,57446648,2023-02-02,179.19,721.5999999999999
2572,57446648,2023-02-06,1201.1,1922.6999999999998
2573,57446648,2023-02-09,123.62,2046.3199999999997
2574,57446648,2023-02-12,129.84,2176.16
1582,57450523,2023-01-31,0.0,609.41
4881,57450523,2023-02-03,82.41,691.8199999999999
7110,57450523,2023-02-06,-82.1,609.72
4882,57450523,2023-02-08,59.47,669.1899999999999
7111,57450523,2023-02-11,-991.6,-322.4100000000001
7112,57450523,2023-02-11,-77.75,-400.1600000000001
4883,57450523,2023-02-12,137.83,-262.33000000000004
1583,57507102,2023-01-31,0.0,374.17
2023,57507102,2023-02-01,-84.14,290.03000000000003
2024,57507102,2023-02-09,-31.87,258.16
2025,57507102,2023-02-11,-148.04,110.12
8573,57507102,2023-02-12,31.75,141.87000000000003
8574,57507102,2023-02-13,116.22,258.09000000000003
8575,57507102,2023-02-14,74.72,332.81000000000006
1584,57584855,2023-01-31,0.0,37.86
865,57584855,2023-02-01,-83.37,-45.510000000000005
866,57584855,2023-02-07,-125.24,-170.75
8078,57584855,2023-02-09,155.0,-15.750000000000014
867,57584855,2023-02-11,-51.18,-66.93000000000002
8079,57584855,2023-02-11,81.2,14.269999999999996
868,57584855,2023-02-12,-56.96,-42.69000000000001
1585,57610201,2023-01-31,0.0,931.52
4677,57610201,2023-02-03,-676.5,255.01999999999998
5241,57610201,2023-02-04,97.9,352.91999999999996
4678,57610201,2023-02-06,-58.71,294.21000000000004
4679,57610201,2023-02-11,-56.37,237.84000000000003
4680,57610201,2023-02-12,-145.68,92.15999999999997
5242,57610201,2023-02-12,25.98,118.13999999999999
4681,57610201,2023-02-13,-158.29,-40.15000000000009
5243,57610201,2023-02-14,64.87,24.720000000000027
1586,57612494,2023-01-31,0.0,499.3
6396,57612494,2023-02-05,109.6,608.9
8511,57612494,2023-02-12,-44.09,564.81
6397,57612494,2023-02-12,103.32,668.13
1587,57675131,2023-01-31,0.0,410.85
3444,57675131,2023-02-02,90.07,500.92
3445,57675131,2023-02-04,112.22,613.14
7367,57675131,2023-02-07,-150.92,462.22
3446,57675131,2023-02-07,123.24,585.46
1588,57687949,2023-01-31,0.0,542.92
679,57687949,2023-02-01,119.2,662.12
3815,57687949,2023-02-03,-88.02,574.0999999999999
680,57687949,2023-02-07,211.2,785.3
3816,57687949,2023-02-08,-119.51,665.79
681,57687949,2023-02-09,682.6,1348.3899999999999
682,57687949,2023-02-12,143.47,1491.8600000000001
3817,57687949,2023-02-13,-94.69,1397.17
1589,57717550,2023-01-31,0.0,832.39
1750,57717550,2023-02-01,-103.68,728.71
1293,57717550,2023-02-01,119.21,847.92
1751,57717550,2023-02-03,-125.77,722.15
1294,57717550,2023-02-09,61.13,783.28
1590,57790631,2023-01-31,0.0,893.46
147,57790631,2023-02-01,-105.16,788.3000000000001
148,57790631,2023-02-09,-71.26,717.04
8421,57790631,2023-02-11,166.8,883.84
149,57790631,2023-02-14,-1139.7,-255.86000000000013
1591,57886631,2023-01-31,0.0,369.6
6624,57886631,2023-02-05,61.09,430.69000000000005
6625,57886631,2023-02-06,543.9,974.59
6626,57886631,2023-02-07,52.98,1027.5700000000002
7986,57886631,2023-02-08,-114.36,913.21
7987,57886631,2023-02-11,-154.67,758.5400000000001
6627,57886631,2023-02-11,110.5,869.0400000000001
7988,57886631,2023-02-12,-85.93,783.11
7989,57886631,2023-02-13,-143.14,639.97
1592,57897038,2023-01-31,0.0,399.72
1371,57897038,2023-02-01,-38.67,361.05
2942,57897038,2023-02-02,46.31,407.36
2943,57897038,2023-02-04,118.34,525.7
2944,57897038,2023-02-06,119.61,645.3100000000001
1372,57897038,2023-02-09,-1653.1,-1007.79
1373,57897038,2023-02-11,-88.41,-1096.2
1593,57941886,2023-01-31,0.0,270.81
2254,57941886,2023-02-02,166.1,436.90999999999997
2255,57941886,2023-02-02,224.12,661.03
6870,57941886,2023-02-06,-154.07,506.96000000000004
6871,57941886,2023-02-08,-59.97,446.99
2256,57941886,2023-02-12,38.42,485.41
6872,57941886,2023-02-14,-37.37,448.04
1594,57948925,2023-01-31,0.0,194.11
4353,57948925,2023-02-03,-95.29,98.82000000000001
4354,57948925,2023-02-04,-1465.5,-1366.6799999999998
7677,57948925,2023-02-07,182.69,-1183.9899999999998
4356,57948925,2023-02-09,-96.17,-1280.1599999999999
4355,57948925,2023-02-09,-7.12,-1287.2799999999997
4357,57948925,2023-02-13,-1505.7,-2792.98
1595,57975842,2023-01-31,0.0,101.94
8221,57975842,2023-02-10,181.0,282.94
1596,58009817,2023-01-31,0.0,887.22
2454,58009817,2023-02-02,121.1,1008.32
4746,58009817,2023-02-03,-144.92,863.4000000000001
2455,58009817,2023-02-04,150.76,1014.1600000000001
4747,58009817,2023-02-05,-56.62,957.54
4748,58009817,2023-02-06,-64.67,892.87
4749,58009817,2023-02-08,-22.97,869.9000000000001
2456,58009817,2023-02-08,111.05,980.95
4750,58009817,2023-02-12,-1354.4,-373.45000000000005
1597,58099419,2023-01-31,0.0,185.74
1527,58099419,2023-02-01,-152.29,33.45000000000002
6642,58099419,2023-02-05,144.17,177.62
1528,58099419,2023-02-14,-80.0,97.62
1598,58126511,2023-01-31,0.0,940.27
4503,58126511,2023-02-03,-85.3,854.97
5012,58126511,2023-02-03,76.11,931.0799999999999
5013,58126511,2023-02-04,1639.2,2570.2799999999997
4504,58126511,2023-02-05,-148.33,2421.95
4505,58126511,2023-02-07,-98.77,2323.1800000000003
5014,58126511,2023-02-08,88.99,2412.17
4506,58126511,2023-02-09,-45.7,2366.4700000000003
4507,58126511,2023-02-11,-121.16,2245.31
5015,58126511,2023-02-13,108.27,2353.58
5016,58126511,2023-02-14,36.2,2389.7799999999997
5017,58126511,2023-02-14,90.11,2479.89
1599,58176810,2023-01-31,0.0,219.07
3503,58176810,2023-02-02,-25.85,193.22
3504,58176810,2023-02-03,-105.11,88.10999999999999
5928,58176810,2023-02-05,113.3,201.41
3505,58176810,2023-02-09,-104.33,97.08
5929,58176810,2023-02-14,133.71,230.79000000000002
1600,58182495,2023-01-31,0.0,223.57
6033,58182495,2023-02-05,-949.6,-726.03
6034,58182495,2023-02-12,-158.82,-884.8500000000001
1601,58216756,2023-01-31,0.0,642.13
2419,58216756,2023-02-02,51.0,693.13
2420,58216756,2023-02-02,115.09,808.22
2421,58216756,2023-02-03,625.5,1433.72
2422,58216756,2023-02-06,120.17,1553.8899999999999
8050,58216756,2023-02-09,-79.05,1474.8400000000001
8051,58216756,2023-02-11,-91.03,1383.81
8052,58216756,2023-02-12,-1690.9,-307.09000000000003
8053,58216756,2023-02-13,-167.82,-474.90999999999997
1602,58249518,2023-01-31,0.0,14.63
7294,58249518,2023-02-07,56.84,71.47
8562,58249518,2023-02-12,-84.03,-12.559999999999997
1603,58254002,2023-01-31,0.0,94.53
1997,58254002,2023-02-01,-91.66,2.8700000000000045
1998,58254002,2023-02-11,-165.77,-162.9
8467,58254002,2023-02-11,45.84,-117.06
8468,58254002,2023-02-11,161.25,44.19
8469,58254002,2023-02-11,184.66,228.85
1999,58254002,2023-02-13,-1258.1,-1029.25
2000,58254002,2023-02-14,-141.17,-1170.42
2001,58254002,2023-02-14,-37.59,-1208.01
1604,58258401,2023-01-31,0.0,873.05
4812,58258401,2023-02-03,154.95,1028.0
6793,58258401,2023-02-06,-178.88,849.1199999999999
6792,58258401,2023-02-06,-119.58,729.54
6794,58258401,2023-02-07,-124.51,605.03
6795,58258401,2023-02-12,-105.2,499.8299999999999
1605,58265755,2023-01-31,0.0,494.05
1797,58265755,2023-02-01,156.89,650.94
3637,58265755,2023-02-02,-124.21,526.73
3638,58265755,2023-02-03,-127.44,399.29
1798,58265755,2023-02-03,178.54,577.83
3639,58265755,2023-02-07,-114.81,463.02
3640,58265755,2023-02-08,-173.81,289.21
1799,58265755,2023-02-14,116.74,405.95
1606,58290957,2023-01-31,0.0,580.25
7108,58290957,2023-02-06,-157.11,423.14
7109,58290957,2023-02-10,-134.24,288.9
1607,58304487,2023-01-31,0.0,5.31
4654,58304487,2023-02-03,-115.75,-110.44
4284,58304487,2023-02-03,59.2,-51.239999999999995
4285,58304487,2023-02-04,95.13,43.89
4655,58304487,2023-02-09,-146.33,-102.44000000000001
4656,58304487,2023-02-13,-86.65,-189.09000000000003
1608,58305943,2023-01-31,0.0,970.56
225,58305943,2023-02-01,58.02,1028.58
2612,58305943,2023-02-02,-164.6,863.98
226,58305943,2023-02-04,99.93,963.91
227,58305943,2023-02-04,118.08,1081.99
2614,58305943,2023-02-07,-124.42,957.5699999999999
2613,58305943,2023-02-07,-122.53,835.04
2615,58305943,2023-02-08,-122.18,712.8599999999999
2616,58305943,2023-02-09,-138.85,574.01
2617,58305943,2023-02-10,-114.0,460.01
1609,58306431,2023-01-31,0.0,576.56
764,58306431,2023-02-01,-102.89,473.66999999999996
3471,58306431,2023-02-02,103.47,577.14
765,58306431,2023-02-03,-123.38,453.75999999999993
3472,58306431,2023-02-04,35.39,489.15
3473,58306431,2023-02-06,742.3,1231.4499999999998
766,58306431,2023-02-12,-202.22,1029.23
767,58306431,2023-02-12,-78.91,950.3199999999999
3474,58306431,2023-02-13,67.88,1018.1999999999999
768,58306431,2023-02-14,-1485.6,-467.4000000000001
1610,58332273,2023-01-31,0.0,299.3
6923,58332273,2023-02-06,-179.82,119.48000000000002
8072,58332273,2023-02-09,73.05,192.53000000000003
8073,58332273,2023-02-12,19.96,212.49
1611,58345258,2023-01-31,0.0,749.07
3227,58345258,2023-02-02,144.51,893.58
3228,58345258,2023-02-06,561.3,1454.88
8001,58345258,2023-02-08,-947.8,507.08000000000004
3229,58345258,2023-02-11,69.7,576.78
3230,58345258,2023-02-13,817.7,1394.48
1612,58362636,2023-01-31,0.0,89.45
6934,58362636,2023-02-06,-39.83,49.620000000000005
7512,58362636,2023-02-07,129.66,179.28
7513,58362636,2023-02-08,120.31,299.59
7514,58362636,2023-02-12,95.84,395.43
1613,58384131,2023-01-31,0.0,327.68
116,58384131,2023-02-01,158.57,486.25
6263,58384131,2023-02-05,-72.1,414.15
6264,58384131,2023-02-09,-147.12,267.03
6265,58384131,2023-02-09,-70.47,196.56
1614,58385320,2023-01-31,0.0,693.52
5986,58385320,2023-02-05,-197.01,496.51
5985,58385320,2023-02-05,-121.41,375.1
5984,58385320,2023-02-05,-89.23,285.87
6653,58385320,2023-02-06,583.7,869.57
5987,58385320,2023-02-10,-79.87,789.7
1615,58400012,2023-01-31,0.0,606.79
1650,58400012,2023-02-01,71.73,678.52
1651,58400012,2023-02-11,59.1,737.62
1616,58434725,2023-01-31,0.0,365.9
4473,58434725,2023-02-03,-87.65,278.25
4474,58434725,2023-02-03,-47.74,230.50999999999996
4475,58434725,2023-02-09,-69.99,160.51999999999998
8505,58434725,2023-02-11,62.47,222.98999999999998
8506,58434725,2023-02-14,91.73,314.71999999999997
1617,58458443,2023-01-31,0.0,903.64
4711,58458443,2023-02-03,-87.05,816.59
4712,58458443,2023-02-07,-180.63,635.96
1618,58489789,2023-01-31,0.0,460.5
3726,58489789,2023-02-02,-120.72,339.78
2423,58489789,2023-02-02,39.87,379.65
3727,58489789,2023-02-04,-54.57,325.08
3728,58489789,2023-02-06,-97.09,227.99
3729,58489789,2023-02-07,-109.32,118.67000000000002
2424,58489789,2023-02-10,98.63,217.3
3730,58489789,2023-02-14,-108.48,108.82
1619,58491429,2023-01-31,0.0,937.47
6467,58491429,2023-02-05,-77.95,859.52
6468,58491429,2023-02-06,-1486.9,-627.3800000000001
6469,58491429,2023-02-07,-103.74,-731.1200000000001
6470,58491429,2023-02-10,-93.02,-824.1400000000001
1620,58533748,2023-01-31,0.0,490.86
5653,58533748,2023-02-04,-113.49,377.37
5654,58533748,2023-02-08,-80.13,297.24
5656,58533748,2023-02-14,-321.9,-24.659999999999968
5655,58533748,2023-02-14,-139.82,-164.4799999999999
8677,58533748,2023-02-14,90.86,-73.62
1621,58547184,2023-01-31,0.0,218.22
3389,58547184,2023-02-02,61.66,279.88
3388,58547184,2023-02-02,1586.6,1866.48
5661,58547184,2023-02-04,-14.63,1851.85
3390,58547184,2023-02-05,83.83,1935.68
3391,58547184,2023-02-06,107.61,2043.29
5662,58547184,2023-02-11,-142.41,1900.88
5663,58547184,2023-02-11,-69.84,1831.04
1622,58558145,2023-01-31,0.0,495.35
8304,58558145,2023-02-10,-114.24,381.11
8305,58558145,2023-02-11,-91.38,289.73
8642,58558145,2023-02-13,91.8,381.53000000000003
1623,58586275,2023-01-31,0.0,916.97
7452,58586275,2023-02-07,-41.64,875.33
7655,58586275,2023-02-07,979.3,1854.63
7453,58586275,2023-02-10,-102.06,1752.57
7454,58586275,2023-02-12,-121.68,1630.8899999999999
1624,58668564,2023-01-31,0.0,813.28
440,58668564,2023-02-01,-105.85,707.43
441,58668564,2023-02-08,-90.09,617.3399999999999
8400,58668564,2023-02-11,1125.0,1742.34
442,58668564,2023-02-12,-108.96,1633.3799999999999
8401,58668564,2023-02-14,57.83,1691.21
1625,58683711,2023-01-31,0.0,12.76
776,58683711,2023-02-01,-115.4,-102.64
6554,58683711,2023-02-05,41.55,-61.09000000000001
6555,58683711,2023-02-10,88.53,27.43999999999999
6556,58683711,2023-02-10,126.49,153.92999999999998
6557,58683711,2023-02-14,0.36,154.29
1626,58703801,2023-01-31,0.0,520.81
8023,58703801,2023-02-09,-100.78,420.03
8308,58703801,2023-02-10,165.41,585.4399999999999
8024,58703801,2023-02-12,-166.9,418.53999999999996
8309,58703801,2023-02-13,53.93,472.4699999999999
1627,58720727,2023-01-31,0.0,471.56
4198,58720727,2023-02-03,-142.86,328.7
5378,58720727,2023-02-04,108.24,436.94
4199,58720727,2023-02-05,-62.37,374.57
4200,58720727,2023-02-08,-92.11,282.46
4201,58720727,2023-02-11,-142.67,139.79000000000002
4202,58720727,2023-02-11,-49.96,89.82999999999998
4203,58720727,2023-02-12,-113.6,-23.77000000000004
4204,58720727,2023-02-13,-80.64,-104.41000000000003
4205,58720727,2023-02-14,-1650.9,-1755.31
1628,58728550,2023-01-31,0.0,250.26
5753,58728550,2023-02-04,-37.8,212.45999999999998
8520,58728550,2023-02-11,114.61,327.07
1629,58785108,2023-01-31,0.0,473.41
2077,58785108,2023-02-01,61.87,535.28
5370,58785108,2023-02-04,-64.43,470.85
2078,58785108,2023-02-04,104.53,575.38
5371,58785108,2023-02-07,-883.6,-308.21999999999997
5372,58785108,2023-02-11,-32.04,-340.25999999999993
2079,58785108,2023-02-13,186.3,-153.95999999999998
1630,58810775,2023-01-31,0.0,747.44
347,58810775,2023-02-01,-62.0,685.44
348,58810775,2023-02-05,-20.17,665.2700000000001
6224,58810775,2023-02-05,114.97,780.24
6225,58810775,2023-02-07,151.21,931.45
349,58810775,2023-02-13,-97.59,833.8600000000001
1631,58811985,2023-01-31,0.0,616.7
7789,58811985,2023-02-08,1024.6,1641.3
7790,58811985,2023-02-09,155.76,1797.06
8530,58811985,2023-02-12,-126.97,1670.09
7791,58811985,2023-02-14,85.37,1755.46
1632,58822254,2023-01-31,0.0,79.7
3019,58822254,2023-02-02,-1559.2,-1479.5
3020,58822254,2023-02-03,-436.5,-1916.0
5216,58822254,2023-02-04,129.56,-1786.44
5217,58822254,2023-02-08,42.43,-1744.01
5218,58822254,2023-02-10,129.11,-1614.8999999999999
1633,58830897,2023-01-31,0.0,834.24
3276,58830897,2023-02-02,-22.54,811.7
3277,58830897,2023-02-04,-55.94,755.76
3278,58830897,2023-02-05,-110.92,644.84
3279,58830897,2023-02-06,-117.02,527.8199999999999
8463,58830897,2023-02-11,152.47,680.29
3280,58830897,2023-02-12,-214.19,466.1
8464,58830897,2023-02-14,137.92,604.02
1634,58837121,2023-01-31,0.0,160.48
5560,58837121,2023-02-04,97.06,257.53999999999996
6148,58837121,2023-02-05,-163.32,94.22
5561,58837121,2023-02-07,75.03,169.25
6149,58837121,2023-02-08,-80.72,88.53
6150,58837121,2023-02-11,-50.91,37.620000000000005
5562,58837121,2023-02-11,111.96,149.57999999999998
5563,58837121,2023-02-14,103.18,252.76
1635,58873428,2023-01-31,0.0,191.58
7535,58873428,2023-02-07,39.09,230.67000000000002
1636,58874842,2023-01-31,0.0,347.73
722,58874842,2023-02-01,-53.09,294.64
723,58874842,2023-02-07,-183.11,111.53
7942,58874842,2023-02-08,106.37,217.9
7943,58874842,2023-02-09,154.04,371.94
7944,58874842,2023-02-10,57.64,429.58
7945,58874842,2023-02-14,86.86,516.44
1637,58897654,2023-01-31,0.0,210.05
5840,58897654,2023-02-04,113.97,324.02
5841,58897654,2023-02-05,193.2,517.22
1638,58925998,2023-01-31,0.0,855.45
6258,58925998,2023-02-05,166.03,1021.48
6259,58925998,2023-02-09,56.12,1077.6000000000001
6260,58925998,2023-02-10,155.67,1233.27
6261,58925998,2023-02-11,100.88,1334.15
6262,58925998,2023-02-12,1261.6,2595.75
1639,58930654,2023-01-31,0.0,661.48
3735,58930654,2023-02-03,136.43,797.9100000000001
5944,58930654,2023-02-04,-158.41,639.5
5945,58930654,2023-02-09,-45.0,594.5
5947,58930654,2023-02-13,-109.04,485.46000000000004
5946,58930654,2023-02-13,-93.39,392.07000000000005
1640,58937028,2023-01-31,0.0,626.96
8536,58937028,2023-02-12,86.73,713.69
1641,58995891,2023-01-31,0.0,12.92
4159,58995891,2023-02-03,-118.76,-105.84
4160,58995891,2023-02-08,-50.31,-156.15
8098,58995891,2023-02-09,125.24,-30.91000000000001
4161,58995891,2023-02-10,-106.62,-137.53000000000003
1642,59110895,2023-01-31,0.0,605.5
8087,59110895,2023-02-09,-1260.0,-654.5
1643,59128512,2023-01-31,0.0,305.71
319,59128512,2023-02-01,158.92,464.63
320,59128512,2023-02-03,94.28,558.91
321,59128512,2023-02-07,1380.5,1939.41
322,59128512,2023-02-08,122.81,2062.22
323,59128512,2023-02-09,109.28,2171.5
324,59128512,2023-02-10,70.74,2242.24
8645,59128512,2023-02-13,-128.0,2114.24
325,59128512,2023-02-13,67.31,2181.55
1644,59135815,2023-01-31,0.0,240.6
1953,59135815,2023-02-01,-800.0,-559.4
5379,59135815,2023-02-04,436.5,-122.9
1954,59135815,2023-02-06,-108.14,-231.04
1955,59135815,2023-02-10,-1202.5,-1433.54
1645,59152169,2023-01-31,0.0,148.6
37,59152169,2023-02-01,70.5,219.1
6375,59152169,2023-02-05,-57.18,161.92
38,59152169,2023-02-05,124.52,286.44
39,59152169,2023-02-08,92.83,379.27
6376,59152169,2023-02-09,-1160.0,-780.73
40,59152169,2023-02-12,89.7,-691.03
1646,59167707,2023-01-31,0.0,904.43
39,59167707,2023-02-01,-109.32,795.1099999999999
40,59167707,2023-02-06,-60.85,734.26
6877,59167707,2023-02-06,49.47,783.73
41,59167707,2023-02-10,-95.08,688.65
1647,59198134,2023-01-31,0.0,122.62
6777,59198134,2023-02-06,168.59,291.21000000000004
8133,59198134,2023-02-09,-104.28,186.93
8134,59198134,2023-02-13,-1291.4,-1104.4700000000003
8135,59198134,2023-02-13,-135.45,-1239.92
1648,59201002,2023-01-31,0.0,780.85
621,59201002,2023-02-01,96.35,877.2
622,59201002,2023-02-01,199.99,1077.19
5951,59201002,2023-02-04,-44.05,1033.14
5952,59201002,2023-02-08,-163.95,869.19
5953,59201002,2023-02-12,-742.0,127.19000000000005
1649,59235925,2023-01-31,0.0,647.8
943,59235925,2023-02-01,-66.43,581.3699999999999
5280,59235925,2023-02-04,111.18,692.55
5281,59235925,2023-02-06,84.1,776.65
944,59235925,2023-02-08,-64.27,712.38
5282,59235925,2023-02-08,42.92,755.3
945,59235925,2023-02-09,-101.53,653.77
5283,59235925,2023-02-11,152.0,805.77
1650,59238438,2023-01-31,0.0,105.1
1626,59238438,2023-02-01,12.97,118.07
7564,59238438,2023-02-07,-49.76,68.31
1627,59238438,2023-02-09,85.32,153.63
7565,59238438,2023-02-12,-1799.2,-1645.5700000000002
1651,59252971,2023-01-31,0.0,803.65
6622,59252971,2023-02-05,85.62,889.27
7642,59252971,2023-02-07,-1741.9,-852.6300000000002
6623,59252971,2023-02-13,131.61,-721.0200000000001
7643,59252971,2023-02-14,-169.73,-890.7500000000001
1652,59265775,2023-01-31,0.0,695.02
1153,59265775,2023-02-01,55.85,750.87
1154,59265775,2023-02-04,81.94,832.81
1155,59265775,2023-02-05,74.37,907.18
1156,59265775,2023-02-11,68.33,975.51
8528,59265775,2023-02-12,-153.05,822.46
8529,59265775,2023-02-12,-130.06,692.4
1157,59265775,2023-02-14,142.86,835.26
1653,59379884,2023-01-31,0.0,139.54
6322,59379884,2023-02-05,81.18,220.72
8277,59379884,2023-02-10,-156.94,63.78
8278,59379884,2023-02-11,-65.4,-1.6200000000000045
6323,59379884,2023-02-12,564.4,562.78
8279,59379884,2023-02-13,-84.91,477.87
1654,59405362,2023-01-31,0.0,503.89
327,59405362,2023-02-01,76.9,580.79
326,59405362,2023-02-01,136.51,717.3
6539,59405362,2023-02-05,-144.79,572.51
6540,59405362,2023-02-08,-195.9,376.61
328,59405362,2023-02-09,645.9,1022.51
6541,59405362,2023-02-10,-66.94,955.5699999999999
329,59405362,2023-02-11,43.44,999.01
1655,59432049,2023-01-31,0.0,387.57
1259,59432049,2023-02-01,142.99,530.56
1260,59432049,2023-02-04,578.7,1109.26
1261,59432049,2023-02-05,1121.5,2230.76
7030,59432049,2023-02-06,-106.77,2123.9900000000002
1263,59432049,2023-02-06,117.11,2241.1
1262,59432049,2023-02-06,129.93,2371.03
7031,59432049,2023-02-08,-125.79,2245.2400000000002
1264,59432049,2023-02-08,66.67,2311.9100000000003
7032,59432049,2023-02-11,-175.69,2136.2200000000003
7033,59432049,2023-02-14,-34.07,2102.15
1656,59450573,2023-01-31,0.0,888.65
6316,59450573,2023-02-05,80.26,968.91
8018,59450573,2023-02-09,-47.96,920.9499999999999
8019,59450573,2023-02-10,-86.27,834.68
1657,59455653,2023-01-31,0.0,4.64
5501,59455653,2023-02-04,7.74,12.379999999999999
6972,59455653,2023-02-06,-129.93,-117.55000000000001
5502,59455653,2023-02-11,148.32,30.769999999999982
6973,59455653,2023-02-12,-1261.7,-1230.93
1658,59510370,2023-01-31,0.0,523.1
4152,59510370,2023-02-03,32.77,555.87
5685,59510370,2023-02-04,-97.19,458.68000000000006
4153,59510370,2023-02-06,12.77,471.45000000000005
5686,59510370,2023-02-10,-62.26,409.19000000000005
5687,59510370,2023-02-14,-53.96,355.23
1659,59529922,2023-01-31,0.0,516.09
1291,59529922,2023-02-01,-129.91,386.18000000000006
1292,59529922,2023-02-03,-104.89,281.29
5772,59529922,2023-02-04,105.37,386.66
5773,59529922,2023-02-06,104.58,491.24
1293,59529922,2023-02-07,-1.77,489.47
5774,59529922,2023-02-09,36.06,525.5300000000001
1295,59529922,2023-02-10,-156.22,369.31000000000006
1294,59529922,2023-02-10,-121.92,247.39000000000004
1296,59529922,2023-02-13,-102.31,145.08000000000004
5775,59529922,2023-02-14,89.67,234.75
1660,59575867,2023-01-31,0.0,576.66
4127,59575867,2023-02-03,5.14,581.8
8361,59575867,2023-02-10,-159.2,422.59999999999997
4128,59575867,2023-02-13,103.44,526.04
1661,59591324,2023-01-31,0.0,509.65
6359,59591324,2023-02-05,-181.42,328.23
6445,59591324,2023-02-05,806.2,1134.43
6446,59591324,2023-02-12,53.98,1188.41
6448,59591324,2023-02-13,135.45,1323.8600000000001
6447,59591324,2023-02-13,156.89,1480.75
1662,59640238,2023-01-31,0.0,993.42
6426,59640238,2023-02-05,129.51,1122.9299999999998
7944,59640238,2023-02-08,-185.22,937.7099999999999
7945,59640238,2023-02-09,-127.23,810.48
6427,59640238,2023-02-11,137.43,947.91
1663,59653557,2023-01-31,0.0,649.61
5538,59653557,2023-02-04,-106.46,543.15
5540,59653557,2023-02-06,-1524.9,-981.7500000000001
5539,59653557,2023-02-06,-37.9,-1019.6500000000002
5541,59653557,2023-02-08,-117.35,-1137.0
1664,59663741,2023-01-31,0.0,642.86
3716,59663741,2023-02-03,68.43,711.29
3718,59663741,2023-02-05,113.1,824.39
3717,59663741,2023-02-05,118.22,942.61
3719,59663741,2023-02-06,97.36,1039.97
7343,59663741,2023-02-07,-199.41,840.56
3720,59663741,2023-02-09,127.72,968.28
7345,59663741,2023-02-10,-1484.2,-515.9200000000002
7344,59663741,2023-02-10,-51.27,-567.1899999999999
7346,59663741,2023-02-11,-85.89,-653.08
3721,59663741,2023-02-14,30.0,-623.08
1665,59684752,2023-01-31,0.0,14.43
112,59684752,2023-02-01,-119.45,-105.02000000000001
113,59684752,2023-02-05,-159.46,-264.48
114,59684752,2023-02-05,-108.03,-372.51
116,59684752,2023-02-06,-154.3,-526.8100000000001
115,59684752,2023-02-06,-27.93,-554.74
117,59684752,2023-02-08,-92.84,-647.58
7720,59684752,2023-02-08,108.02,-539.5600000000001
118,59684752,2023-02-09,-108.23,-647.7900000000001
119,59684752,2023-02-12,-130.68,-778.4700000000001
7721,59684752,2023-02-13,2359.1,1580.6299999999999
1666,59705091,2023-01-31,0.0,631.05
3665,59705091,2023-02-02,1091.2,1722.25
5087,59705091,2023-02-04,-102.22,1620.03
5086,59705091,2023-02-04,-46.93,1573.1
3666,59705091,2023-02-07,111.37,1684.47
3668,59705091,2023-02-08,53.32,1737.79
3667,59705091,2023-02-08,62.19,1799.98
5088,59705091,2023-02-11,-1677.5,122.48000000000002
5089,59705091,2023-02-13,-73.31,49.17000000000007
1667,59737910,2023-01-31,0.0,523.19
4792,59737910,2023-02-03,99.14,622.33
4793,59737910,2023-02-09,132.58,754.9100000000001
8475,59737910,2023-02-11,-139.86,615.0500000000001
4794,59737910,2023-02-11,80.51,695.5600000000001
1668,59855808,2023-01-31,0.0,172.54
2592,59855808,2023-02-02,-157.41,15.129999999999995
5979,59855808,2023-02-05,100.23,115.36
2593,59855808,2023-02-06,-204.86,-89.50000000000003
5980,59855808,2023-02-09,53.95,-35.55000000000004
2594,59855808,2023-02-10,-905.0,-940.5500000000002
2595,59855808,2023-02-12,-58.39,-998.94
5981,59855808,2023-02-13,1397.6,398.65999999999985
2596,59855808,2023-02-14,-179.57,219.0899999999999
1669,59867000,2023-01-31,0.0,62.01
2520,59867000,2023-02-02,116.89,178.9
2521,59867000,2023-02-06,110.54,289.44
7814,59867000,2023-02-08,-124.32,165.12
7813,59867000,2023-02-08,-36.78,128.34
7815,59867000,2023-02-12,-845.0,-716.66
1670,59876714,2023-01-31,0.0,938.46
875,59876714,2023-02-01,469.6,1408.06
876,59876714,2023-02-02,132.84,1540.9
7614,59876714,2023-02-07,-101.89,1439.01
877,59876714,2023-02-07,134.11,1573.1200000000001
878,59876714,2023-02-11,117.41,1690.5300000000002
7615,59876714,2023-02-12,-166.15,1524.38
7616,59876714,2023-02-13,-1535.7,-11.319999999999936
1671,59933973,2023-01-31,0.0,29.98
3641,59933973,2023-02-02,-144.06,-114.08
3642,59933973,2023-02-07,-148.28,-262.36
8529,59933973,2023-02-12,65.93,-196.43
1672,59961433,2023-01-31,0.0,267.05
534,59961433,2023-02-01,-177.63,89.42000000000002
597,59961433,2023-02-01,47.33,136.75
598,59961433,2023-02-05,907.1,1043.85
535,59961433,2023-02-09,-77.09,966.76
599,59961433,2023-02-14,147.72,1114.48
1673,59980709,2023-01-31,0.0,781.42
358,59980709,2023-02-01,99.56,880.98
4849,59980709,2023-02-03,-8.49,872.49
359,59980709,2023-02-06,1194.9,2067.39
1674,59984692,2023-01-31,0.0,818.03
4424,59984692,2023-02-03,-913.8,-95.76999999999998
4425,59984692,2023-02-05,-175.68,-271.45000000000005
4426,59984692,2023-02-05,-111.66,-383.1099999999999
6098,59984692,2023-02-05,33.96,-349.1500000000001
6099,59984692,2023-02-10,119.92,-229.23000000000002
6100,59984692,2023-02-14,7.29,-221.94000000000005
1675,59989722,2023-01-31,0.0,816.77
7409,59989722,2023-02-07,-853.6,-36.83000000000004
7410,59989722,2023-02-09,-78.22,-115.05000000000007
8367,59989722,2023-02-10,672.0,556.9499999999999
1676,60017511,2023-01-31,0.0,859.48
4072,60017511,2023-02-03,-60.17,799.3100000000001
3781,60017511,2023-02-03,41.91,841.22
4073,60017511,2023-02-04,-131.11,710.11
3782,60017511,2023-02-04,1131.3,1841.4099999999999
3783,60017511,2023-02-05,678.7,2520.11
3784,60017511,2023-02-11,56.16,2576.27
3785,60017511,2023-02-11,1363.6,3939.87
3786,60017511,2023-02-13,69.25,4009.12
1677,60114464,2023-01-31,0.0,972.56
4959,60114464,2023-02-03,-43.75,928.81
4960,60114464,2023-02-09,-178.61,750.1999999999999
8238,60114464,2023-02-10,1188.3,1938.5
8239,60114464,2023-02-10,1275.4,3213.9
8240,60114464,2023-02-10,1640.4,4854.3
4961,60114464,2023-02-11,-1777.8,3076.5000000000005
4962,60114464,2023-02-13,-153.62,2922.88
1678,60138058,2023-01-31,0.0,686.46
3793,60138058,2023-02-03,113.46,799.9200000000001
3794,60138058,2023-02-04,59.13,859.0500000000001
3795,60138058,2023-02-07,149.99,1009.0400000000001
3796,60138058,2023-02-08,14.01,1023.0500000000001
8070,60138058,2023-02-09,-110.11,912.94
3797,60138058,2023-02-09,45.0,957.94
8071,60138058,2023-02-10,-1526.7,-568.76
8072,60138058,2023-02-10,-97.78,-666.54
1679,60184250,2023-01-31,0.0,70.89
4884,60184250,2023-02-03,-146.39,-75.49999999999999
5587,60184250,2023-02-04,106.07,30.570000000000007
5588,60184250,2023-02-05,1526.1,1556.67
5589,60184250,2023-02-06,80.07,1636.74
4885,60184250,2023-02-09,-73.11,1563.63
4886,60184250,2023-02-11,-43.44,1520.19
4887,60184250,2023-02-14,-114.54,1405.65
1680,60189055,2023-01-31,0.0,814.54
2234,60189055,2023-02-02,71.52,886.06
5339,60189055,2023-02-04,-629.0,257.05999999999995
5340,60189055,2023-02-05,-62.74,194.31999999999994
2235,60189055,2023-02-08,136.06,330.37999999999994
2236,60189055,2023-02-10,160.72,491.0999999999999
2237,60189055,2023-02-12,129.45,620.55
1681,60193174,2023-01-31,0.0,740.53
2860,60193174,2023-02-02,1327.5,2068.0299999999997
5198,60193174,2023-02-04,-204.89,1863.14
5199,60193174,2023-02-04,-108.21,1754.9299999999998
5200,60193174,2023-02-05,-27.15,1727.78
2861,60193174,2023-02-10,68.91,1796.69
2862,60193174,2023-02-10,101.72,1898.41
5201,60193174,2023-02-12,-127.05,1771.36
2863,60193174,2023-02-13,51.71,1823.07
1682,60202402,2023-01-31,0.0,783.7
4162,60202402,2023-02-03,-18.28,765.4200000000001
4163,60202402,2023-02-05,-963.3,-197.87999999999988
4164,60202402,2023-02-12,-89.55,-287.42999999999984
4165,60202402,2023-02-12,-89.48,-376.90999999999985
8558,60202402,2023-02-12,82.91,-293.9999999999998
8559,60202402,2023-02-13,789.4,495.4000000000001
1683,60220702,2023-01-31,0.0,937.23
4344,60220702,2023-02-03,-37.49,899.74
4345,60220702,2023-02-05,-102.96,796.78
7654,60220702,2023-02-07,98.61,895.39
4346,60220702,2023-02-10,-76.48,818.91
4347,60220702,2023-02-12,-128.94,689.97
1684,60222199,2023-01-31,0.0,350.4
7905,60222199,2023-02-08,537.9,888.3
7906,60222199,2023-02-11,83.49,971.79
8513,60222199,2023-02-12,-893.8,77.99000000000001
1685,60238192,2023-01-31,0.0,307.97
2248,60238192,2023-02-02,120.45,428.42
4322,60238192,2023-02-03,-95.05,333.37
4323,60238192,2023-02-05,-62.49,270.88000000000005
2249,60238192,2023-02-12,202.22,473.1
4324,60238192,2023-02-13,-8.94,464.16
2250,60238192,2023-02-14,58.12,522.28
2251,60238192,2023-02-14,69.61,591.89
1686,60367416,2023-01-31,0.0,754.86
3856,60367416,2023-02-03,-164.14,590.72
3857,60367416,2023-02-04,-96.78,493.94000000000005
6111,60367416,2023-02-05,154.98,648.9200000000001
3858,60367416,2023-02-07,-104.75,544.1700000000001
6113,60367416,2023-02-10,4.42,548.59
6112,60367416,2023-02-10,76.15,624.74
6115,60367416,2023-02-11,51.94,676.6800000000001
6114,60367416,2023-02-11,165.41,842.09
1687,60371134,2023-01-31,0.0,444.57
5763,60371134,2023-02-04,125.07,569.64
5764,60371134,2023-02-07,93.89,663.53
8679,60371134,2023-02-14,-95.91,567.62
1688,60383549,2023-01-31,0.0,268.15
1403,60383549,2023-02-01,38.67,306.82
1404,60383549,2023-02-06,141.54,448.35999999999996
1405,60383549,2023-02-09,73.11,521.47
1406,60383549,2023-02-14,131.83,653.3
1689,60417212,2023-01-31,0.0,653.31
246,60417212,2023-02-01,-974.4,-321.09000000000003
247,60417212,2023-02-01,-69.4,-390.49
248,60417212,2023-02-04,-117.96,-508.45000000000005
5896,60417212,2023-02-05,471.4,-37.05000000000007
249,60417212,2023-02-07,-26.93,-63.98000000000002
250,60417212,2023-02-09,-9.69,-73.67000000000007
251,60417212,2023-02-10,-98.96,-172.6300000000001
5898,60417212,2023-02-11,104.89,-67.74000000000001
5897,60417212,2023-02-11,134.17,66.42999999999995
5899,60417212,2023-02-12,82.59,149.01999999999992
252,60417212,2023-02-13,-145.9,3.119999999999891
253,60417212,2023-02-14,-151.47,-148.35000000000014
1690,60459342,2023-01-31,0.0,734.15
3113,60459342,2023-02-02,-108.85,625.3
3114,60459342,2023-02-03,-36.57,588.73
7320,60459342,2023-02-07,77.09,665.8199999999999
7321,60459342,2023-02-07,103.43,769.25
3115,60459342,2023-02-10,-145.86,623.39
3116,60459342,2023-02-11,-134.17,489.22
3117,60459342,2023-02-12,-134.05,355.16999999999996
3118,60459342,2023-02-13,-30.31,324.86
1691,60522190,2023-01-31,0.0,965.46
3002,60522190,2023-02-02,51.61,1017.07
3003,60522190,2023-02-08,1589.0,2606.0699999999997
8344,60522190,2023-02-10,-61.2,2544.87
1692,60659147,2023-01-31,0.0,323.85
787,60659147,2023-02-01,-140.1,183.75000000000003
788,60659147,2023-02-03,-136.92,46.83000000000004
6942,60659147,2023-02-06,98.87,145.70000000000005
6943,60659147,2023-02-10,103.49,249.19000000000005
789,60659147,2023-02-11,-99.35,149.84000000000003
790,60659147,2023-02-13,-72.13,77.71000000000004
6944,60659147,2023-02-13,14.32,92.03000000000006
1693,60667043,2023-01-31,0.0,937.62
4080,60667043,2023-02-03,-19.83,917.79
4081,60667043,2023-02-04,-861.1,56.68999999999994
4082,60667043,2023-02-04,-165.76,-109.07000000000005
4083,60667043,2023-02-06,-308.7,-417.7700000000001
4084,60667043,2023-02-09,-148.39,-566.16
7963,60667043,2023-02-09,88.81,-477.35
7962,60667043,2023-02-09,96.08,-381.2700000000001
4085,60667043,2023-02-11,-1199.0,-1580.2700000000004
7964,60667043,2023-02-14,122.9,-1457.3700000000003
1694,60684197,2023-01-31,0.0,752.92
4713,60684197,2023-02-03,-179.13,573.79
5795,60684197,2023-02-04,140.43,714.22
5796,60684197,2023-02-06,76.95,791.17
5797,60684197,2023-02-11,60.22,851.39
4714,60684197,2023-02-12,-41.59,809.8
1695,60707792,2023-01-31,0.0,220.35
1169,60707792,2023-02-01,-126.01,94.33999999999999
1952,60707792,2023-02-01,122.51,216.85
1953,60707792,2023-02-05,99.42,316.27
1170,60707792,2023-02-06,-154.81,161.45999999999998
1172,60707792,2023-02-14,-159.73,1.7299999999999898
1171,60707792,2023-02-14,-56.24,-54.50999999999996
1696,60711202,2023-01-31,0.0,869.92
4972,60711202,2023-02-03,-165.39,704.53
4973,60711202,2023-02-07,-260.82,443.71
4974,60711202,2023-02-08,-191.64,252.07000000000005
8657,60711202,2023-02-14,93.66,345.73
1697,60730902,2023-01-31,0.0,243.72
1614,60730902,2023-02-01,-17.61,226.11
1615,60730902,2023-02-02,-85.17,140.94
1618,60730902,2023-02-03,-67.03,73.91
1617,60730902,2023-02-03,-56.31,17.599999999999994
1616,60730902,2023-02-03,-13.52,4.079999999999984
1619,60730902,2023-02-06,-44.47,-40.390000000000015
1620,60730902,2023-02-10,-88.33,-128.72
8334,60730902,2023-02-10,192.26,63.53999999999999
1621,60730902,2023-02-12,-95.07,-31.53
1698,60751083,2023-01-31,0.0,115.23
5776,60751083,2023-02-04,-129.92,-14.689999999999984
5777,60751083,2023-02-05,-23.88,-38.56999999999998
5951,60751083,2023-02-05,129.71,91.14000000000003
5952,60751083,2023-02-07,85.77,176.91000000000003
5953,60751083,2023-02-08,782.7,959.6100000000001
5954,60751083,2023-02-09,96.28,1055.89
5955,60751083,2023-02-10,123.72,1179.6100000000001
1699,60755797,2023-01-31,0.0,207.78
4896,60755797,2023-02-03,-164.56,43.22
7671,60755797,2023-02-07,93.07,136.29
4897,60755797,2023-02-08,-33.32,102.97
4898,60755797,2023-02-12,-16.56,86.41
7672,60755797,2023-02-13,1856.7,1943.11
4899,60755797,2023-02-14,-64.87,1878.24
1700,60789634,2023-01-31,0.0,379.4
4567,60789634,2023-02-03,174.25,553.65
4568,60789634,2023-02-05,65.25,618.9
4569,60789634,2023-02-05,116.03,734.93
4570,60789634,2023-02-09,161.02,895.9499999999999
8535,60789634,2023-02-12,-140.82,755.13
8536,60789634,2023-02-12,-49.38,705.75
4571,60789634,2023-02-12,146.05,851.8
8537,60789634,2023-02-13,-78.14,773.6600000000001
1701,60819695,2023-01-31,0.0,38.96
4211,60819695,2023-02-03,92.73,131.69
5178,60819695,2023-02-04,-207.89,-76.19999999999999
5179,60819695,2023-02-04,-121.97,-198.17
5180,60819695,2023-02-09,-96.94,-295.11
4212,60819695,2023-02-11,88.2,-206.90999999999997
4213,60819695,2023-02-14,111.2,-95.70999999999995
1702,60860851,2023-01-31,0.0,17.96
2640,60860851,2023-02-02,-15.19,2.7700000000000014
2641,60860851,2023-02-04,-142.92,-140.14999999999998
2642,60860851,2023-02-07,-1372.5,-1512.6499999999999
2644,60860851,2023-02-10,-152.92,-1665.57
2643,60860851,2023-02-10,-114.32,-1779.8899999999999
8268,60860851,2023-02-10,194.97,-1584.9199999999998
1703,60866500,2023-01-31,0.0,523.13
4940,60866500,2023-02-03,-77.14,445.99
4941,60866500,2023-02-05,-116.03,329.96
7075,60866500,2023-02-06,68.31,398.27
4942,60866500,2023-02-09,-125.74,272.53
4943,60866500,2023-02-11,-79.43,193.10000000000002
7076,60866500,2023-02-11,156.49,349.59000000000003
1704,60916657,2023-01-31,0.0,893.41
4139,60916657,2023-02-03,117.51,1010.92
6528,60916657,2023-02-05,-76.57,934.35
6529,60916657,2023-02-06,-56.09,878.26
4140,60916657,2023-02-11,71.24,949.5
4141,60916657,2023-02-12,50.94,1000.4399999999999
1705,60930856,2023-01-31,0.0,445.07
4674,60930856,2023-02-03,-46.85,398.21999999999997
4675,60930856,2023-02-04,-131.69,266.53
4676,60930856,2023-02-07,-52.98,213.55
8539,60930856,2023-02-12,68.26,281.81
8540,60930856,2023-02-12,123.5,405.31
8541,60930856,2023-02-14,64.87,470.18
1706,60955647,2023-01-31,0.0,546.28
8423,60955647,2023-02-11,34.52,580.8
8424,60955647,2023-02-14,126.46,707.26
1707,60966485,2023-01-31,0.0,774.41
474,60966485,2023-02-01,-116.0,658.41
835,60966485,2023-02-01,63.28,721.6899999999999
836,60966485,2023-02-04,187.19,908.88
475,60966485,2023-02-05,-151.29,757.5899999999999
476,60966485,2023-02-06,-193.24,564.3499999999999
477,60966485,2023-02-07,-56.84,507.51
478,60966485,2023-02-10,-155.39,352.12
837,60966485,2023-02-12,57.89,410.01
838,60966485,2023-02-14,149.95,559.96
1708,60996794,2023-01-31,0.0,27.98
5730,60996794,2023-02-04,63.46,91.44
7836,60996794,2023-02-08,-903.3,-811.8599999999999
7837,60996794,2023-02-11,-66.62,-878.4799999999999
7838,60996794,2023-02-13,-1525.2,-2403.68
1709,61087394,2023-01-31,0.0,112.81
1523,61087394,2023-02-01,121.69,234.5
7543,61087394,2023-02-07,-38.29,196.21
1524,61087394,2023-02-07,156.4,352.61
7544,61087394,2023-02-08,-1621.0,-1268.39
7545,61087394,2023-02-12,-52.46,-1320.8500000000001
7547,61087394,2023-02-13,-105.17,-1426.02
7546,61087394,2023-02-13,-101.58,-1527.6000000000001
7548,61087394,2023-02-14,-1879.5,-3407.1
1710,61101757,2023-01-31,0.0,992.2
1711,61152319,2023-01-31,0.0,471.31
1490,61152319,2023-02-01,-75.45,395.86
1491,61152319,2023-02-04,-82.25,313.61
7483,61152319,2023-02-07,61.01,374.62
7484,61152319,2023-02-08,57.93,432.55
1492,61152319,2023-02-13,-79.81,352.74
1712,61178950,2023-01-31,0.0,104.88
5055,61178950,2023-02-04,79.62,184.5
8073,61178950,2023-02-09,-95.74,88.76
5056,61178950,2023-02-10,150.39,239.14999999999998
8074,61178950,2023-02-13,-1023.0,-783.85
8075,61178950,2023-02-14,-685.5,-1469.35
1713,61181609,2023-01-31,0.0,44.55
1377,61181609,2023-02-01,-146.28,-101.73
1378,61181609,2023-02-03,-321.6,-423.33
1379,61181609,2023-02-04,-114.54,-537.87
1380,61181609,2023-02-09,-80.63,-618.5
1381,61181609,2023-02-11,-106.62,-725.12
1382,61181609,2023-02-12,-108.99,-834.11
1383,61181609,2023-02-14,-89.9,-924.01
1714,61279456,2023-01-31,0.0,814.3
3070,61279456,2023-02-02,-93.31,720.99
3071,61279456,2023-02-04,-72.97,648.02
5761,61279456,2023-02-04,133.05,781.0699999999999
3072,61279456,2023-02-06,-22.45,758.62
3073,61279456,2023-02-09,-180.82,577.8
3074,61279456,2023-02-11,-94.12,483.67999999999995
3075,61279456,2023-02-12,-81.44,402.23999999999995
3076,61279456,2023-02-12,-56.08,346.15999999999997
5762,61279456,2023-02-12,134.18,480.34
3077,61279456,2023-02-13,-1406.7,-926.3600000000001
3078,61279456,2023-02-13,-116.67,-1043.0300000000002
1715,61419726,2023-01-31,0.0,932.41
2273,61419726,2023-02-02,176.64,1109.05
2274,61419726,2023-02-03,131.74,1240.79
7606,61419726,2023-02-07,-105.53,1135.26
7608,61419726,2023-02-09,-149.64,985.62
7607,61419726,2023-02-09,-85.81,899.81
7609,61419726,2023-02-10,-213.8,686.01
1716,61423373,2023-01-31,0.0,87.17
8109,61423373,2023-02-09,-411.3,-324.13
8110,61423373,2023-02-10,-655.8,-979.93
8393,61423373,2023-02-11,113.52,-866.41
1717,61450849,2023-01-31,0.0,890.19
1342,61450849,2023-02-01,-646.2,243.99
1343,61450849,2023-02-02,-6.47,237.51999999999998
1344,61450849,2023-02-04,-121.04,116.48000000000002
1345,61450849,2023-02-06,-133.12,-16.639999999999986
1346,61450849,2023-02-07,-54.63,-71.26999999999998
1347,61450849,2023-02-08,-41.56,-112.83000000000004
7785,61450849,2023-02-08,68.6,-44.23000000000002
7786,61450849,2023-02-08,94.96,50.73000000000002
1718,61493381,2023-01-31,0.0,569.94
1622,61493381,2023-02-01,-12.97,556.97
1623,61493381,2023-02-05,-54.53,502.44000000000005
1624,61493381,2023-02-06,-113.47,388.97
1625,61493381,2023-02-08,-203.33,185.64000000000004
1626,61493381,2023-02-09,-77.58,108.06000000000006
1627,61493381,2023-02-12,-182.63,-74.56999999999994
1628,61493381,2023-02-14,-81.5,-156.06999999999994
1719,61512912,2023-01-31,0.0,328.0
7724,61512912,2023-02-08,-138.88,189.12
7726,61512912,2023-02-11,-165.41,23.710000000000036
7725,61512912,2023-02-11,-38.45,-14.740000000000009
1720,61555609,2023-01-31,0.0,505.76
2680,61555609,2023-02-02,-150.57,355.19
2681,61555609,2023-02-03,-90.12,265.07
8138,61555609,2023-02-09,77.33,342.4
8139,61555609,2023-02-13,1503.2,1845.6000000000001
1721,61578713,2023-01-31,0.0,209.89
5939,61578713,2023-02-05,34.76,244.64999999999998
5940,61578713,2023-02-05,88.55,333.2
7352,61578713,2023-02-07,-106.48,226.71999999999997
7351,61578713,2023-02-07,-81.64,145.07999999999998
7353,61578713,2023-02-09,-112.05,33.02999999999997
7354,61578713,2023-02-10,-95.62,-62.59000000000003
1722,61582769,2023-01-31,0.0,325.47
2962,61582769,2023-02-02,87.06,412.53000000000003
2963,61582769,2023-02-08,69.56,482.09000000000003
8429,61582769,2023-02-11,-124.32,357.77000000000004
8430,61582769,2023-02-13,-123.64,234.13000000000005
2964,61582769,2023-02-14,167.84,401.97
1723,61593392,2023-01-31,0.0,621.21
8218,61593392,2023-02-10,-92.09,529.12
8219,61593392,2023-02-11,-41.89,487.23
1724,61634340,2023-01-31,0.0,83.85
2141,61634340,2023-02-01,-148.64,-64.78999999999999
2142,61634340,2023-02-03,-60.33,-125.11999999999998
2143,61634340,2023-02-04,-238.96,-364.08000000000004
2144,61634340,2023-02-07,-109.13,-473.2099999999999
2145,61634340,2023-02-12,-94.0,-567.2099999999999
2146,61634340,2023-02-13,-70.25,-637.4599999999999
1725,61642813,2023-01-31,0.0,760.74
2140,61642813,2023-02-02,177.88,938.62
5315,61642813,2023-02-04,-73.67,864.95
2141,61642813,2023-02-10,221.22,1086.17
5316,61642813,2023-02-13,-68.67,1017.5
2142,61642813,2023-02-13,81.39,1098.8899999999999
1726,61644310,2023-01-31,0.0,709.97
5267,61644310,2023-02-04,-72.42,637.5500000000001
5268,61644310,2023-02-05,-89.72,547.83
5269,61644310,2023-02-06,-110.71,437.12
5270,61644310,2023-02-08,-106.37,330.75
8633,61644310,2023-02-13,87.58,418.33000000000004
8634,61644310,2023-02-13,136.4,554.73
1727,61649729,2023-01-31,0.0,848.76
4181,61649729,2023-02-03,-26.28,822.48
7463,61649729,2023-02-07,156.28,978.76
7464,61649729,2023-02-10,149.53,1128.29
1728,61661386,2023-01-31,0.0,524.42
7455,61661386,2023-02-07,-125.96,398.46
7456,61661386,2023-02-11,-126.05,272.40999999999997
1729,61676204,2023-01-31,0.0,88.85
5169,61676204,2023-02-04,-75.65,13.199999999999989
5643,61676204,2023-02-04,90.09,103.28999999999999
5644,61676204,2023-02-04,134.22,237.51
5170,61676204,2023-02-06,-43.35,194.16
5171,61676204,2023-02-07,-7.57,186.58999999999997
5645,61676204,2023-02-09,49.06,235.65
5646,61676204,2023-02-13,89.3,324.95
1730,61682186,2023-01-31,0.0,959.96
3571,61682186,2023-02-02,154.85,1114.81
8311,61682186,2023-02-10,-99.28,1015.53
8312,61682186,2023-02-10,-26.43,989.1
3572,61682186,2023-02-11,659.5,1648.6
8313,61682186,2023-02-12,-61.6,1587.0
8314,61682186,2023-02-12,-19.98,1567.02
3573,61682186,2023-02-13,1132.5,2699.52
1731,61687835,2023-01-31,0.0,739.0
4466,61687835,2023-02-03,-102.16,636.84
3882,61687835,2023-02-03,147.6,784.44
4467,61687835,2023-02-06,-561.3,223.1400000000001
4468,61687835,2023-02-06,-163.9,59.24000000000012
3883,61687835,2023-02-08,9.19,68.43000000000006
3884,61687835,2023-02-08,56.13,124.56000000000006
3885,61687835,2023-02-09,652.0,776.5600000000001
4469,61687835,2023-02-10,-212.1,564.46
3887,61687835,2023-02-11,142.29,706.75
3886,61687835,2023-02-11,165.77,872.5200000000001
3888,61687835,2023-02-12,62.63,935.1500000000001
1732,61720005,2023-01-31,0.0,687.35
2552,61720005,2023-02-02,-49.63,637.72
2553,61720005,2023-02-03,-75.28,562.44
2554,61720005,2023-02-05,-0.49,561.95
6036,61720005,2023-02-05,72.33,634.28
2555,61720005,2023-02-08,-107.47,526.8100000000001
6037,61720005,2023-02-09,105.86,632.6700000000001
2556,61720005,2023-02-10,-204.71,427.96000000000004
2557,61720005,2023-02-12,-50.65,377.31
2558,61720005,2023-02-13,-38.26,339.05
1733,61724951,2023-01-31,0.0,656.25
4728,61724951,2023-02-03,33.4,689.65
7355,61724951,2023-02-07,-99.73,589.92
7356,61724951,2023-02-08,-69.75,520.1700000000001
4730,61724951,2023-02-09,65.77,585.94
4729,61724951,2023-02-09,139.86,725.8
4731,61724951,2023-02-10,107.4,833.2
4732,61724951,2023-02-12,207.6,1040.8
7357,61724951,2023-02-13,-1127.3,-86.5
1734,61781801,2023-01-31,0.0,699.78
5030,61781801,2023-02-03,71.27,771.05
7280,61781801,2023-02-07,-84.97,686.0799999999999
5031,61781801,2023-02-07,182.27,868.3499999999999
5033,61781801,2023-02-08,1051.4,1919.75
5032,61781801,2023-02-08,1428.0,3347.75
5034,61781801,2023-02-09,49.68,3397.4300000000003
5035,61781801,2023-02-14,81.5,3478.9300000000003
1735,61847987,2023-01-31,0.0,874.22
5196,61847987,2023-02-04,75.65,949.87
6941,61847987,2023-02-06,-86.9,862.97
6942,61847987,2023-02-08,-2017.7,-1154.73
6943,61847987,2023-02-11,-89.18,-1243.91
5197,61847987,2023-02-14,67.85,-1176.0600000000002
1736,61860337,2023-01-31,0.0,892.77
6122,61860337,2023-02-05,-97.37,795.4
7217,61860337,2023-02-06,64.67,860.0699999999999
6123,61860337,2023-02-07,-132.98,727.0899999999999
6124,61860337,2023-02-09,-1679.2,-952.1100000000001
7218,61860337,2023-02-11,107.49,-844.6200000000001
6125,61860337,2023-02-12,-102.73,-947.3500000000001
1737,61884944,2023-01-31,0.0,123.93
3990,61884944,2023-02-03,96.42,220.35000000000002
3991,61884944,2023-02-03,156.2,376.55
3992,61884944,2023-02-04,189.33,565.8800000000001
6313,61884944,2023-02-05,-997.4,-431.5199999999999
3993,61884944,2023-02-08,193.89,-237.62999999999994
6314,61884944,2023-02-10,-106.29,-343.91999999999996
3994,61884944,2023-02-12,985.9,641.98
3995,61884944,2023-02-14,131.36,773.3400000000001
1738,61941956,2023-01-31,0.0,137.19
3836,61941956,2023-02-03,-48.48,88.71000000000001
3837,61941956,2023-02-04,-64.48,24.22999999999999
3838,61941956,2023-02-09,-181.01,-156.78000000000003
8148,61941956,2023-02-09,52.73,-104.05000000000001
1739,61979134,2023-01-31,0.0,574.77
4018,61979134,2023-02-03,-106.43,468.34
4017,61979134,2023-02-03,-15.12,453.21999999999997
4019,61979134,2023-02-04,-101.39,351.83
7995,61979134,2023-02-09,143.27,495.09999999999997
1740,61999896,2023-01-31,0.0,788.63
5997,61999896,2023-02-05,106.71,895.34
5998,61999896,2023-02-05,1475.4,2370.7400000000002
6785,61999896,2023-02-06,-123.77,2246.9700000000003
6784,61999896,2023-02-06,-63.49,2183.48
5999,61999896,2023-02-06,739.3,2922.78
6000,61999896,2023-02-08,51.04,2973.82
6002,61999896,2023-02-11,132.76,3106.5800000000004
6001,61999896,2023-02-11,510.2,3616.78
6003,61999896,2023-02-13,137.58,3754.36
1741,62077439,2023-01-31,0.0,333.47
645,62077439,2023-02-01,345.3,678.77
6337,62077439,2023-02-05,-166.03,512.74
6338,62077439,2023-02-06,-96.82,415.9200000000001
646,62077439,2023-02-07,110.79,526.71
6339,62077439,2023-02-08,-123.3,403.4100000000001
6340,62077439,2023-02-09,-121.95,281.46000000000004
6341,62077439,2023-02-10,-958.6,-677.14
647,62077439,2023-02-12,491.6,-185.53999999999996
1742,62141083,2023-01-31,0.0,17.63
2490,62141083,2023-02-02,104.03,121.66
2491,62141083,2023-02-05,168.21,289.87
2492,62141083,2023-02-07,94.93,384.8
8478,62141083,2023-02-11,-46.65,338.15000000000003
8479,62141083,2023-02-13,-113.41,224.74
1743,62147353,2023-01-31,0.0,783.96
5070,62147353,2023-02-04,-65.13,718.83
8188,62147353,2023-02-10,54.73,773.5600000000001
5071,62147353,2023-02-12,-31.75,741.8100000000001
8189,62147353,2023-02-12,109.65,851.46
5072,62147353,2023-02-14,-144.85,706.61
1744,62158499,2023-01-31,0.0,581.72
2222,62158499,2023-02-02,89.46,671.1800000000001
2223,62158499,2023-02-04,89.95,761.13
6671,62158499,2023-02-05,-821.8,-60.66999999999996
2224,62158499,2023-02-08,163.95,103.28000000000003
6672,62158499,2023-02-11,-121.47,-18.18999999999994
6674,62158499,2023-02-13,-901.5,-919.6899999999998
6673,62158499,2023-02-13,-17.92,-937.6099999999999
2225,62158499,2023-02-13,104.56,-833.05
1745,62191488,2023-01-31,0.0,652.76
136,62191488,2023-02-01,-79.2,573.56
1538,62191488,2023-02-01,115.85,689.41
1539,62191488,2023-02-03,115.62,805.03
1540,62191488,2023-02-08,14.52,819.55
137,62191488,2023-02-09,-4.38,815.17
1541,62191488,2023-02-09,112.76,927.9300000000001
1746,62213525,2023-01-31,0.0,45.68
1024,62213525,2023-02-01,948.2,993.88
5525,62213525,2023-02-04,-1702.7,-708.82
5524,62213525,2023-02-04,-143.01,-851.83
5526,62213525,2023-02-07,-139.96,-991.7900000000001
1025,62213525,2023-02-07,336.2,-655.59
5527,62213525,2023-02-10,-114.59,-770.1800000000001
1026,62213525,2023-02-10,90.86,-679.32
1747,62222306,2023-01-31,0.0,304.45
3396,62222306,2023-02-02,-108.46,195.99
3398,62222306,2023-02-03,-89.93,106.06
3397,62222306,2023-02-03,-60.47,45.589999999999975
3399,62222306,2023-02-04,-1639.2,-1593.61
3400,62222306,2023-02-10,-9.75,-1603.3600000000001
1748,62227017,2023-01-31,0.0,177.72
3170,62227017,2023-02-02,128.31,306.03
8065,62227017,2023-02-09,-112.93,193.1
3171,62227017,2023-02-13,122.16,315.26
1749,62251465,2023-01-31,0.0,304.55
598,62251465,2023-02-01,-96.35,208.20000000000002
3075,62251465,2023-02-02,15.44,223.64000000000001
3076,62251465,2023-02-06,187.58,411.22
599,62251465,2023-02-07,-195.55,215.67000000000002
3077,62251465,2023-02-07,37.9,253.57000000000002
3078,62251465,2023-02-11,127.25,380.82000000000005
1750,62256127,2023-01-31,0.0,784.39
6061,62256127,2023-02-05,-151.27,633.12
7264,62256127,2023-02-07,134.55,767.67
6062,62256127,2023-02-09,-137.44,630.23
6064,62256127,2023-02-11,-1363.6,-733.37
6063,62256127,2023-02-11,-100.94,-834.3100000000001
6065,62256127,2023-02-12,-1491.7,-2326.01
1751,62276269,2023-01-31,0.0,575.1
2285,62276269,2023-02-02,-142.26,432.84000000000003
2286,62276269,2023-02-04,-126.83,306.01000000000005
7726,62276269,2023-02-08,50.71,356.72
1752,62289297,2023-01-31,0.0,802.44
8493,62289297,2023-02-11,-157.6,644.84
1753,62320219,2023-01-31,0.0,178.4
6153,62320219,2023-02-05,-49.95,128.45
6423,62320219,2023-02-05,112.45,240.9
6422,62320219,2023-02-05,141.51,382.40999999999997
6424,62320219,2023-02-08,47.37,429.78
1754,62332278,2023-01-31,0.0,970.66
1529,62332278,2023-02-01,119.74,1090.3999999999999
7377,62332278,2023-02-07,-83.68,1006.7199999999999
7376,62332278,2023-02-07,-32.06,974.66
7378,62332278,2023-02-10,-145.13,829.53
1530,62332278,2023-02-12,58.63,888.16
1531,62332278,2023-02-12,166.15,1054.31
1532,62332278,2023-02-13,181.54,1235.85
1755,62362650,2023-01-31,0.0,650.79
495,62362650,2023-02-01,-466.7,184.08999999999997
1309,62362650,2023-02-01,129.83,313.91999999999996
1310,62362650,2023-02-05,62.8,376.71999999999997
1311,62362650,2023-02-05,118.78,495.5
496,62362650,2023-02-06,-133.3,362.2
497,62362650,2023-02-08,-85.01,277.19
1313,62362650,2023-02-08,138.18,415.37
1312,62362650,2023-02-08,162.63,578.0
1314,62362650,2023-02-08,191.5,769.5
498,62362650,2023-02-11,-114.77,654.73
1315,62362650,2023-02-11,67.06,721.79
1316,62362650,2023-02-13,80.64,802.4300000000001
1756,62412215,2023-01-31,0.0,766.15
2282,62412215,2023-02-02,-89.46,676.6899999999999
2283,62412215,2023-02-03,-89.33,587.36
6848,62412215,2023-02-06,96.82,684.18
6847,62412215,2023-02-06,1011.5,1695.6799999999998
2284,62412215,2023-02-07,-97.95,1597.73
6849,62412215,2023-02-12,1278.9,2876.63
1757,62414886,2023-01-31,0.0,489.04
3137,62414886,2023-02-02,-107.51,381.53000000000003
3139,62414886,2023-02-06,-72.35,309.18
3138,62414886,2023-02-06,-63.36,245.82000000000002
3140,62414886,2023-02-09,-89.43,156.39000000000004
3141,62414886,2023-02-09,-50.28,106.11000000000001
3142,62414886,2023-02-11,-159.77,-53.660000000000025
3143,62414886,2023-02-11,-74.36,-128.02000000000004
3144,62414886,2023-02-12,-126.93,-254.95
3146,62414886,2023-02-13,-789.4,-1044.35
3145,62414886,2023-02-13,-132.93,-1177.28
1758,62470872,2023-01-31,0.0,436.81
3983,62470872,2023-02-03,-81.28,355.53
6778,62470872,2023-02-06,78.94,434.47
6779,62470872,2023-02-11,60.09,494.56
6780,62470872,2023-02-13,101.09,595.65
3984,62470872,2023-02-14,-140.8,454.85
1759,62477219,2023-01-31,0.0,715.67
7890,62477219,2023-02-08,-99.5,616.17
1760,62511159,2023-01-31,0.0,347.79
7752,62511159,2023-02-08,-123.12,224.67000000000002
8042,62511159,2023-02-09,33.68,258.35
8043,62511159,2023-02-10,5.2,263.55
1761,62567104,2023-01-31,0.0,53.95
1896,62567104,2023-02-01,-124.73,-70.78
1897,62567104,2023-02-04,-152.48,-223.26
1898,62567104,2023-02-08,-190.37,-413.63000000000005
8678,62567104,2023-02-14,113.47,-300.16
1762,62580854,2023-01-31,0.0,421.59
6024,62580854,2023-02-05,114.23,535.8199999999999
7261,62580854,2023-02-07,-199.97,335.84999999999997
1763,62584374,2023-01-31,0.0,334.08
2075,62584374,2023-02-01,130.11,464.19
6623,62584374,2023-02-05,-101.23,362.96
2076,62584374,2023-02-06,30.38,393.34
6624,62584374,2023-02-12,-518.5,-125.16000000000003
6625,62584374,2023-02-14,-126.17,-251.32999999999998
1764,62671957,2023-01-31,0.0,168.03
1317,62671957,2023-02-01,96.51,264.54
7268,62671957,2023-02-07,-126.74,137.8
1318,62671957,2023-02-07,101.36,239.16000000000003
1319,62671957,2023-02-08,119.16,358.32000000000005
1320,62671957,2023-02-09,58.59,416.90999999999997
1321,62671957,2023-02-11,1454.9,1871.8100000000002
7269,62671957,2023-02-12,-51.66,1820.15
1322,62671957,2023-02-12,96.6,1916.7500000000002
1765,62716405,2023-01-31,0.0,531.19
3364,62716405,2023-02-02,84.59,615.7800000000001
3365,62716405,2023-02-03,98.24,714.02
3366,62716405,2023-02-06,15.22,729.24
3367,62716405,2023-02-14,68.51,797.75
1766,62746004,2023-01-31,0.0,638.36
8306,62746004,2023-02-10,97.09,735.45
8307,62746004,2023-02-11,113.8,849.25
1767,62756075,2023-01-31,0.0,896.87
3971,62756075,2023-02-03,10.53,907.4
3970,62756075,2023-02-03,436.5,1343.9
6154,62756075,2023-02-05,-61.84,1282.06
6155,62756075,2023-02-06,-11.94,1270.12
3972,62756075,2023-02-08,14.84,1284.96
6156,62756075,2023-02-10,-355.2,929.76
3973,62756075,2023-02-12,196.98,1126.74
3974,62756075,2023-02-13,142.99,1269.73
1768,62780588,2023-01-31,0.0,828.86
4457,62780588,2023-02-03,-534.6,294.26
5658,62780588,2023-02-04,72.53,366.78999999999996
5659,62780588,2023-02-06,62.08,428.87
5661,62780588,2023-02-08,41.57,470.44
5660,62780588,2023-02-08,106.62,577.06
5662,62780588,2023-02-10,109.89,686.95
5663,62780588,2023-02-11,663.1,1350.0500000000002
4458,62780588,2023-02-12,-233.91,1116.1399999999999
1769,62862427,2023-01-31,0.0,545.14
2016,62862427,2023-02-01,-176.41,368.73
5934,62862427,2023-02-05,19.27,388.0
2017,62862427,2023-02-06,-70.55,317.45
5935,62862427,2023-02-06,1069.9,1387.35
5936,62862427,2023-02-10,76.48,1463.83
2018,62862427,2023-02-11,-101.6,1362.23
5937,62862427,2023-02-11,89.55,1451.7800000000002
5938,62862427,2023-02-13,1756.0,3207.78
2019,62862427,2023-02-14,-76.49,3131.29
1770,63014981,2023-01-31,0.0,222.98
6686,63014981,2023-02-05,-42.25,180.73
6688,63014981,2023-02-09,-132.48,48.25
6687,63014981,2023-02-09,-26.32,21.930000000000007
1771,63057168,2023-01-31,0.0,159.71
3084,63057168,2023-02-02,104.5,264.21000000000004
8066,63057168,2023-02-09,-16.12,248.09
8067,63057168,2023-02-10,-92.49,155.60000000000002
3085,63057168,2023-02-10,142.78,298.38
1772,63102647,2023-01-31,0.0,665.14
507,63102647,2023-02-01,77.81,742.95
5703,63102647,2023-02-04,-109.76,633.1899999999999
508,63102647,2023-02-04,76.44,709.63
5704,63102647,2023-02-07,-20.07,689.56
509,63102647,2023-02-07,32.06,721.62
510,63102647,2023-02-07,79.0,800.62
511,63102647,2023-02-07,113.01,913.63
5705,63102647,2023-02-09,-124.1,789.53
512,63102647,2023-02-09,58.71,848.24
5706,63102647,2023-02-11,-152.0,696.24
513,63102647,2023-02-11,158.35,854.5899999999999
1773,63232279,2023-01-31,0.0,931.78
852,63232279,2023-02-01,118.27,1050.05
3438,63232279,2023-02-02,-159.22,890.8299999999999
853,63232279,2023-02-02,129.83,1020.66
3439,63232279,2023-02-03,-2285.6,-1264.9399999999998
854,63232279,2023-02-03,640.4,-624.5399999999997
3440,63232279,2023-02-07,-146.5,-771.0399999999997
855,63232279,2023-02-08,56.83,-714.2099999999998
3441,63232279,2023-02-09,-125.05,-839.2599999999998
3442,63232279,2023-02-11,-36.36,-875.6199999999999
856,63232279,2023-02-11,125.55,-750.0699999999999
1774,63265361,2023-01-31,0.0,935.22
3188,63265361,2023-02-02,-884.3,50.92000000000007
4672,63265361,2023-02-03,96.77,147.69000000000005
4673,63265361,2023-02-05,949.6,1097.29
3189,63265361,2023-02-07,-135.72,961.57
3190,63265361,2023-02-08,-132.99,828.58
4674,63265361,2023-02-10,29.92,858.5000000000001
4675,63265361,2023-02-12,136.93,995.4300000000001
1775,63280767,2023-01-31,0.0,836.58
2402,63280767,2023-02-02,58.65,895.23
2403,63280767,2023-02-03,43.75,938.98
6326,63280767,2023-02-05,-159.79,779.19
6327,63280767,2023-02-07,-852.6,-73.40999999999997
2404,63280767,2023-02-10,79.87,6.460000000000036
2405,63280767,2023-02-14,66.56,73.0200000000001
1776,63298193,2023-01-31,0.0,259.55
7743,63298193,2023-02-08,1360.9,1620.45
7742,63298193,2023-02-08,1374.1,2994.55
7744,63298193,2023-02-11,45.02,3039.57
7745,63298193,2023-02-12,1111.4,4150.97
1777,63301094,2023-01-31,0.0,532.03
4325,63301094,2023-02-03,-159.23,372.79999999999995
5754,63301094,2023-02-04,25.82,398.62
5755,63301094,2023-02-06,1204.5,1603.12
4326,63301094,2023-02-07,-93.91,1509.21
4327,63301094,2023-02-10,-5.2,1504.0099999999998
5756,63301094,2023-02-10,116.53,1620.54
4328,63301094,2023-02-11,-130.33,1490.2099999999998
1778,63381038,2023-01-31,0.0,541.91
7777,63381038,2023-02-08,69.06,610.97
7778,63381038,2023-02-13,151.93,762.9
1779,63405199,2023-01-31,0.0,18.35
7316,63405199,2023-02-07,-229.29,-210.94
7315,63405199,2023-02-07,-178.2,-389.14
7642,63405199,2023-02-07,102.26,-286.87999999999994
7643,63405199,2023-02-09,226.54,-60.339999999999996
7644,63405199,2023-02-11,75.1,14.759999999999998
7318,63405199,2023-02-14,-71.12,-56.36000000000001
7317,63405199,2023-02-14,-18.62,-74.98000000000002
1780,63412767,2023-01-31,0.0,715.41
4046,63412767,2023-02-03,-153.0,562.41
4045,63412767,2023-02-03,-87.36,475.04999999999995
4044,63412767,2023-02-03,-18.62,456.42999999999995
4048,63412767,2023-02-05,-146.21,310.21999999999997
4047,63412767,2023-02-05,-53.81,256.40999999999997
6598,63412767,2023-02-05,62.56,318.96999999999997
6599,63412767,2023-02-09,128.5,447.46999999999997
6600,63412767,2023-02-11,54.29,501.76
4049,63412767,2023-02-13,-99.37,402.39
1781,63486424,2023-01-31,0.0,531.83
5958,63486424,2023-02-04,-0.23,531.6
6298,63486424,2023-02-05,167.77,699.3700000000001
6299,63486424,2023-02-07,92.8,792.1700000000001
5959,63486424,2023-02-10,-55.17,737.0
5960,63486424,2023-02-12,-1224.6,-487.5999999999998
1782,63534397,2023-01-31,0.0,451.25
4657,63534397,2023-02-03,-590.1,-138.85000000000002
7184,63534397,2023-02-06,109.59,-29.25999999999999
7185,63534397,2023-02-07,87.03,57.76999999999998
4658,63534397,2023-02-11,-873.9,-816.1300000000001
1783,63556863,2023-01-31,0.0,634.4
707,63556863,2023-02-01,-0.5,633.9
708,63556863,2023-02-02,-102.25,531.65
3941,63556863,2023-02-03,130.91,662.56
709,63556863,2023-02-05,-125.17,537.39
710,63556863,2023-02-06,-104.85,432.53999999999996
3942,63556863,2023-02-06,1124.1,1556.6399999999999
3943,63556863,2023-02-08,1127.4,2684.04
3945,63556863,2023-02-09,60.16,2744.2
3944,63556863,2023-02-09,83.38,2827.58
711,63556863,2023-02-11,-213.76,2613.8199999999997
1784,63569270,2023-01-31,0.0,949.8
7578,63569270,2023-02-07,-120.5,829.3
8218,63569270,2023-02-10,30.02,859.3199999999999
7579,63569270,2023-02-11,-1231.3,-371.98
1785,63635633,2023-01-31,0.0,202.35
7273,63635633,2023-02-07,123.36,325.71
7274,63635633,2023-02-09,109.51,435.22
8260,63635633,2023-02-10,-60.41,374.81
8261,63635633,2023-02-13,-74.51,300.3
1786,63714888,2023-01-31,0.0,632.75
1250,63714888,2023-02-01,77.55,710.3
5572,63714888,2023-02-04,-523.6,186.7
5571,63714888,2023-02-04,-109.43,77.26999999999998
1251,63714888,2023-02-11,174.19,251.45999999999998
5573,63714888,2023-02-12,-1143.7,-892.24
5574,63714888,2023-02-12,-207.81,-1100.05
1252,63714888,2023-02-13,44.57,-1055.48
5575,63714888,2023-02-14,-80.39,-1135.87
1787,63746530,2023-01-31,0.0,874.63
6584,63746530,2023-02-05,986.7,1861.33
7027,63746530,2023-02-06,-57.25,1804.08
6585,63746530,2023-02-07,764.7,2568.78
7028,63746530,2023-02-09,-116.81,2451.9700000000003
6586,63746530,2023-02-09,1705.6,4157.57
7029,63746530,2023-02-12,-151.29,4006.28
6587,63746530,2023-02-12,94.08,4100.36
6588,63746530,2023-02-14,150.33,4250.69
1788,63845700,2023-01-31,0.0,856.95
3645,63845700,2023-02-02,-184.44,672.51
3646,63845700,2023-02-04,-168.29,504.22
3647,63845700,2023-02-06,-59.16,445.06000000000006
7996,63845700,2023-02-09,1606.6,2051.66
7997,63845700,2023-02-11,126.05,2177.71
7998,63845700,2023-02-12,75.56,2253.27
1789,63863096,2023-01-31,0.0,819.23
6025,63863096,2023-02-05,-148.09,671.14
6026,63863096,2023-02-08,-72.17,598.97
7848,63863096,2023-02-08,167.77,766.74
1790,63959769,2023-01-31,0.0,938.58
3713,63959769,2023-02-03,112.46,1051.04
7911,63959769,2023-02-08,-147.81,903.23
3714,63959769,2023-02-09,48.6,951.83
3715,63959769,2023-02-10,54.78,1006.61
7912,63959769,2023-02-12,-541.9,464.71000000000004
1791,63977699,2023-01-31,0.0,140.44
7749,63977699,2023-02-08,-156.53,-16.090000000000003
7750,63977699,2023-02-10,-60.14,-76.23000000000002
8490,63977699,2023-02-11,90.03,13.799999999999997
8491,63977699,2023-02-11,207.88,221.68
1792,64034275,2023-01-31,0.0,609.61
1238,64034275,2023-02-01,-71.89,537.72
1237,64034275,2023-02-01,-55.09,482.63
1424,64034275,2023-02-01,42.27,524.9
1239,64034275,2023-02-10,-84.47,440.43
1426,64034275,2023-02-11,99.93,540.36
1425,64034275,2023-02-11,135.48,675.84
1428,64034275,2023-02-12,66.35,742.19
1427,64034275,2023-02-12,69.44,811.63
1793,64065043,2023-01-31,0.0,245.44
6832,64065043,2023-02-06,67.45,312.89
6831,64065043,2023-02-06,78.47,391.36
6833,64065043,2023-02-10,95.62,486.98
6835,64065043,2023-02-13,47.82,534.8
6834,64065043,2023-02-13,1619.8,2154.6
1794,64093529,2023-01-31,0.0,748.57
2820,64093529,2023-02-02,131.15,879.72
2821,64093529,2023-02-03,151.73,1031.45
2822,64093529,2023-02-08,155.62,1187.0700000000002
2823,64093529,2023-02-10,93.29,1280.3600000000001
1795,64108699,2023-01-31,0.0,71.97
3228,64108699,2023-02-02,-190.87,-118.9
3227,64108699,2023-02-02,-50.83,-169.73
3229,64108699,2023-02-07,-116.74,-286.47
3230,64108699,2023-02-08,-83.5,-369.97
7871,64108699,2023-02-08,120.11,-249.85999999999999
3231,64108699,2023-02-09,-34.17,-284.03
3232,64108699,2023-02-10,-202.69,-486.72
7872,64108699,2023-02-10,111.68,-375.03999999999996
7873,64108699,2023-02-14,241.71,-133.32999999999998
1796,64123632,2023-01-31,0.0,358.39
3864,64123632,2023-02-03,131.87,490.26
3865,64123632,2023-02-06,54.05,544.31
3867,64123632,2023-02-07,24.34,568.65
3866,64123632,2023-02-07,993.9,1562.5499999999997
8346,64123632,2023-02-10,-193.16,1369.3899999999999
3868,64123632,2023-02-12,85.39,1454.7799999999997
1797,64160490,2023-01-31,0.0,222.89
3596,64160490,2023-02-02,115.12,338.01
3958,64160490,2023-02-03,-228.59,109.41999999999999
3597,64160490,2023-02-03,146.33,255.75
3959,64160490,2023-02-05,-62.88,192.87
3960,64160490,2023-02-09,-74.87,118.0
3598,64160490,2023-02-10,11.9,129.9
3599,64160490,2023-02-12,18.96,148.86
3961,64160490,2023-02-13,-162.92,-14.060000000000002
3962,64160490,2023-02-13,-133.53,-147.58999999999997
3963,64160490,2023-02-14,-122.9,-270.49
3601,64160490,2023-02-14,85.5,-184.99
3600,64160490,2023-02-14,173.88,-11.109999999999985
1798,64167315,2023-01-31,0.0,145.11
6469,64167315,2023-02-05,69.19,214.3
6470,64167315,2023-02-06,99.27,313.57
6471,64167315,2023-02-13,59.69,373.26
8658,64167315,2023-02-14,-165.55,207.70999999999998
1799,64168292,2023-01-31,0.0,297.09
4725,64168292,2023-02-03,-129.36,167.72999999999996
3889,64168292,2023-02-03,111.84,279.56999999999994
3890,64168292,2023-02-04,101.49,381.05999999999995
4726,64168292,2023-02-06,-59.58,321.47999999999996
4727,64168292,2023-02-08,-164.35,157.12999999999997
3891,64168292,2023-02-08,132.61,289.74
4728,64168292,2023-02-10,-182.87,106.86999999999998
3892,64168292,2023-02-10,25.17,132.03999999999996
3893,64168292,2023-02-13,169.97,302.01
3894,64168292,2023-02-14,1323.7,1625.71
1800,64177019,2023-01-31,0.0,298.31
5095,64177019,2023-02-04,-76.94,221.37
5096,64177019,2023-02-05,-17.88,203.49
5097,64177019,2023-02-06,-89.28,114.21000000000001
8074,64177019,2023-02-09,101.53,215.74
5098,64177019,2023-02-10,-101.58,114.16000000000003
8075,64177019,2023-02-10,116.06,230.22000000000003
1801,64226824,2023-01-31,0.0,794.79
6410,64226824,2023-02-05,-112.69,682.0999999999999
6411,64226824,2023-02-11,-104.89,577.21
1802,64228624,2023-01-31,0.0,508.14
2361,64228624,2023-02-02,-150.88,357.26
5444,64228624,2023-02-04,126.18,483.44
5445,64228624,2023-02-05,110.97,594.41
2362,64228624,2023-02-09,-85.88,508.53
2363,64228624,2023-02-10,-110.41,398.12
5446,64228624,2023-02-10,93.74,491.86
5447,64228624,2023-02-12,1153.9,1645.7600000000002
1803,64237458,2023-01-31,0.0,255.48
2125,64237458,2023-02-01,-75.62,179.85999999999999
2126,64237458,2023-02-02,-55.08,124.78
6180,64237458,2023-02-05,103.17,227.95
6181,64237458,2023-02-05,1295.5,1523.45
2127,64237458,2023-02-06,-178.82,1344.63
6182,64237458,2023-02-06,55.36,1399.99
2128,64237458,2023-02-09,-158.77,1241.22
2129,64237458,2023-02-10,-672.0,569.22
6183,64237458,2023-02-10,59.81,629.03
6184,64237458,2023-02-11,2.2,631.23
2130,64237458,2023-02-12,-69.4,561.83
6185,64237458,2023-02-12,133.51,695.34
6186,64237458,2023-02-14,105.98,801.32
1804,64299012,2023-01-31,0.0,509.56
893,64299012,2023-02-01,128.83,638.39
894,64299012,2023-02-05,90.59,728.98
7113,64299012,2023-02-06,-47.53,681.45
895,64299012,2023-02-08,129.37,810.8199999999999
7114,64299012,2023-02-10,-20.93,789.8900000000001
7115,64299012,2023-02-12,-114.77,675.12
7116,64299012,2023-02-14,-2620.1,-1944.98
896,64299012,2023-02-14,146.71,-1798.27
1805,64300289,2023-01-31,0.0,472.59
3361,64300289,2023-02-02,-118.23,354.35999999999996
6392,64300289,2023-02-05,29.05,383.40999999999997
3362,64300289,2023-02-06,-78.61,304.79999999999995
6393,64300289,2023-02-09,168.03,472.83
3363,64300289,2023-02-10,-108.85,363.98
3364,64300289,2023-02-12,-73.94,290.03999999999996
3365,64300289,2023-02-12,-66.55,223.49
1806,64303157,2023-01-31,0.0,698.38
2044,64303157,2023-02-01,-9.32,689.06
2045,64303157,2023-02-06,-128.12,560.94
7448,64303157,2023-02-07,96.55,657.49
7449,64303157,2023-02-08,1737.4,2394.89
1807,64305805,2023-01-31,0.0,181.46
1687,64305805,2023-02-01,126.64,308.1
5886,64305805,2023-02-04,-1649.2,-1341.1
5887,64305805,2023-02-05,-100.57,-1441.6699999999998
5888,64305805,2023-02-07,-153.3,-1594.9699999999998
1688,64305805,2023-02-11,102.91,-1492.06
5889,64305805,2023-02-13,-73.97,-1566.03
1808,64331821,2023-01-31,0.0,519.62
6142,64331821,2023-02-05,-145.08,374.53999999999996
7536,64331821,2023-02-07,16.72,391.26
7537,64331821,2023-02-09,897.0,1288.26
6143,64331821,2023-02-11,-148.32,1139.94
6144,64331821,2023-02-11,-104.39,1035.55
7538,64331821,2023-02-14,479.9,1515.4499999999998
1809,64402841,2023-01-31,0.0,751.76
1219,64402841,2023-02-01,-61.08,690.68
6374,64402841,2023-02-05,109.7,800.38
1220,64402841,2023-02-07,-133.09,667.29
6375,64402841,2023-02-11,93.58,760.87
1221,64402841,2023-02-12,-1411.1,-650.23
6376,64402841,2023-02-13,52.19,-598.04
1810,64411319,2023-01-31,0.0,619.06
7086,64411319,2023-02-06,128.12,747.18
7768,64411319,2023-02-08,-128.28,618.9
7769,64411319,2023-02-10,-58.75,560.15
7087,64411319,2023-02-11,96.47,656.6199999999999
7088,64411319,2023-02-11,124.56,781.18
1811,64460080,2023-01-31,0.0,313.37
1687,64460080,2023-02-01,-85.99,227.38
1688,64460080,2023-02-02,-61.09,166.29000000000002
1689,64460080,2023-02-03,-156.41,9.879999999999995
1690,64460080,2023-02-03,-119.02,-109.13999999999999
8296,64460080,2023-02-10,191.56,82.42000000000002
1812,64462046,2023-01-31,0.0,847.04
7442,64462046,2023-02-07,-1392.7,-545.6600000000001
7443,64462046,2023-02-10,-715.5,-1261.1599999999999
8295,64462046,2023-02-10,83.79,-1177.3700000000001
1813,64486954,2023-01-31,0.0,378.0
6323,64486954,2023-02-05,-1685.4,-1307.4
6314,64486954,2023-02-05,57.18,-1250.22
6324,64486954,2023-02-08,-117.41,-1367.63
6325,64486954,2023-02-11,-1454.9,-2822.53
1814,64526097,2023-01-31,0.0,491.42
3319,64526097,2023-02-02,61.97,553.39
3320,64526097,2023-02-03,140.51,693.9
3321,64526097,2023-02-04,46.96,740.86
8289,64526097,2023-02-10,-67.56,673.3
3322,64526097,2023-02-11,138.99,812.29
3323,64526097,2023-02-12,28.57,840.86
3324,64526097,2023-02-13,157.41,998.27
1815,64533535,2023-01-31,0.0,535.88
4139,64533535,2023-02-03,-108.5,427.38
4140,64533535,2023-02-07,-162.23,265.15
4141,64533535,2023-02-09,-26.26,238.89
8398,64533535,2023-02-11,59.16,298.05
8399,64533535,2023-02-13,77.95,376.0
1816,64571970,2023-01-31,0.0,693.34
5190,64571970,2023-02-04,809.4,1502.74
7510,64571970,2023-02-07,-148.81,1353.9299999999998
7512,64571970,2023-02-07,-135.14,1218.79
7511,64571970,2023-02-07,-57.59,1161.2
7513,64571970,2023-02-08,-71.81,1089.3899999999999
7514,64571970,2023-02-09,-18.36,1071.03
1817,64590882,2023-01-31,0.0,344.01
4640,64590882,2023-02-03,-1505.1,-1161.09
4641,64590882,2023-02-05,-144.77,-1305.86
6634,64590882,2023-02-05,71.17,-1234.6899999999998
6635,64590882,2023-02-07,146.17,-1088.52
4642,64590882,2023-02-14,-140.07,-1228.59
4643,64590882,2023-02-14,-54.0,-1282.59
6636,64590882,2023-02-14,75.01,-1207.58
1818,64610632,2023-01-31,0.0,869.95
5004,64610632,2023-02-04,-35.39,834.5600000000001
6503,64610632,2023-02-05,858.4,1692.96
5005,64610632,2023-02-07,-147.04,1545.92
6504,64610632,2023-02-09,46.29,1592.21
5007,64610632,2023-02-13,-199.57,1392.64
5006,64610632,2023-02-13,-183.43,1209.21
1819,64683004,2023-01-31,0.0,348.86
1878,64683004,2023-02-01,614.1,962.96
1880,64683004,2023-02-04,3.48,966.44
1879,64683004,2023-02-04,303.4,1269.8400000000001
6015,64683004,2023-02-05,-183.09,1086.75
6016,64683004,2023-02-08,-106.98,979.77
1881,64683004,2023-02-08,2017.7,2997.4700000000003
1882,64683004,2023-02-09,1658.0,4655.469999999999
1883,64683004,2023-02-11,101.75,4757.219999999999
6017,64683004,2023-02-13,-188.62,4568.599999999999
6018,64683004,2023-02-14,-26.02,4542.58
1884,64683004,2023-02-14,107.71,4650.29
1885,64683004,2023-02-14,147.85,4798.139999999999
1820,64716185,2023-01-31,0.0,391.53
3540,64716185,2023-02-02,80.3,471.83
7182,64716185,2023-02-06,-54.21,417.61999999999995
3541,64716185,2023-02-07,1255.9,1673.52
7183,64716185,2023-02-08,-89.88,1583.64
7184,64716185,2023-02-13,-153.4,1430.24
3542,64716185,2023-02-14,7.26,1437.5
1821,64769583,2023-01-31,0.0,598.67
3489,64769583,2023-02-02,-115.98,482.68999999999994
5707,64769583,2023-02-04,1705.8,2188.49
5708,64769583,2023-02-07,115.83,2304.3199999999997
3490,64769583,2023-02-12,-129.84,2174.48
1822,64893719,2023-01-31,0.0,689.59
4784,64893719,2023-02-03,64.85,754.44
5494,64893719,2023-02-04,-91.88,662.5600000000001
4785,64893719,2023-02-07,126.74,789.3000000000001
4786,64893719,2023-02-08,41.56,830.86
5495,64893719,2023-02-10,-119.83,711.03
5496,64893719,2023-02-10,-83.89,627.14
1823,64901797,2023-01-31,0.0,672.29
7197,64901797,2023-02-06,73.11,745.4
7289,64901797,2023-02-07,-94.93,650.4699999999999
7290,64901797,2023-02-10,-154.39,496.08
7198,64901797,2023-02-14,70.4,566.48
1824,64953936,2023-01-31,0.0,311.46
6497,64953936,2023-02-05,226.81,538.27
7756,64953936,2023-02-08,-34.12,504.15
6498,64953936,2023-02-11,148.4,652.55
7757,64953936,2023-02-13,-710.9,-58.349999999999966
1825,64958880,2023-01-31,0.0,840.8
2045,64958880,2023-02-01,64.89,905.6899999999999
5813,64958880,2023-02-04,-54.34,851.3499999999999
2046,64958880,2023-02-04,87.56,938.91
5814,64958880,2023-02-07,-156.28,782.63
2047,64958880,2023-02-09,142.61,925.24
2048,64958880,2023-02-10,50.54,975.78
1826,64979248,2023-01-31,0.0,202.63
3281,64979248,2023-02-02,-168.67,33.96000000000001
6571,64979248,2023-02-05,46.87,80.83000000000001
6572,64979248,2023-02-10,15.31,96.14
6573,64979248,2023-02-12,622.0,718.14
6574,64979248,2023-02-13,136.67,854.81
3282,64979248,2023-02-14,-44.4,810.41
1827,64990799,2023-01-31,0.0,480.33
3618,64990799,2023-02-02,-102.4,377.92999999999995
3619,64990799,2023-02-03,-62.98,314.95
3620,64990799,2023-02-10,-67.2,247.74999999999997
3621,64990799,2023-02-12,-966.7,-718.95
3622,64990799,2023-02-12,-52.16,-771.1100000000001
8589,64990799,2023-02-12,272.8,-498.3100000000001
1828,65009032,2023-01-31,0.0,984.64
4041,65009032,2023-02-03,220.14,1204.78
5181,65009032,2023-02-04,-128.21,1076.57
5182,65009032,2023-02-06,-140.67,935.9
4042,65009032,2023-02-09,95.74,1031.6399999999999
4043,65009032,2023-02-09,143.28,1174.92
4044,65009032,2023-02-10,93.37,1268.29
4045,65009032,2023-02-10,99.74,1368.03
4046,65009032,2023-02-14,97.59,1465.62
1829,65033625,2023-01-31,0.0,186.26
1678,65033625,2023-02-01,80.88,267.14
1679,65033625,2023-02-01,117.4,384.53999999999996
1680,65033625,2023-02-05,104.89,489.43
6909,65033625,2023-02-06,-107.96,381.47
1830,65052411,2023-01-31,0.0,877.5
6645,65052411,2023-02-05,-80.22,797.28
7173,65052411,2023-02-06,177.63,974.91
7174,65052411,2023-02-10,48.54,1023.45
7175,65052411,2023-02-11,159.34,1182.79
7176,65052411,2023-02-12,463.1,1645.8899999999999
7177,65052411,2023-02-14,169.73,1815.62
1831,65097827,2023-01-31,0.0,526.75
3511,65097827,2023-02-02,-133.34,393.40999999999997
3512,65097827,2023-02-03,-64.91,328.5
3513,65097827,2023-02-04,-27.43,301.07
6493,65097827,2023-02-05,109.24,410.31
6494,65097827,2023-02-06,738.2,1148.51
6496,65097827,2023-02-09,93.18,1241.69
6495,65097827,2023-02-09,102.14,1343.83
1832,65125795,2023-01-31,0.0,632.35
2575,65125795,2023-02-02,15.19,647.5400000000001
2576,65125795,2023-02-08,38.13,685.6700000000001
8676,65125795,2023-02-14,-66.29,619.38
1833,65143384,2023-01-31,0.0,227.08
5632,65143384,2023-02-04,8.85,235.93
5633,65143384,2023-02-04,117.79,353.72
6778,65143384,2023-02-06,-122.9,230.82
6780,65143384,2023-02-07,-1516.3,-1285.48
6781,65143384,2023-02-07,-119.45,-1404.93
6779,65143384,2023-02-07,-109.89,-1514.82
5634,65143384,2023-02-09,139.36,-1375.46
6782,65143384,2023-02-11,-67.21,-1442.67
6783,65143384,2023-02-12,-45.77,-1488.44
1834,65159654,2023-01-31,0.0,761.19
6417,65159654,2023-02-05,-148.44,612.75
6418,65159654,2023-02-08,-123.43,489.32000000000005
8325,65159654,2023-02-10,113.36,602.6800000000001
6419,65159654,2023-02-12,-221.72,380.96000000000004
6420,65159654,2023-02-14,-665.3,-284.3399999999999
8326,65159654,2023-02-14,37.21,-247.12999999999988
1835,65199307,2023-01-31,0.0,68.09
255,65199307,2023-02-01,142.91,211.0
254,65199307,2023-02-01,161.85,372.85
256,65199307,2023-02-02,1097.6,1470.4499999999998
257,65199307,2023-02-06,89.47,1559.9199999999998
8323,65199307,2023-02-10,-58.45,1501.4699999999998
258,65199307,2023-02-12,96.4,1597.87
259,65199307,2023-02-13,63.47,1661.34
1836,65200379,2023-01-31,0.0,4.27
4406,65200379,2023-02-03,37.15,41.42
5824,65200379,2023-02-04,-68.44,-27.02
4407,65200379,2023-02-05,66.67,39.650000000000006
5825,65200379,2023-02-06,-101.4,-61.750000000000014
5826,65200379,2023-02-08,-116.58,-178.33
5827,65200379,2023-02-10,-83.52,-261.85
4408,65200379,2023-02-10,158.38,-103.47000000000001
4409,65200379,2023-02-10,193.12,89.64999999999999
5828,65200379,2023-02-11,-171.55,-81.90000000000002
5829,65200379,2023-02-12,-1682.4,-1764.3000000000002
5830,65200379,2023-02-12,-66.35,-1830.65
1837,65220738,2023-01-31,0.0,873.56
215,65220738,2023-02-01,-89.8,783.76
216,65220738,2023-02-03,-1121.6,-337.8399999999999
5585,65220738,2023-02-04,158.98,-178.8599999999999
217,65220738,2023-02-05,-1533.5,-1712.3600000000001
5586,65220738,2023-02-06,633.0,-1079.36
218,65220738,2023-02-11,-663.1,-1742.46
1838,65225040,2023-01-31,0.0,826.42
6509,65225040,2023-02-05,-102.18,724.24
6657,65225040,2023-02-06,106.0,830.24
6658,65225040,2023-02-06,146.22,976.4599999999999
6659,65225040,2023-02-09,188.3,1164.76
6510,65225040,2023-02-10,-55.08,1109.6799999999998
1839,65280102,2023-01-31,0.0,2.17
6944,65280102,2023-02-06,-5.35,-3.1799999999999997
6870,65280102,2023-02-06,131.6,128.42
6945,65280102,2023-02-11,-134.09,-5.6700000000000035
6871,65280102,2023-02-11,203.67,197.99999999999997
6873,65280102,2023-02-14,126.17,324.17
6872,65280102,2023-02-14,701.1,1025.27
1840,65321237,2023-01-31,0.0,425.42
4772,65321237,2023-02-03,616.4,1041.82
5896,65321237,2023-02-04,-35.68,1006.1400000000001
4773,65321237,2023-02-05,148.44,1154.58
4774,65321237,2023-02-08,107.42,1262.0
4775,65321237,2023-02-11,1293.9,2555.9
4776,65321237,2023-02-12,100.61,2656.51
1841,65380590,2023-01-31,0.0,683.96
2580,65380590,2023-02-02,-31.96,652.0
5908,65380590,2023-02-05,70.44,722.44
5909,65380590,2023-02-07,73.26,795.7
2581,65380590,2023-02-12,-123.38,672.32
5910,65380590,2023-02-14,18.54,690.86
1842,65429379,2023-01-31,0.0,232.83
75,65429379,2023-02-01,54.5,287.33000000000004
76,65429379,2023-02-01,78.22,365.55
7566,65429379,2023-02-07,-155.73,209.82000000000002
7567,65429379,2023-02-09,-133.43,76.39000000000001
78,65429379,2023-02-09,24.12,100.51000000000002
77,65429379,2023-02-09,118.21,218.72000000000003
79,65429379,2023-02-10,60.14,278.86
80,65429379,2023-02-13,133.53,412.39
1843,65534206,2023-01-31,0.0,274.89
1044,65534206,2023-02-01,-173.01,101.88
1284,65534206,2023-02-01,62.95,164.82999999999998
1285,65534206,2023-02-04,35.8,200.63
1045,65534206,2023-02-09,-124.56,76.07
1286,65534206,2023-02-13,40.95,117.01999999999998
1287,65534206,2023-02-14,133.43,250.45
1844,65579734,2023-01-31,0.0,928.08
7634,65579734,2023-02-07,97.26,1025.3400000000001
8367,65579734,2023-02-10,-123.19,902.1500000000001
7636,65579734,2023-02-10,134.33,1036.48
7635,65579734,2023-02-10,163.3,1199.7800000000002
7637,65579734,2023-02-11,130.27,1330.0500000000002
8368,65579734,2023-02-12,-156.13,1173.92
8369,65579734,2023-02-13,-115.9,1058.02
7638,65579734,2023-02-13,1085.6,2143.62
1845,65583532,2023-01-31,0.0,542.09
4329,65583532,2023-02-03,-80.54,461.55
5181,65583532,2023-02-04,57.41,518.96
5182,65583532,2023-02-05,209.45,728.4100000000001
4330,65583532,2023-02-09,-196.47,531.94
5183,65583532,2023-02-09,107.84,639.78
1846,65589565,2023-01-31,0.0,321.99
7394,65589565,2023-02-07,-93.93,228.06
7395,65589565,2023-02-07,-84.83,143.23000000000002
7396,65589565,2023-02-12,-1761.1,-1617.87
1847,65596186,2023-01-31,0.0,254.28
4616,65596186,2023-02-03,98.67,352.95
5205,65596186,2023-02-04,-111.74,241.21
5206,65596186,2023-02-06,-121.72,119.49000000000001
5207,65596186,2023-02-14,-37.22,82.27000000000001
1848,65603779,2023-01-31,0.0,652.83
1922,65603779,2023-02-01,-121.46,531.37
1924,65603779,2023-02-02,-599.3,-67.92999999999995
1923,65603779,2023-02-02,-108.49,-176.41999999999996
2979,65603779,2023-02-02,1145.1,968.68
2980,65603779,2023-02-14,201.83,1170.51
1849,65606472,2023-01-31,0.0,405.1
8565,65606472,2023-02-12,-65.91,339.19000000000005
8566,65606472,2023-02-14,-302.9,36.29000000000008
8567,65606472,2023-02-14,-142.57,-106.27999999999992
1850,65721172,2023-01-31,0.0,221.49
5117,65721172,2023-02-04,-155.79,65.70000000000002
5118,65721172,2023-02-05,-190.77,-125.07
5119,65721172,2023-02-05,-66.67,-191.74
5120,65721172,2023-02-07,-57.31,-249.05
5121,65721172,2023-02-09,-154.04,-403.0899999999999
5122,65721172,2023-02-13,-39.15,-442.24
1851,65724980,2023-01-31,0.0,307.93
976,65724980,2023-02-01,66.43,374.36
6803,65724980,2023-02-06,-155.01,219.35000000000002
6804,65724980,2023-02-06,-133.2,86.15000000000003
977,65724980,2023-02-06,1138.4,1224.5500000000002
6805,65724980,2023-02-07,-134.59,1089.96
6806,65724980,2023-02-08,-157.28,932.6800000000001
6807,65724980,2023-02-12,-1.29,931.3900000000001
1852,65754176,2023-01-31,0.0,716.55
1189,65754176,2023-02-01,174.19,890.74
4348,65754176,2023-02-03,-218.15,672.5899999999999
4349,65754176,2023-02-09,-1045.1,-372.51
4350,65754176,2023-02-10,-106.77,-479.28
1190,65754176,2023-02-12,180.46,-298.81999999999994
4351,65754176,2023-02-13,-105.95,-404.77
1853,65782923,2023-01-31,0.0,193.43
6524,65782923,2023-02-05,118.02,311.45
7001,65782923,2023-02-06,-38.61,272.84000000000003
7002,65782923,2023-02-10,-148.09,124.75
6525,65782923,2023-02-11,70.39,195.14
7003,65782923,2023-02-14,-87.88,107.26
1854,65804470,2023-01-31,0.0,454.38
2590,65804470,2023-02-02,-129.45,324.93
4903,65804470,2023-02-03,220.83,545.76
4904,65804470,2023-02-08,117.35,663.11
2591,65804470,2023-02-11,-90.36,572.75
4905,65804470,2023-02-11,167.02,739.77
4906,65804470,2023-02-13,62.13,801.9000000000001
4907,65804470,2023-02-14,61.34,863.24
1855,65815967,2023-01-31,0.0,0.43
4857,65815967,2023-02-03,84.7,85.13000000000001
7475,65815967,2023-02-07,-149.99,-64.86
4858,65815967,2023-02-07,43.28,-21.580000000000005
4860,65815967,2023-02-09,63.99,42.41
4859,65815967,2023-02-09,110.14,152.55
1856,65926576,2023-01-31,0.0,73.48
2816,65926576,2023-02-02,97.47,170.95
2817,65926576,2023-02-10,82.23,253.18
2818,65926576,2023-02-12,158.57,411.75
2819,65926576,2023-02-13,110.4,522.15
8672,65926576,2023-02-14,-143.6,378.55
1857,65988118,2023-01-31,0.0,647.81
2613,65988118,2023-02-02,56.84,704.65
7788,65988118,2023-02-08,-14.01,690.64
7789,65988118,2023-02-10,-117.56,573.0799999999999
2614,65988118,2023-02-10,55.13,628.2099999999999
2615,65988118,2023-02-11,108.59,736.8
2616,65988118,2023-02-12,157.46,894.26
1858,66008535,2023-01-31,0.0,398.99
1974,66008535,2023-02-01,63.11,462.1
1975,66008535,2023-02-08,105.76,567.86
1859,66022888,2023-01-31,0.0,757.14
713,66022888,2023-02-01,57.37,814.51
3021,66022888,2023-02-02,-24.05,790.46
3022,66022888,2023-02-03,-91.37,699.0899999999999
3023,66022888,2023-02-03,-50.38,648.71
714,66022888,2023-02-03,98.38,747.0899999999999
715,66022888,2023-02-07,126.32,873.41
3024,66022888,2023-02-08,-159.05,714.3599999999999
716,66022888,2023-02-09,63.95,778.31
717,66022888,2023-02-14,81.21,859.52
1860,66044567,2023-01-31,0.0,596.13
2856,66044567,2023-02-02,183.83,779.96
2857,66044567,2023-02-03,11.36,791.3199999999999
2858,66044567,2023-02-05,159.59,950.9100000000001
2859,66044567,2023-02-12,95.14,1046.05
1861,66152145,2023-01-31,0.0,83.45
2318,66152145,2023-02-02,150.88,234.32999999999998
4721,66152145,2023-02-03,-616.4,-382.07
2319,66152145,2023-02-03,55.63,-326.44
4722,66152145,2023-02-05,-83.4,-409.84
4723,66152145,2023-02-07,-1760.8,-2170.6400000000003
2320,66152145,2023-02-08,59.97,-2110.67
4724,66152145,2023-02-09,-73.42,-2184.09
2321,66152145,2023-02-14,107.51,-2076.58
2322,66152145,2023-02-14,685.5,-1391.08
1862,66168472,2023-01-31,0.0,29.89
4239,66168472,2023-02-03,-196.95,-167.06
4240,66168472,2023-02-03,-79.25,-246.31
4952,66168472,2023-02-03,221.11,-25.199999999999974
4953,66168472,2023-02-05,98.07,72.87000000000002
4954,66168472,2023-02-09,20.18,93.05000000000001
4955,66168472,2023-02-09,96.2,189.25
4241,66168472,2023-02-12,-88.2,101.05000000000003
1863,66175264,2023-01-31,0.0,765.91
7099,66175264,2023-02-06,123.31,889.22
7100,66175264,2023-02-09,74.87,964.0899999999999
7101,66175264,2023-02-10,1134.6,2098.69
7102,66175264,2023-02-12,67.31,2166.0
8640,66175264,2023-02-13,-161.21,2004.79
7103,66175264,2023-02-14,117.68,2122.47
1864,66187843,2023-01-31,0.0,535.34
350,66187843,2023-02-01,-112.17,423.17
4462,66187843,2023-02-03,163.12,586.2900000000001
1865,66239954,2023-01-31,0.0,181.14
2920,66239954,2023-02-02,93.88,275.02
2921,66239954,2023-02-03,267.7,542.72
2922,66239954,2023-02-05,83.4,626.12
7416,66239954,2023-02-07,-140.1,486.02
7418,66239954,2023-02-12,-57.42,428.59999999999997
7417,66239954,2023-02-12,-48.67,379.92999999999995
7419,66239954,2023-02-14,-1478.2,-1098.27
2924,66239954,2023-02-14,80.39,-1017.88
2923,66239954,2023-02-14,130.84,-887.0400000000001
1866,66257438,2023-01-31,0.0,818.57
339,66257438,2023-02-01,78.4,896.97
340,66257438,2023-02-04,84.59,981.5600000000001
6450,66257438,2023-02-05,-28.46,953.1
6451,66257438,2023-02-07,-6.03,947.07
341,66257438,2023-02-09,71.12,1018.19
6452,66257438,2023-02-12,-108.0,910.19
342,66257438,2023-02-12,1799.2,2709.3900000000003
1867,66283493,2023-01-31,0.0,612.88
7123,66283493,2023-02-06,49.21,662.09
7124,66283493,2023-02-07,1370.6,2032.69
1868,66332583,2023-01-31,0.0,241.29
6681,66332583,2023-02-05,-184.86,56.42999999999998
6682,66332583,2023-02-06,-83.89,-27.460000000000008
7550,66332583,2023-02-07,151.7,124.23999999999998
6683,66332583,2023-02-09,-121.13,3.109999999999985
6684,66332583,2023-02-12,-198.39,-195.28
6685,66332583,2023-02-12,-128.81,-324.09000000000003
1869,66341438,2023-01-31,0.0,685.06
6019,66341438,2023-02-05,-1625.6,-940.54
7133,66341438,2023-02-06,113.63,-826.9099999999999
6020,66341438,2023-02-13,-1013.4,-1840.31
6021,66341438,2023-02-13,-81.39,-1921.6999999999998
1870,66390683,2023-01-31,0.0,52.77
553,66390683,2023-02-01,-104.47,-51.699999999999996
554,66390683,2023-02-03,-103.29,-154.98999999999998
555,66390683,2023-02-05,-165.42,-320.41
6198,66390683,2023-02-05,83.99,-236.42
6199,66390683,2023-02-09,90.79,-145.63
556,66390683,2023-02-11,-77.62,-223.24999999999997
557,66390683,2023-02-13,-157.55,-380.80000000000007
559,66390683,2023-02-14,-146.71,-527.51
558,66390683,2023-02-14,-133.19,-660.7
6200,66390683,2023-02-14,65.5,-595.2
1871,66416254,2023-01-31,0.0,166.4
4207,66416254,2023-02-03,-159.42,6.980000000000018
4208,66416254,2023-02-03,-63.29,-56.309999999999974
4206,66416254,2023-02-03,-38.14,-94.44999999999996
4336,66416254,2023-02-03,131.54,37.09
4209,66416254,2023-02-04,-93.96,-56.869999999999976
4210,66416254,2023-02-05,-159.34,-216.21
4337,66416254,2023-02-05,812.6,596.39
4338,66416254,2023-02-06,1095.4,1691.7900000000002
4211,66416254,2023-02-10,-68.78,1623.0100000000002
4339,66416254,2023-02-10,174.77,1797.7800000000002
4340,66416254,2023-02-11,142.67,1940.4500000000003
4212,66416254,2023-02-12,-89.64,1850.8100000000002
4341,66416254,2023-02-13,837.4,2688.21
1872,66445304,2023-01-31,0.0,153.78
1616,66445304,2023-02-01,174.0,327.78
6403,66445304,2023-02-05,-108.92,218.86
1617,66445304,2023-02-05,184.78,403.64
6404,66445304,2023-02-08,-94.29,309.35
1873,66449974,2023-01-31,0.0,795.59
5965,66449974,2023-02-05,65.31,860.9000000000001
5966,66449974,2023-02-11,102.91,963.8100000000001
8554,66449974,2023-02-12,-1265.1,-301.28999999999985
8555,66449974,2023-02-12,-80.44,-381.7299999999999
1874,66504443,2023-01-31,0.0,618.97
2344,66504443,2023-02-02,-217.51,401.46000000000004
2345,66504443,2023-02-05,-45.47,355.99
2346,66504443,2023-02-12,-127.6,228.39000000000004
1875,66521788,2023-01-31,0.0,201.43
274,66521788,2023-02-01,-127.41,74.02000000000001
275,66521788,2023-02-05,-73.78,0.2400000000000091
6070,66521788,2023-02-05,90.66,90.9
276,66521788,2023-02-13,-67.31,23.590000000000003
1876,66556141,2023-01-31,0.0,688.37
6215,66556141,2023-02-05,-33.96,654.41
7309,66556141,2023-02-07,45.83,700.24
7310,66556141,2023-02-10,206.97,907.21
6216,66556141,2023-02-13,-96.51,810.7
1877,66586860,2023-01-31,0.0,938.51
1950,66586860,2023-02-01,1072.7,2011.21
6838,66586860,2023-02-06,-143.42,1867.79
6839,66586860,2023-02-07,-106.1,1761.69
6840,66586860,2023-02-08,-145.66,1616.0300000000002
1951,66586860,2023-02-10,116.33,1732.3600000000001
6842,66586860,2023-02-11,-148.74,1583.6200000000001
6841,66586860,2023-02-11,-86.77,1496.85
6843,66586860,2023-02-12,-1764.4,-267.54999999999995
6844,66586860,2023-02-13,-56.41,-323.96000000000004
1878,66601462,2023-01-31,0.0,361.46
8496,66601462,2023-02-11,62.18,423.64
8601,66601462,2023-02-13,-115.86,307.78
1879,66624477,2023-01-31,0.0,521.98
8321,66624477,2023-02-10,-1271.5,-749.52
8322,66624477,2023-02-13,-70.58,-820.0999999999999
1880,66667727,2023-01-31,0.0,431.31
1876,66667727,2023-02-01,145.77,577.08
5741,66667727,2023-02-04,-201.15,375.93
1877,66667727,2023-02-04,146.82,522.75
5742,66667727,2023-02-05,-104.58,418.17
5743,66667727,2023-02-06,-106.31,311.86
1881,66681692,2023-01-31,0.0,712.12
4413,66681692,2023-02-03,-102.01,610.11
3978,66681692,2023-02-03,644.3,1254.4099999999999
3979,66681692,2023-02-09,1246.4,2500.81
3980,66681692,2023-02-11,99.6,2600.41
4414,66681692,2023-02-14,-150.42,2449.9900000000002
1882,66700123,2023-01-31,0.0,175.15
1529,66700123,2023-02-01,-106.46,68.69000000000001
1530,66700123,2023-02-02,-1180.2,-1111.51
1531,66700123,2023-02-08,-39.85,-1151.36
8489,66700123,2023-02-11,125.31,-1026.05
1532,66700123,2023-02-12,-62.68,-1088.73
1883,66704269,2023-01-31,0.0,915.51
4390,66704269,2023-02-03,110.38,1025.8899999999999
4392,66704269,2023-02-04,64.92,1090.81
4391,66704269,2023-02-04,124.72,1215.53
4393,66704269,2023-02-05,159.34,1374.87
7281,66704269,2023-02-07,-10.31,1364.56
7282,66704269,2023-02-08,-157.04,1207.52
4394,66704269,2023-02-11,94.59,1302.1100000000001
7283,66704269,2023-02-12,-124.55,1177.56
4396,66704269,2023-02-14,87.55,1265.1100000000001
4395,66704269,2023-02-14,658.2,1923.31
1884,66706067,2023-01-31,0.0,1.98
2942,66706067,2023-02-02,-233.36,-231.38000000000002
5104,66706067,2023-02-04,111.13,-120.25000000000001
2943,66706067,2023-02-07,-180.28,-300.53
2944,66706067,2023-02-08,-1006.9,-1307.4299999999998
2945,66706067,2023-02-08,-12.95,-1320.3799999999999
2946,66706067,2023-02-10,-140.57,-1460.9499999999998
5106,66706067,2023-02-10,96.87,-1364.08
5105,66706067,2023-02-10,1202.5,-161.57999999999996
2947,66706067,2023-02-11,-52.74,-214.31999999999996
5107,66706067,2023-02-12,166.9,-47.41999999999995
1885,66729131,2023-01-31,0.0,100.8
5419,66729131,2023-02-04,-146.89,-46.08999999999999
5417,66729131,2023-02-04,-95.6,-141.69
5418,66729131,2023-02-04,-24.31,-165.99999999999994
6087,66729131,2023-02-05,87.07,-78.92999999999999
1886,66896515,2023-01-31,0.0,842.82
5779,66896515,2023-02-04,535.8,1378.62
6584,66896515,2023-02-05,-190.01,1188.6100000000001
6585,66896515,2023-02-05,-104.2,1084.41
5780,66896515,2023-02-05,91.73,1176.1399999999999
5781,66896515,2023-02-09,101.53,1277.67
6586,66896515,2023-02-11,-99.6,1178.0700000000002
5782,66896515,2023-02-11,222.05,1400.12
1887,66914990,2023-01-31,0.0,764.75
818,66914990,2023-02-01,-98.33,666.42
6640,66914990,2023-02-05,137.98,804.4
819,66914990,2023-02-09,-125.11,679.29
820,66914990,2023-02-13,-229.21,450.08
821,66914990,2023-02-14,-133.67,316.40999999999997
6641,66914990,2023-02-14,65.19,381.6
1888,66930564,2023-01-31,0.0,398.03
3583,66930564,2023-02-02,-83.72,314.30999999999995
3584,66930564,2023-02-05,-174.96,139.34999999999997
6929,66930564,2023-02-06,115.81,255.15999999999997
3585,66930564,2023-02-11,-96.9,158.25999999999996
6930,66930564,2023-02-13,114.54,272.79999999999995
1889,66954664,2023-01-31,0.0,620.1
5064,66954664,2023-02-04,-57.49,562.61
5249,66954664,2023-02-04,49.52,612.13
5065,66954664,2023-02-05,-202.11,410.02
5066,66954664,2023-02-08,-62.89,347.13
5067,66954664,2023-02-12,-153.75,193.38
5068,66954664,2023-02-13,-48.57,144.81
5069,66954664,2023-02-14,-781.5,-636.6899999999999
1890,67029298,2023-01-31,0.0,255.53
232,67029298,2023-02-01,-60.58,194.95
233,67029298,2023-02-02,-90.07,104.88000000000002
2155,67029298,2023-02-02,28.3,133.18
2154,67029298,2023-02-02,68.12,201.3
2153,67029298,2023-02-02,786.6,987.9
2156,67029298,2023-02-07,21.61,1009.51
234,67029298,2023-02-08,-107.83,901.68
235,67029298,2023-02-14,-93.35,808.3299999999999
1891,67056187,2023-01-31,0.0,392.51
3200,67056187,2023-02-02,-101.39,291.12
3201,67056187,2023-02-08,-92.86,198.26
3202,67056187,2023-02-09,-163.99,34.26999999999998
3203,67056187,2023-02-11,-1370.2,-1335.93
3205,67056187,2023-02-14,-106.34,-1442.27
3204,67056187,2023-02-14,-47.83,-1490.1000000000001
1892,67090449,2023-01-31,0.0,724.35
5964,67090449,2023-02-04,-31.07,693.28
5966,67090449,2023-02-07,-788.3,-95.01999999999998
5965,67090449,2023-02-07,-84.46,-179.48000000000002
5967,67090449,2023-02-09,-143.28,-322.7600000000001
5968,67090449,2023-02-10,-59.66,-382.41999999999996
8362,67090449,2023-02-10,103.55,-278.87
8363,67090449,2023-02-11,62.9,-215.97000000000003
5969,67090449,2023-02-14,-1145.9,-1361.8700000000003
8364,67090449,2023-02-14,72.94,-1288.9300000000003
1893,67102224,2023-01-31,0.0,852.71
1031,67102224,2023-02-01,103.68,956.3900000000001
4480,67102224,2023-02-03,-107.3,849.09
1894,67104073,2023-01-31,0.0,476.04
3764,67104073,2023-02-03,46.54,522.58
7521,67104073,2023-02-07,-184.95,337.63
7522,67104073,2023-02-13,-69.73,267.90000000000003
1895,67147649,2023-01-31,0.0,3.28
2217,67147649,2023-02-02,1499.9,1503.18
4412,67147649,2023-02-03,-121.77,1381.41
2218,67147649,2023-02-05,106.43,1487.8400000000001
2219,67147649,2023-02-08,27.23,1515.0700000000002
2220,67147649,2023-02-10,72.61,1587.68
2221,67147649,2023-02-14,98.34,1686.02
1896,67153119,2023-01-31,0.0,454.81
922,67153119,2023-02-01,-99.45,355.36
1997,67153119,2023-02-01,117.6,472.96
1998,67153119,2023-02-02,190.87,663.8299999999999
1999,67153119,2023-02-03,8.49,672.3199999999999
923,67153119,2023-02-08,-53.25,619.0699999999999
2000,67153119,2023-02-12,91.62,710.69
924,67153119,2023-02-14,-171.69,539.0
1897,67157564,2023-01-31,0.0,562.42
1116,67157564,2023-02-01,1153.0,1715.42
1117,67157564,2023-02-02,74.82,1790.2399999999998
1118,67157564,2023-02-03,89.03,1879.27
5586,67157564,2023-02-04,-160.12,1719.15
5587,67157564,2023-02-08,-122.19,1596.96
5589,67157564,2023-02-10,-72.18,1524.78
5588,67157564,2023-02-10,-58.74,1466.04
1119,67157564,2023-02-12,71.93,1537.9699999999998
1898,67190209,2023-01-31,0.0,567.61
1552,67190209,2023-02-01,74.4,642.01
1899,67270354,2023-01-31,0.0,805.28
5565,67270354,2023-02-04,-130.37,674.91
5566,67270354,2023-02-05,-139.91,535.0
8217,67270354,2023-02-10,1124.9,1659.9
5567,67270354,2023-02-12,-68.07,1591.8300000000002
1900,67283010,2023-01-31,0.0,872.4
3183,67283010,2023-02-02,72.58,944.98
3184,67283010,2023-02-04,126.98,1071.96
3185,67283010,2023-02-05,143.73,1215.69
7861,67283010,2023-02-08,-7.94,1207.75
7862,67283010,2023-02-11,-75.12,1132.63
1901,67392638,2023-01-31,0.0,519.61
5510,67392638,2023-02-04,905.4,1425.01
6356,67392638,2023-02-05,-95.35,1329.6599999999999
5511,67392638,2023-02-05,184.06,1513.72
6357,67392638,2023-02-06,-93.75,1419.97
1902,67400117,2023-01-31,0.0,769.45
2506,67400117,2023-02-02,-114.44,655.01
4078,67400117,2023-02-03,158.72,813.73
2507,67400117,2023-02-10,-130.32,683.4100000000001
4079,67400117,2023-02-10,121.7,805.11
2508,67400117,2023-02-14,-658.2,146.90999999999997
1903,67434874,2023-01-31,0.0,399.94
2695,67434874,2023-02-02,108.49,508.43
2696,67434874,2023-02-03,94.57,603.0
2697,67434874,2023-02-04,72.83,675.8299999999999
2698,67434874,2023-02-05,80.66,756.49
7324,67434874,2023-02-07,-123.67,632.8199999999999
2699,67434874,2023-02-09,110.11,742.9300000000001
7325,67434874,2023-02-11,-88.2,654.73
7326,67434874,2023-02-12,-85.9,568.8299999999999
1904,67464890,2023-01-31,0.0,81.27
8607,67464890,2023-02-13,-565.6,-484.33000000000004
8608,67464890,2023-02-14,-114.72,-599.0500000000001
1905,67466632,2023-01-31,0.0,350.06
2057,67466632,2023-02-01,126.75,476.81
6639,67466632,2023-02-05,-1317.7,-840.8900000000001
2059,67466632,2023-02-06,48.43,-792.46
2058,67466632,2023-02-06,179.1,-613.3600000000001
2060,67466632,2023-02-09,144.14,-469.2200000000001
6640,67466632,2023-02-11,-196.49,-665.71
2061,67466632,2023-02-11,83.01,-582.7
6641,67466632,2023-02-13,-66.5,-649.2
6642,67466632,2023-02-14,-147.38,-796.5800000000002
1906,67489489,2023-01-31,0.0,219.39
1476,67489489,2023-02-01,-118.62,100.76999999999998
5229,67489489,2023-02-04,68.1,168.86999999999998
5228,67489489,2023-02-04,88.31,257.17999999999995
5230,67489489,2023-02-06,91.86,349.03999999999996
5231,67489489,2023-02-06,112.02,461.05999999999995
1477,67489489,2023-02-09,-264.6,196.45999999999995
1478,67489489,2023-02-09,-7.44,189.01999999999995
5232,67489489,2023-02-14,85.38,274.4
1907,67490657,2023-01-31,0.0,588.58
5438,67490657,2023-02-04,-158.56,430.02000000000004
5439,67490657,2023-02-05,-18.89,411.13000000000005
5440,67490657,2023-02-06,-146.96,264.17
7926,67490657,2023-02-08,59.4,323.57
7927,67490657,2023-02-10,123.76,447.33000000000004
5441,67490657,2023-02-11,-954.4,-507.07000000000005
5442,67490657,2023-02-12,-850.1,-1357.17
7928,67490657,2023-02-14,99.88,-1257.29
1908,67502738,2023-01-31,0.0,185.72
7909,67502738,2023-02-08,170.5,356.22
8377,67502738,2023-02-10,-104.93,251.29
8378,67502738,2023-02-12,-84.83,166.45999999999998
1909,67532228,2023-01-31,0.0,805.91
4669,67532228,2023-02-03,936.3,1742.21
5568,67532228,2023-02-04,-163.15,1579.06
5569,67532228,2023-02-05,-139.34,1439.7199999999998
4670,67532228,2023-02-05,117.8,1557.52
4671,67532228,2023-02-07,153.27,1710.79
5570,67532228,2023-02-10,-92.13,1618.6599999999999
1910,67541253,2023-01-31,0.0,985.49
3697,67541253,2023-02-02,-555.5,429.99
6071,67541253,2023-02-05,81.2,511.19
3698,67541253,2023-02-09,-38.71,472.48
6072,67541253,2023-02-10,139.35,611.83
1911,67561762,2023-01-31,0.0,469.23
1327,67561762,2023-02-01,170.35,639.58
5876,67561762,2023-02-04,-192.0,447.58000000000004
5877,67561762,2023-02-07,-52.55,395.03000000000003
5878,67561762,2023-02-09,-140.61,254.42000000000002
5879,67561762,2023-02-11,-1136.3,-881.8799999999999
1328,67561762,2023-02-14,114.68,-767.1999999999998
1912,67571676,2023-01-31,0.0,491.88
8161,67571676,2023-02-09,-7.96,483.92
7999,67571676,2023-02-09,151.22,635.14
8162,67571676,2023-02-10,-11.9,623.24
8163,67571676,2023-02-14,-85.15,538.0899999999999
1913,67635951,2023-01-31,0.0,692.02
1020,67635951,2023-02-01,77.61,769.63
1021,67635951,2023-02-01,167.46,937.0899999999999
4993,67635951,2023-02-04,-174.55,762.54
4994,67635951,2023-02-04,-109.45,653.09
1022,67635951,2023-02-04,133.61,786.7
4995,67635951,2023-02-08,-258.6,528.0999999999999
4996,67635951,2023-02-08,-89.09,439.01
1023,67635951,2023-02-08,174.24,613.25
1914,67674594,2023-01-31,0.0,126.16
410,67674594,2023-02-01,61.16,187.32
7304,67674594,2023-02-07,-169.03,18.289999999999992
7305,67674594,2023-02-08,-135.45,-117.16
411,67674594,2023-02-08,153.92,36.75999999999999
7306,67674594,2023-02-09,-56.53,-19.77000000000001
412,67674594,2023-02-11,151.65,131.88
7307,67674594,2023-02-12,-76.15,55.72999999999999
1915,67679622,2023-01-31,0.0,631.03
630,67679622,2023-02-01,142.37,773.4
7690,67679622,2023-02-08,-93.74,679.66
7691,67679622,2023-02-08,-54.11,625.55
631,67679622,2023-02-09,813.0,1438.55
7693,67679622,2023-02-10,-190.89,1247.6599999999999
7692,67679622,2023-02-10,-111.68,1135.98
7694,67679622,2023-02-12,-163.83,972.15
1916,67716893,2023-01-31,0.0,250.99
3586,67716893,2023-02-02,93.16,344.15
3587,67716893,2023-02-05,69.16,413.31
7332,67716893,2023-02-07,-1500.0,-1086.69
7331,67716893,2023-02-07,-126.45,-1213.14
7334,67716893,2023-02-08,-73.68,-1286.8200000000002
7333,67716893,2023-02-08,-10.18,-1297.0
3588,67716893,2023-02-09,166.7,-1130.3
1917,67805276,2023-01-31,0.0,431.12
7836,67805276,2023-02-08,88.85,519.97
8063,67805276,2023-02-09,-182.8,337.16999999999996
7837,67805276,2023-02-09,79.05,416.21999999999997
7838,67805276,2023-02-10,103.06,519.28
7839,67805276,2023-02-11,104.82,624.0999999999999
8064,67805276,2023-02-14,-10.57,613.53
1918,67837998,2023-01-31,0.0,246.4
2517,67837998,2023-02-02,154.06,400.46000000000004
5513,67837998,2023-02-04,-87.56,312.9
2518,67837998,2023-02-05,63.7,376.6
2519,67837998,2023-02-10,682.2,1058.8000000000002
1919,67862200,2023-01-31,0.0,944.49
5893,67862200,2023-02-04,-121.95,822.54
5894,67862200,2023-02-06,-7.07,815.47
8059,67862200,2023-02-09,1131.6,1947.07
8060,67862200,2023-02-11,1655.3,3602.37
5895,67862200,2023-02-12,-860.8,2741.5699999999997
1920,67902154,2023-01-31,0.0,669.79
389,67902154,2023-02-01,-546.3,123.49000000000001
388,67902154,2023-02-01,-86.21,37.27999999999997
1959,67902154,2023-02-01,65.61,102.88999999999999
390,67902154,2023-02-03,-58.81,44.08000000000004
391,67902154,2023-02-03,-3.24,40.84000000000003
1960,67902154,2023-02-04,126.83,167.67000000000002
392,67902154,2023-02-06,-85.9,81.76999999999998
1961,67902154,2023-02-06,188.27,270.04
1962,67902154,2023-02-08,118.58,388.62
1963,67902154,2023-02-12,158.11,546.73
393,67902154,2023-02-14,-1100.7,-553.97
394,67902154,2023-02-14,-91.53,-645.5
1921,67909830,2023-01-31,0.0,589.68
4989,67909830,2023-02-03,-118.95,470.72999999999996
4099,67909830,2023-02-03,168.82,639.55
4990,67909830,2023-02-06,-157.94,481.60999999999996
4100,67909830,2023-02-07,86.52,568.1299999999999
4101,67909830,2023-02-11,170.72,738.8499999999999
1922,67911201,2023-01-31,0.0,762.17
1107,67911201,2023-02-01,65.26,827.43
5669,67911201,2023-02-04,-120.19,707.24
5670,67911201,2023-02-09,-1558.7,-851.4600000000002
1108,67911201,2023-02-10,170.08,-681.3800000000002
5672,67911201,2023-02-11,-107.06,-788.4400000000002
5671,67911201,2023-02-11,-52.48,-840.9200000000002
1923,67911677,2023-01-31,0.0,725.9
5380,67911677,2023-02-04,149.2,875.0999999999999
8132,67911677,2023-02-09,-73.05,802.05
1924,67938929,2023-01-31,0.0,868.04
1327,67938929,2023-02-01,-125.38,742.66
1328,67938929,2023-02-03,-61.92,680.74
3922,67938929,2023-02-03,110.43,791.17
3923,67938929,2023-02-06,122.9,914.0699999999999
1329,67938929,2023-02-09,-135.47,778.6
3924,67938929,2023-02-09,158.5,937.1
1330,67938929,2023-02-10,-20.05,917.05
3926,67938929,2023-02-10,58.74,975.79
3925,67938929,2023-02-10,90.78,1066.57
1331,67938929,2023-02-11,-73.62,992.9499999999999
3927,67938929,2023-02-13,121.3,1114.25
1925,67961706,2023-01-31,0.0,569.5
6116,67961706,2023-02-05,95.84,665.34
6117,67961706,2023-02-09,182.8,848.14
6118,67961706,2023-02-11,832.5,1680.6399999999999
8538,67961706,2023-02-12,-98.2,1582.44
6119,67961706,2023-02-14,104.45,1686.8899999999999
1926,67987326,2023-01-31,0.0,161.67
814,67987326,2023-02-01,-151.18,10.48999999999998
7237,67987326,2023-02-06,175.36,185.85
815,67987326,2023-02-07,-138.63,47.22
7238,67987326,2023-02-10,83.95,131.17000000000002
7239,67987326,2023-02-12,224.14,355.30999999999995
1927,68051701,2023-01-31,0.0,911.6
4156,68051701,2023-02-03,-774.8,136.80000000000007
4155,68051701,2023-02-03,-197.64,-60.83999999999992
4157,68051701,2023-02-04,-34.22,-95.05999999999995
8513,68051701,2023-02-11,89.5,-5.559999999999945
8514,68051701,2023-02-12,128.28,122.72000000000014
4158,68051701,2023-02-13,-184.92,-62.19999999999993
1928,68104946,2023-01-31,0.0,925.71
7820,68104946,2023-02-08,109.29,1035.0
1929,68153614,2023-01-31,0.0,927.95
2118,68153614,2023-02-02,118.22,1046.17
8329,68153614,2023-02-10,-170.08,876.09
8330,68153614,2023-02-11,-659.5,216.59000000000003
8331,68153614,2023-02-13,-99.78,116.81000000000006
1930,68189902,2023-01-31,0.0,448.56
3643,68189902,2023-02-02,-61.7,386.86
3644,68189902,2023-02-05,-153.59,233.26999999999998
6581,68189902,2023-02-05,125.05,358.32
6582,68189902,2023-02-06,145.42,503.74
6583,68189902,2023-02-07,101.79,605.53
1931,68198696,2023-01-31,0.0,979.46
6294,68198696,2023-02-05,27.36,1006.82
6295,68198696,2023-02-07,159.97,1166.79
7927,68198696,2023-02-08,-96.45,1070.3400000000001
7929,68198696,2023-02-09,-60.16,1010.1800000000001
7928,68198696,2023-02-09,-37.14,973.0400000000001
6296,68198696,2023-02-09,56.02,1029.06
7930,68198696,2023-02-11,-16.59,1012.47
6297,68198696,2023-02-12,1149.0,2161.4700000000003
1932,68239576,2023-01-31,0.0,64.42
843,68239576,2023-02-01,21.82,86.24000000000001
845,68239576,2023-02-01,94.97,181.20999999999998
844,68239576,2023-02-01,121.83,303.04
846,68239576,2023-02-05,100.33,403.37
8080,68239576,2023-02-09,-129.19,274.18
847,68239576,2023-02-09,85.04,359.22
1933,68262083,2023-01-31,0.0,899.79
5528,68262083,2023-02-04,-141.71,758.0799999999999
5529,68262083,2023-02-11,-57.11,700.97
8674,68262083,2023-02-14,120.31,821.28
1934,68275028,2023-01-31,0.0,918.44
1473,68275028,2023-02-01,-120.92,797.5200000000001
3975,68275028,2023-02-03,106.67,904.19
1474,68275028,2023-02-04,-35.52,868.6700000000001
3976,68275028,2023-02-07,192.3,1060.97
3977,68275028,2023-02-07,1002.5,2063.4700000000003
1475,68275028,2023-02-09,-107.22,1956.25
1935,68294036,2023-01-31,0.0,184.64
3020,68294036,2023-02-02,119.55,304.19
6900,68294036,2023-02-06,-50.84,253.34999999999997
3021,68294036,2023-02-06,67.41,320.76
6902,68294036,2023-02-08,-162.49,158.26999999999998
6901,68294036,2023-02-08,-157.52,0.7499999999999716
3022,68294036,2023-02-09,411.3,412.04999999999995
3023,68294036,2023-02-10,165.63,577.68
1936,68294645,2023-01-31,0.0,306.18
879,68294645,2023-02-01,33.51,339.69
880,68294645,2023-02-02,83.72,423.40999999999997
881,68294645,2023-02-06,126.54,549.95
8556,68294645,2023-02-12,-72.46,477.49
1937,68311266,2023-01-31,0.0,87.08
1399,68311266,2023-02-01,-239.72,-152.64
3736,68311266,2023-02-03,130.74,-21.89999999999999
3737,68311266,2023-02-05,139.91,118.01
3738,68311266,2023-02-06,1253.1,1371.11
3739,68311266,2023-02-10,114.74,1485.85
1400,68311266,2023-02-12,-96.87,1388.9799999999998
3740,68311266,2023-02-14,27.68,1416.6599999999999
3741,68311266,2023-02-14,108.48,1525.1399999999999
1938,68315462,2023-01-31,0.0,769.16
1542,68315462,2023-02-01,152.29,921.4499999999999
1543,68315462,2023-02-02,118.55,1040.0
1544,68315462,2023-02-03,198.29,1238.29
6009,68315462,2023-02-05,-19.27,1219.02
6010,68315462,2023-02-05,-10.32,1208.7
1545,68315462,2023-02-09,1410.1,2618.7999999999997
6011,68315462,2023-02-10,-74.29,2544.5099999999998
1546,68315462,2023-02-10,63.58,2608.0899999999997
1547,68315462,2023-02-10,104.86,2712.95
6012,68315462,2023-02-13,-40.65,2672.2999999999997
1939,68346907,2023-01-31,0.0,752.88
359,68346907,2023-02-01,-844.6,-91.72000000000003
6617,68346907,2023-02-05,74.21,-17.50999999999999
360,68346907,2023-02-06,-100.09,-117.60000000000002
361,68346907,2023-02-07,-129.86,-247.46000000000004
6618,68346907,2023-02-08,43.89,-203.57000000000005
362,68346907,2023-02-09,-78.9,-282.47000000000014
363,68346907,2023-02-12,-841.7,-1124.17
6619,68346907,2023-02-13,92.64,-1031.5300000000002
1940,68393439,2023-01-31,0.0,783.05
497,68393439,2023-02-01,137.75,920.8
3163,68393439,2023-02-02,-174.74,746.06
498,68393439,2023-02-05,104.42,850.4799999999999
499,68393439,2023-02-09,115.06,965.54
3164,68393439,2023-02-10,-130.57,834.97
3165,68393439,2023-02-12,-67.66,767.31
500,68393439,2023-02-12,40.07,807.38
3167,68393439,2023-02-13,-152.83,654.55
3168,68393439,2023-02-13,-125.61,528.9399999999999
3166,68393439,2023-02-13,-72.65,456.28999999999996
1941,68423238,2023-01-31,0.0,972.94
6603,68423238,2023-02-05,80.22,1053.16
8416,68423238,2023-02-11,-107.4,945.76
6605,68423238,2023-02-12,84.4,1030.16
6604,68423238,2023-02-12,128.4,1158.56
6606,68423238,2023-02-13,175.32,1333.88
1942,68483071,2023-01-31,0.0,25.88
5935,68483071,2023-02-04,-2122.7,-2096.8199999999997
5936,68483071,2023-02-05,-1580.8,-3677.62
7507,68483071,2023-02-07,166.87,-3510.7499999999995
1943,68484031,2023-01-31,0.0,853.99
2813,68484031,2023-02-02,52.86,906.85
6465,68484031,2023-02-05,-1463.6,-556.75
2814,68484031,2023-02-05,18.89,-537.8599999999999
6466,68484031,2023-02-11,-26.87,-564.73
2815,68484031,2023-02-11,1672.7,1107.97
1944,68552857,2023-01-31,0.0,309.92
3344,68552857,2023-02-02,-106.6,203.32000000000002
3307,68552857,2023-02-02,156.04,359.36
3345,68552857,2023-02-08,-68.6,290.76
1945,68552994,2023-01-31,0.0,516.25
1264,68552994,2023-02-01,-62.95,453.3
1265,68552994,2023-02-08,-1608.4,-1155.1000000000001
1266,68552994,2023-02-09,-88.81,-1243.91
8673,68552994,2023-02-14,781.5,-462.4100000000001
1946,68558850,2023-01-31,0.0,281.5
1754,68558850,2023-02-01,80.81,362.31
1755,68558850,2023-02-04,1395.3,1757.61
6766,68558850,2023-02-06,-182.96,1574.6499999999999
6767,68558850,2023-02-07,-111.95,1462.6999999999998
6768,68558850,2023-02-10,-70.74,1391.9599999999998
6769,68558850,2023-02-12,-69.85,1322.11
1947,68579203,2023-01-31,0.0,149.39
1948,68680764,2023-01-31,0.0,200.27
4562,68680764,2023-02-03,886.6,1086.8700000000001
8049,68680764,2023-02-09,-81.22,1005.65
1949,68683403,2023-01-31,0.0,674.5
5903,68683403,2023-02-05,63.32,737.82
5904,68683403,2023-02-13,535.9,1273.72
1950,68689742,2023-01-31,0.0,45.41
7424,68689742,2023-02-07,56.42,101.83
7425,68689742,2023-02-07,121.67,223.5
8675,68689742,2023-02-14,-123.36,100.14
1951,68708795,2023-01-31,0.0,399.11
3987,68708795,2023-02-03,-102.85,296.26
3988,68708795,2023-02-04,-255.0,41.25999999999999
3989,68708795,2023-02-04,-140.43,-99.16999999999996
3990,68708795,2023-02-05,-109.76,-208.92999999999995
3991,68708795,2023-02-07,-115.4,-324.33000000000004
3992,68708795,2023-02-08,-134.23,-458.56000000000006
3993,68708795,2023-02-09,-49.06,-507.62
3994,68708795,2023-02-10,-138.8,-646.42
3995,68708795,2023-02-14,-1297.2,-1943.62
1952,68721707,2023-01-31,0.0,900.45
4519,68721707,2023-02-03,113.78,1014.23
4520,68721707,2023-02-09,69.99,1084.22
8290,68721707,2023-02-10,-113.56,970.6600000000001
1953,68775529,2023-01-31,0.0,531.87
4292,68775529,2023-02-03,1266.7,1798.5700000000002
7302,68775529,2023-02-07,-113.79,1684.7800000000002
7303,68775529,2023-02-08,-48.01,1636.77
4294,68775529,2023-02-09,124.1,1760.87
4293,68775529,2023-02-09,512.3,2273.17
4295,68775529,2023-02-10,129.33,2402.5
4296,68775529,2023-02-11,60.41,2462.91
4297,68775529,2023-02-12,178.37,2641.2799999999997
1954,68786878,2023-01-31,0.0,512.06
4941,68786878,2023-02-03,44.25,556.31
4942,68786878,2023-02-12,66.27,622.5799999999999
4943,68786878,2023-02-12,79.12,701.6999999999999
8657,68786878,2023-02-14,-58.68,643.02
1955,68793483,2023-01-31,0.0,581.36
2597,68793483,2023-02-02,-983.3,-401.93999999999994
4432,68793483,2023-02-03,119.95,-281.9899999999999
4433,68793483,2023-02-03,185.02,-96.96999999999991
2598,68793483,2023-02-08,-110.48,-207.44999999999993
4434,68793483,2023-02-08,68.31,-139.13999999999987
2599,68793483,2023-02-09,-123.28,-262.41999999999996
4435,68793483,2023-02-09,140.49,-121.92999999999995
4436,68793483,2023-02-10,116.54,-5.389999999999873
2600,68793483,2023-02-11,-626.6,-631.9899999999999
4437,68793483,2023-02-13,99.13,-532.8599999999998
2601,68793483,2023-02-14,-131.83,-664.6899999999999
2602,68793483,2023-02-14,-59.81,-724.4999999999999
4438,68793483,2023-02-14,130.44,-594.0599999999998
1956,68798691,2023-01-31,0.0,819.33
1980,68798691,2023-02-01,-112.52,706.8100000000001
1981,68798691,2023-02-04,-7.74,699.07
1982,68798691,2023-02-05,-124.83,574.24
7305,68798691,2023-02-07,53.14,627.3800000000001
7306,68798691,2023-02-07,123.45,750.83
1983,68798691,2023-02-11,-36.07,714.76
1984,68798691,2023-02-11,-33.64,681.1200000000001
1985,68798691,2023-02-12,-147.45,533.6700000000001
1986,68798691,2023-02-14,-56.66,477.0100000000001
7307,68798691,2023-02-14,47.84,524.8500000000001
7308,68798691,2023-02-14,71.41,596.2600000000001
1957,68800062,2023-01-31,0.0,749.65
5698,68800062,2023-02-04,-668.8,80.85000000000002
5734,68800062,2023-02-04,165.76,246.61
5699,68800062,2023-02-05,-276.4,-29.789999999999964
5735,68800062,2023-02-05,149.41,119.62
5700,68800062,2023-02-06,-73.11,46.50999999999999
5701,68800062,2023-02-08,-116.37,-69.86000000000001
5736,68800062,2023-02-08,164.35,94.49000000000001
5737,68800062,2023-02-09,100.36,194.85000000000002
5738,68800062,2023-02-09,109.08,303.93
5739,68800062,2023-02-13,123.49,427.42
1958,68836810,2023-01-31,0.0,171.96
2618,68836810,2023-02-02,-128.3,43.66
5639,68836810,2023-02-04,89.11,132.76999999999998
1959,68891568,2023-01-31,0.0,844.06
2302,68891568,2023-02-02,-58.4,785.66
4367,68891568,2023-02-03,121.82,907.4799999999999
2303,68891568,2023-02-09,-12.23,895.25
2304,68891568,2023-02-13,-77.23,818.02
2305,68891568,2023-02-13,-30.41,787.6099999999999
4368,68891568,2023-02-13,38.13,825.7399999999999
1960,68928221,2023-01-31,0.0,502.06
2896,68928221,2023-02-02,-82.11,419.95
2303,68928221,2023-02-02,236.79,656.74
2897,68928221,2023-02-04,-104.53,552.21
2304,68928221,2023-02-06,171.3,723.51
2305,68928221,2023-02-08,106.98,830.49
2306,68928221,2023-02-09,46.08,876.5699999999999
2898,68928221,2023-02-11,-70.39,806.1800000000001
2307,68928221,2023-02-12,99.99,906.1700000000001
2309,68928221,2023-02-14,63.0,969.1700000000001
2308,68928221,2023-02-14,150.77,1119.94
1961,68962066,2023-01-31,0.0,304.46
3141,68962066,2023-02-02,699.5,1003.96
4659,68962066,2023-02-03,-61.91,942.05
4660,68962066,2023-02-06,-441.4,500.65000000000003
3142,68962066,2023-02-06,197.61,698.26
3143,68962066,2023-02-07,141.05,839.3100000000002
3144,68962066,2023-02-08,220.34,1059.65
4662,68962066,2023-02-09,-125.24,934.4100000000001
4661,68962066,2023-02-09,-103.84,830.5700000000002
4663,68962066,2023-02-12,-45.23,785.3400000000001
4664,68962066,2023-02-12,-36.02,749.32
4665,68962066,2023-02-14,-75.98,673.3400000000001
1962,68973836,2023-01-31,0.0,634.67
1837,68973836,2023-02-01,116.57,751.24
1838,68973836,2023-02-03,955.4,1706.6399999999999
5846,68973836,2023-02-04,-157.26,1549.3799999999999
1840,68973836,2023-02-05,82.33,1631.71
1839,68973836,2023-02-05,115.12,1746.83
5847,68973836,2023-02-10,-62.01,1684.8199999999997
1841,68973836,2023-02-11,1273.1,2957.92
5848,68973836,2023-02-13,-72.81,2885.1099999999997
1963,69008969,2023-01-31,0.0,716.37
3183,69008969,2023-02-02,-128.03,588.34
3184,69008969,2023-02-03,-157.15,431.19
3185,69008969,2023-02-07,-88.5,342.69
7976,69008969,2023-02-09,58.69,401.38
3186,69008969,2023-02-10,-143.62,257.76
3187,69008969,2023-02-11,-60.41,197.35000000000002
7977,69008969,2023-02-14,67.7,265.05
1964,69090518,2023-01-31,0.0,473.87
5157,69090518,2023-02-04,-124.74,349.13
5158,69090518,2023-02-05,-59.47,289.66
7389,69090518,2023-02-07,127.45,417.11
7390,69090518,2023-02-09,99.11,516.22
7391,69090518,2023-02-10,20.05,536.27
5159,69090518,2023-02-13,-157.27,379.0
1965,69118170,2023-01-31,0.0,109.35
1329,69118170,2023-02-01,151.41,260.76
2892,69118170,2023-02-02,-56.3,204.45999999999998
2893,69118170,2023-02-06,-1161.4,-956.9400000000002
1330,69118170,2023-02-07,86.51,-870.4300000000002
1331,69118170,2023-02-08,110.44,-759.9900000000001
2894,69118170,2023-02-10,-180.0,-939.9900000000001
2895,69118170,2023-02-11,-130.27,-1070.2600000000002
1332,69118170,2023-02-14,439.8,-630.4600000000002
1966,69153577,2023-01-31,0.0,402.52
6538,69153577,2023-02-05,-112.45,290.07
7423,69153577,2023-02-07,136.09,426.15999999999997
1967,69302678,2023-01-31,0.0,568.08
6342,69302678,2023-02-05,62.49,630.57
6343,69302678,2023-02-10,86.78,717.35
6344,69302678,2023-02-11,213.76,931.11
6345,69302678,2023-02-12,132.03,1063.14
6346,69302678,2023-02-13,62.72,1125.8600000000001
1968,69306093,2023-01-31,0.0,189.46
6101,69306093,2023-02-05,161.46,350.92
8571,69306093,2023-02-12,-20.96,329.96000000000004
1969,69307050,2023-01-31,0.0,623.84
2254,69307050,2023-02-02,-86.31,537.53
2253,69307050,2023-02-02,-62.13,475.40000000000003
8002,69307050,2023-02-09,49.28,524.6800000000001
8001,69307050,2023-02-09,60.37,585.0500000000001
8003,69307050,2023-02-11,73.66,658.71
8004,69307050,2023-02-12,103.74,762.45
8005,69307050,2023-02-14,122.88,885.33
1970,69315008,2023-01-31,0.0,923.08
1752,69315008,2023-02-01,-72.79,850.2900000000001
1787,69315008,2023-02-01,1052.6,1902.8899999999999
1788,69315008,2023-02-02,180.4,2083.29
1789,69315008,2023-02-05,101.45,2184.74
1753,69315008,2023-02-07,-85.76,2098.98
1754,69315008,2023-02-09,-190.82,1908.1599999999999
1790,69315008,2023-02-12,139.75,2047.9099999999999
1971,69344396,2023-01-31,0.0,304.19
3252,69344396,2023-02-02,1190.9,1495.0900000000001
3253,69344396,2023-02-03,97.42,1592.5100000000002
6555,69344396,2023-02-05,-138.9,1453.6100000000001
3254,69344396,2023-02-06,840.3,2293.91
3255,69344396,2023-02-10,87.07,2380.98
3257,69344396,2023-02-11,78.29,2459.27
3256,69344396,2023-02-11,160.29,2619.56
6556,69344396,2023-02-12,-44.88,2574.68
3259,69344396,2023-02-12,118.77,2693.4500000000003
3258,69344396,2023-02-12,210.36,2903.81
3260,69344396,2023-02-14,98.11,3001.92
1972,69362270,2023-01-31,0.0,410.6
3429,69362270,2023-02-02,-179.0,231.60000000000002
3430,69362270,2023-02-05,-17.25,214.35000000000002
8245,69362270,2023-02-10,26.55,240.90000000000003
8246,69362270,2023-02-11,133.78,374.68000000000006
3431,69362270,2023-02-14,-126.46,248.22000000000003
1973,69446767,2023-01-31,0.0,672.47
3706,69446767,2023-02-02,83.44,755.9100000000001
3707,69446767,2023-02-06,22.45,778.36
3708,69446767,2023-02-07,101.82,880.1800000000001
3709,69446767,2023-02-09,107.86,988.04
8254,69446767,2023-02-10,-137.34,850.7
8255,69446767,2023-02-11,-113.8,736.9
8256,69446767,2023-02-14,-141.48,595.4200000000001
1974,69447534,2023-01-31,0.0,68.02
282,69447534,2023-02-01,-105.36,-37.34
283,69447534,2023-02-03,-121.82,-159.16000000000003
284,69447534,2023-02-11,-68.33,-227.49
8564,69447534,2023-02-12,101.4,-126.08999999999999
285,69447534,2023-02-13,-38.04,-164.13
1975,69468071,2023-01-31,0.0,652.9
5861,69468071,2023-02-04,-81.16,571.74
6272,69468071,2023-02-05,111.92,683.66
5862,69468071,2023-02-06,-67.45,616.21
6274,69468071,2023-02-06,137.34,753.55
6273,69468071,2023-02-06,1791.9,2545.4500000000003
6275,69468071,2023-02-07,69.39,2614.84
6276,69468071,2023-02-08,166.6,2781.44
5863,69468071,2023-02-09,-36.71,2744.7300000000005
5864,69468071,2023-02-12,-16.68,2728.05
6277,69468071,2023-02-13,98.15,2826.2000000000003
1976,69492532,2023-01-31,0.0,581.23
5808,69492532,2023-02-04,-119.25,461.98
5809,69492532,2023-02-11,-84.22,377.76
5810,69492532,2023-02-12,-200.04,177.72000000000003
1977,69533742,2023-01-31,0.0,812.2
434,69533742,2023-02-01,-96.51,715.69
433,69533742,2023-02-01,-12.21,703.48
1465,69533742,2023-02-01,1397.4,2100.88
435,69533742,2023-02-03,-175.55,1925.3300000000002
436,69533742,2023-02-04,-82.56,1842.7700000000002
1466,69533742,2023-02-05,112.73,1955.5
1467,69533742,2023-02-06,129.51,2085.01
437,69533742,2023-02-07,-98.42,1986.5900000000001
438,69533742,2023-02-11,-75.14,1911.45
439,69533742,2023-02-11,-65.15,1846.3000000000002
1978,69540137,2023-01-31,0.0,351.36
2362,69540137,2023-02-02,109.28,460.64
2364,69540137,2023-02-06,51.71,512.35
2363,69540137,2023-02-06,473.7,986.0500000000001
2366,69540137,2023-02-07,141.99,1128.04
2365,69540137,2023-02-07,173.55,1301.5900000000001
2367,69540137,2023-02-11,32.04,1333.63
2368,69540137,2023-02-14,1314.7,2648.3300000000004
1979,69556322,2023-01-31,0.0,785.03
1663,69556322,2023-02-01,102.91,887.9399999999999
1664,69556322,2023-02-02,24.87,912.81
1666,69556322,2023-02-03,66.67,979.48
1665,69556322,2023-02-03,112.15,1091.63
1667,69556322,2023-02-06,68.0,1159.63
8526,69556322,2023-02-12,-125.48,1034.15
8527,69556322,2023-02-13,-62.36,971.79
1669,69556322,2023-02-14,1145.9,2117.69
1668,69556322,2023-02-14,1478.2,3595.8900000000003
1980,69561077,2023-01-31,0.0,318.31
1352,69561077,2023-02-01,125.38,443.69
1353,69561077,2023-02-03,23.5,467.19
1354,69561077,2023-02-04,37.8,504.99
1355,69561077,2023-02-05,1917.1,2422.0899999999997
7908,69561077,2023-02-08,-167.35,2254.7400000000002
7909,69561077,2023-02-09,-56.02,2198.7200000000003
1356,69561077,2023-02-10,75.83,2274.55
7910,69561077,2023-02-11,-104.82,2169.73
1357,69561077,2023-02-11,132.56,2302.29
1358,69561077,2023-02-12,143.91,2446.2
1981,69588947,2023-01-31,0.0,732.72
7965,69588947,2023-02-08,-66.6,666.12
7966,69588947,2023-02-09,-114.45,551.6700000000001
7967,69588947,2023-02-09,-97.55,454.12
7968,69588947,2023-02-10,-8.85,445.27000000000004
1982,69617552,2023-01-31,0.0,853.9
4517,69617552,2023-02-03,-89.23,764.67
4518,69617552,2023-02-06,-96.79,667.88
4519,69617552,2023-02-08,-61.4,606.48
8010,69617552,2023-02-09,108.57,715.05
4520,69617552,2023-02-14,-188.3,526.75
1983,69647833,2023-01-31,0.0,765.74
1265,69647833,2023-02-01,84.44,850.1800000000001
1266,69647833,2023-02-03,54.41,904.59
6829,69647833,2023-02-06,-160.08,744.51
6830,69647833,2023-02-07,-136.97,607.54
1267,69647833,2023-02-07,170.65,778.19
6831,69647833,2023-02-13,-107.16,671.03
1268,69647833,2023-02-13,115.44,786.47
1984,69648759,2023-01-31,0.0,693.39
1288,69648759,2023-02-01,80.92,774.31
8240,69648759,2023-02-10,-155.67,618.64
8241,69648759,2023-02-13,-1503.2,-884.5600000000001
8242,69648759,2023-02-14,-126.03,-1010.59
1289,69648759,2023-02-14,163.34,-847.2500000000001
1985,69664627,2023-01-31,0.0,897.76
428,69664627,2023-02-01,-130.78,766.98
7376,69664627,2023-02-07,218.78,985.76
7377,69664627,2023-02-10,28.25,1014.01
7378,69664627,2023-02-12,1482.9,2496.91
429,69664627,2023-02-13,-163.99,2332.92
1986,69665438,2023-01-31,0.0,417.78
102,69665438,2023-02-01,-158.57,259.21
103,69665438,2023-02-01,-99.56,159.64999999999998
104,69665438,2023-02-05,-75.94,83.70999999999998
1987,69683385,2023-01-31,0.0,519.63
5227,69683385,2023-02-04,54.37,574.0
7291,69683385,2023-02-07,-102.9,471.09999999999997
1988,69730266,2023-01-31,0.0,732.61
5757,69730266,2023-02-04,-95.37,637.24
5758,69730266,2023-02-07,-105.66,531.58
8012,69730266,2023-02-09,102.69,634.27
5759,69730266,2023-02-12,-79.75,554.52
1989,69796371,2023-01-31,0.0,649.23
2765,69796371,2023-02-02,-94.57,554.6600000000001
4068,69796371,2023-02-03,60.17,614.83
4069,69796371,2023-02-04,1412.5,2027.33
4070,69796371,2023-02-05,109.76,2137.09
4071,69796371,2023-02-06,182.28,2319.37
4072,69796371,2023-02-11,166.3,2485.67
4073,69796371,2023-02-14,2002.7,4488.37
1990,69806946,2023-01-31,0.0,971.49
7689,69806946,2023-02-07,87.82,1059.31
7954,69806946,2023-02-08,-183.05,876.26
1991,69939682,2023-01-31,0.0,854.18
1483,69939682,2023-02-01,-120.13,734.05
882,69939682,2023-02-01,94.91,828.9599999999999
1484,69939682,2023-02-08,-5.73,823.2299999999999
1485,69939682,2023-02-09,-143.77,679.4599999999999
1486,69939682,2023-02-11,-214.9,464.55999999999995
1992,70010970,2023-01-31,0.0,114.23
6861,70010970,2023-02-06,-128.7,-14.469999999999985
6862,70010970,2023-02-08,-69.02,-83.48999999999997
6863,70010970,2023-02-11,-181.68,-265.16999999999996
1993,70013367,2023-01-31,0.0,38.86
5739,70013367,2023-02-04,-70.76,-31.900000000000006
6730,70013367,2023-02-06,138.83,106.93
6731,70013367,2023-02-06,660.3,767.23
6732,70013367,2023-02-09,140.35,907.58
5740,70013367,2023-02-13,-96.06,811.52
1994,70034563,2023-01-31,0.0,723.18
1229,70034563,2023-02-01,149.8,872.98
3106,70034563,2023-02-02,-122.42,750.56
1230,70034563,2023-02-04,96.09,846.65
3107,70034563,2023-02-05,-137.98,708.67
3108,70034563,2023-02-13,-182.14,526.53
1995,70049609,2023-01-31,0.0,226.63
7300,70049609,2023-02-07,75.13,301.76
7299,70049609,2023-02-07,89.73,391.49
8238,70049609,2023-02-10,-109.89,281.6
8239,70049609,2023-02-10,-84.17,197.43
7301,70049609,2023-02-13,101.66,299.09
7302,70049609,2023-02-14,103.89,402.98
1996,70123664,2023-01-31,0.0,483.12
2046,70123664,2023-02-01,-122.51,360.61
2047,70123664,2023-02-02,-127.28,233.32999999999998
2048,70123664,2023-02-03,-114.58,118.75
5473,70123664,2023-02-04,24.31,143.06
2049,70123664,2023-02-08,-209.01,-65.94999999999993
1997,70129567,2023-01-31,0.0,886.92
1336,70129567,2023-02-01,52.32,939.24
4594,70129567,2023-02-03,-98.67,840.5699999999999
4595,70129567,2023-02-04,-133.05,707.52
1337,70129567,2023-02-06,100.59,808.1099999999999
4596,70129567,2023-02-08,-149.26,658.8499999999999
1338,70129567,2023-02-09,175.39,834.24
4597,70129567,2023-02-10,-47.22,787.02
1339,70129567,2023-02-10,65.29,852.31
4598,70129567,2023-02-11,-125.65,726.66
1340,70129567,2023-02-11,214.9,941.56
1341,70129567,2023-02-12,35.17,976.7299999999999
1998,70163139,2023-01-31,0.0,674.14
93,70163139,2023-02-01,85.94,760.0799999999999
94,70163139,2023-02-05,116.16,876.24
7070,70163139,2023-02-06,-31.91,844.3299999999999
95,70163139,2023-02-07,121.65,965.98
97,70163139,2023-02-11,55.33,1021.31
98,70163139,2023-02-11,100.86,1122.17
96,70163139,2023-02-11,158.58,1280.75
100,70163139,2023-02-12,64.23,1344.98
99,70163139,2023-02-12,170.4,1515.38
101,70163139,2023-02-14,48.39,1563.77
1999,70185446,2023-01-31,0.0,863.26
7722,70185446,2023-02-08,191.64,1054.9
7723,70185446,2023-02-09,97.29,1152.19
7724,70185446,2023-02-11,96.92,1249.1100000000001
2000,70214700,2023-01-31,0.0,152.79
165,70214700,2023-02-01,-1255.3,-1102.51
166,70214700,2023-02-02,-84.59,-1187.1
167,70214700,2023-02-06,-1498.3,-2685.3999999999996
168,70214700,2023-02-07,-89.15,-2774.5499999999997
8576,70214700,2023-02-12,127.0,-2647.5499999999997
169,70214700,2023-02-14,-102.53,-2750.08
8577,70214700,2023-02-14,33.09,-2716.99
2001,70217229,2023-01-31,0.0,705.69
2259,70217229,2023-02-02,167.22,872.9100000000001
2260,70217229,2023-02-02,190.9,1063.81
4739,70217229,2023-02-03,-127.58,936.23
2261,70217229,2023-02-06,59.52,995.75
4740,70217229,2023-02-12,-491.6,504.15000000000003
2262,70217229,2023-02-12,129.61,633.76
4741,70217229,2023-02-14,-46.61,587.1500000000001
2002,70221848,2023-01-31,0.0,550.83
1448,70221848,2023-02-01,69.91,620.74
1449,70221848,2023-02-03,175.55,796.2900000000001
1450,70221848,2023-02-05,23.13,819.4200000000001
1451,70221848,2023-02-08,149.26,968.6800000000001
2003,70231750,2023-01-31,0.0,749.6
2115,70231750,2023-02-02,187.19,936.79
4440,70231750,2023-02-03,-2128.4,-1191.6100000000001
4442,70231750,2023-02-04,-1618.2,-2809.81
4441,70231750,2023-02-04,-148.06,-2957.8700000000003
2116,70231750,2023-02-09,112.38,-2845.4900000000002
4443,70231750,2023-02-10,-192.08,-3037.57
2117,70231750,2023-02-11,100.04,-2937.53
2004,70331285,2023-01-31,0.0,537.34
7744,70331285,2023-02-08,-74.39,462.95000000000005
8040,70331285,2023-02-09,121.13,584.08
8041,70331285,2023-02-10,56.59,640.6700000000001
7745,70331285,2023-02-14,-105.11,535.5600000000001
2005,70351135,2023-01-31,0.0,169.6
1105,70351135,2023-02-01,3.89,173.48999999999998
1106,70351135,2023-02-05,128.72,302.21
8602,70351135,2023-02-13,-167.52,134.68999999999997
2006,70375931,2023-01-31,0.0,980.21
6041,70375931,2023-02-05,92.89,1073.1000000000001
7433,70375931,2023-02-07,-152.96,920.14
6042,70375931,2023-02-11,87.16,1007.3000000000001
6043,70375931,2023-02-13,159.46,1166.76
2007,70384410,2023-01-31,0.0,718.99
5550,70384410,2023-02-04,-129.64,589.35
5611,70384410,2023-02-04,122.2,711.5500000000001
5612,70384410,2023-02-09,969.7,1681.25
5551,70384410,2023-02-11,-55.38,1625.8700000000001
5613,70384410,2023-02-13,153.4,1779.2700000000002
2008,70385129,2023-01-31,0.0,252.45
1858,70385129,2023-02-01,121.46,373.90999999999997
1859,70385129,2023-02-08,25.37,399.28
1860,70385129,2023-02-10,134.99,534.27
2009,70409852,2023-01-31,0.0,662.8
5693,70409852,2023-02-04,-81.35,581.4499999999999
6806,70409852,2023-02-06,137.14,718.5899999999999
5694,70409852,2023-02-09,-67.33,651.26
6807,70409852,2023-02-10,25.41,676.67
6808,70409852,2023-02-11,102.16,778.8299999999999
2010,70469258,2023-01-31,0.0,868.53
5346,70469258,2023-02-04,-71.39,797.14
6133,70469258,2023-02-05,2112.8,2909.94
6134,70469258,2023-02-08,80.16,2990.1000000000004
5347,70469258,2023-02-09,-171.71,2818.3900000000003
5348,70469258,2023-02-10,-1575.6,1242.7900000000002
5349,70469258,2023-02-14,-47.11,1195.6800000000003
2011,70505401,2023-01-31,0.0,138.85
5042,70505401,2023-02-04,-113.98,24.86999999999999
5059,70505401,2023-02-04,113.98,138.85
5043,70505401,2023-02-11,-58.36,80.49
5060,70505401,2023-02-11,123.81,204.3
5044,70505401,2023-02-14,-884.5,-680.1999999999999
2012,70554021,2023-01-31,0.0,44.26
6176,70554021,2023-02-05,129.49,173.75
6796,70554021,2023-02-06,-116.65,57.1
6797,70554021,2023-02-10,-1188.3,-1131.2
6178,70554021,2023-02-11,78.25,-1052.95
6177,70554021,2023-02-11,126.09,-926.86
6179,70554021,2023-02-12,63.69,-863.1700000000001
2013,70567557,2023-01-31,0.0,984.3
7495,70567557,2023-02-07,41.64,1025.94
7801,70567557,2023-02-08,-87.73,938.2099999999999
7496,70567557,2023-02-08,185.22,1123.4299999999998
7497,70567557,2023-02-13,129.32,1252.75
7498,70567557,2023-02-14,113.78,1366.53
2014,70571486,2023-01-31,0.0,573.26
2114,70571486,2023-02-01,-52.17,521.09
2115,70571486,2023-02-07,-639.3,-118.20999999999992
2116,70571486,2023-02-10,-39.45,-157.65999999999997
8402,70571486,2023-02-11,115.25,-42.40999999999997
8403,70571486,2023-02-12,47.25,4.840000000000032
2015,70624878,2023-01-31,0.0,328.5
1866,70624878,2023-02-01,-158.51,169.99
4307,70624878,2023-02-03,825.8,995.79
4308,70624878,2023-02-05,190.77,1186.56
1867,70624878,2023-02-08,-1051.3,135.26
1868,70624878,2023-02-08,-94.34,40.91999999999996
4309,70624878,2023-02-08,190.88,231.79999999999998
2016,70643766,2023-01-31,0.0,143.86
4580,70643766,2023-02-03,-192.08,-48.22
4581,70643766,2023-02-07,-140.14,-188.36
2017,70652524,2023-01-31,0.0,342.86
5945,70652524,2023-02-05,76.23,419.09000000000003
5944,70652524,2023-02-05,81.18,500.27000000000004
5946,70652524,2023-02-07,61.37,561.64
5947,70652524,2023-02-11,89.98,651.62
5948,70652524,2023-02-12,104.46,756.08
2018,70665892,2023-01-31,0.0,856.22
1014,70665892,2023-02-01,-165.66,690.5600000000001
5324,70665892,2023-02-04,45.03,735.59
5325,70665892,2023-02-08,113.92,849.51
5326,70665892,2023-02-09,1365.7,2215.21
1015,70665892,2023-02-11,-43.12,2172.09
5327,70665892,2023-02-12,245.7,2417.79
2019,70719064,2023-01-31,0.0,752.97
2697,70719064,2023-02-02,-198.45,554.52
3032,70719064,2023-02-02,1805.5,2360.02
2698,70719064,2023-02-04,-163.96,2196.06
3033,70719064,2023-02-06,965.2,3161.26
3034,70719064,2023-02-08,145.4,3306.66
3035,70719064,2023-02-11,40.22,3346.88
2020,70749706,2023-01-31,0.0,963.82
2097,70749706,2023-02-01,-119.88,843.94
2098,70749706,2023-02-04,-122.23,721.71
2099,70749706,2023-02-07,-137.51,584.2
2100,70749706,2023-02-09,-150.23,433.97
8357,70749706,2023-02-10,58.75,492.72
2101,70749706,2023-02-12,-91.93,400.7900000000001
2021,70905083,2023-01-31,0.0,623.65
2808,70905083,2023-02-02,119.89,743.54
2809,70905083,2023-02-02,131.53,875.0699999999999
2810,70905083,2023-02-03,133.41,1008.48
2811,70905083,2023-02-07,103.35,1111.83
2022,70920653,2023-01-31,0.0,577.7
3648,70920653,2023-02-02,-88.8,488.90000000000003
3649,70920653,2023-02-04,-97.81,391.09000000000003
8187,70920653,2023-02-10,123.77,514.86
2023,70925461,2023-01-31,0.0,260.33
2009,70925461,2023-02-01,-66.84,193.48999999999998
4695,70925461,2023-02-03,97.5,290.99
2010,70925461,2023-02-06,-126.83,164.15999999999997
4697,70925461,2023-02-06,46.16,210.32
4696,70925461,2023-02-06,134.68,345.0
2011,70925461,2023-02-07,-154.41,190.58999999999997
2012,70925461,2023-02-08,-103.89,86.69999999999999
4698,70925461,2023-02-08,121.98,208.68
2013,70925461,2023-02-09,-287.8,-79.12
4699,70925461,2023-02-09,201.62,122.5
2014,70925461,2023-02-12,-907.1,-784.6000000000001
2015,70925461,2023-02-12,-100.25,-884.8499999999999
2024,70954264,2023-01-31,0.0,331.51
2032,70954264,2023-02-01,-142.91,188.6
2033,70954264,2023-02-02,-81.2,107.39999999999998
2034,70954264,2023-02-08,-35.81,71.58999999999997
2035,70954264,2023-02-10,-90.32,-18.730000000000018
2036,70954264,2023-02-10,-64.46,-83.19
8314,70954264,2023-02-10,113.81,30.620000000000005
2038,70954264,2023-02-12,-82.91,-52.289999999999964
2037,70954264,2023-02-12,-76.6,-128.89
2039,70954264,2023-02-13,-101.48,-230.37
2025,70989002,2023-01-31,0.0,220.06
4969,70989002,2023-02-03,-134.37,85.69
4970,70989002,2023-02-04,-111.19,-25.5
5512,70989002,2023-02-04,134.48,108.97999999999999
5514,70989002,2023-02-05,102.18,211.16
5513,70989002,2023-02-05,298.3,509.46
5515,70989002,2023-02-06,116.65,626.1100000000001
4971,70989002,2023-02-12,-87.73,538.3800000000001
5516,70989002,2023-02-13,156.04,694.4200000000001
2026,71014167,2023-01-31,0.0,654.16
748,71014167,2023-02-01,58.05,712.2099999999999
749,71014167,2023-02-02,72.72,784.93
5412,71014167,2023-02-04,-118.37,666.56
5413,71014167,2023-02-06,-46.33,620.23
750,71014167,2023-02-07,122.53,742.76
5414,71014167,2023-02-12,-84.75,658.01
751,71014167,2023-02-14,80.98,738.99
2027,71045135,2023-01-31,0.0,98.76
8446,71045135,2023-02-11,-989.3,-890.54
8445,71045135,2023-02-11,-43.47,-934.01
8580,71045135,2023-02-12,54.92,-879.0899999999999
8447,71045135,2023-02-14,-133.71,-1012.8
2028,71051904,2023-01-31,0.0,48.92
3403,71051904,2023-02-02,-93.84,-44.92
7231,71051904,2023-02-06,102.1,57.17999999999999
7232,71051904,2023-02-08,117.36,174.54
3404,71051904,2023-02-13,-2.26,172.27999999999997
2029,71082437,2023-01-31,0.0,717.98
5125,71082437,2023-02-04,111.19,829.1700000000001
7201,71082437,2023-02-06,-51.53,777.64
7202,71082437,2023-02-11,-122.42,655.22
5126,71082437,2023-02-11,111.11,766.33
5127,71082437,2023-02-12,96.6,862.9300000000001
7203,71082437,2023-02-13,-76.11,786.82
2030,71135606,2023-01-31,0.0,728.32
2700,71135606,2023-02-02,-104.5,623.82
2699,71135606,2023-02-02,-99.44,524.3800000000001
2701,71135606,2023-02-04,-47.16,477.22
2702,71135606,2023-02-08,-65.06,412.1600000000001
8028,71135606,2023-02-09,66.83,478.99000000000007
8027,71135606,2023-02-09,159.05,638.0400000000001
2704,71135606,2023-02-12,-116.83,521.21
2703,71135606,2023-02-12,-26.59,494.6200000000001
8029,71135606,2023-02-13,73.19,567.8100000000001
2031,71137421,2023-01-31,0.0,65.44
1231,71137421,2023-02-01,61.08,126.52
2167,71137421,2023-02-02,-27.44,99.08
1232,71137421,2023-02-02,109.29,208.37
2168,71137421,2023-02-07,-949.2,-740.8299999999999
2169,71137421,2023-02-07,-79.99,-820.8199999999999
1233,71137421,2023-02-07,53.78,-767.04
1234,71137421,2023-02-08,190.12,-576.9199999999998
2170,71137421,2023-02-14,-123.69,-700.6099999999999
2032,71161073,2023-01-31,0.0,861.98
353,71161073,2023-02-01,-99.52,762.46
354,71161073,2023-02-02,-94.2,668.26
8109,71161073,2023-02-09,191.29,859.55
2033,71183710,2023-01-31,0.0,989.68
3044,71183710,2023-02-02,-77.54,912.14
3045,71183710,2023-02-03,-65.8,846.3399999999999
4404,71183710,2023-02-03,5.31,851.65
3046,71183710,2023-02-04,-143.95,707.6999999999999
3047,71183710,2023-02-06,-68.0,639.6999999999999
3048,71183710,2023-02-07,-86.52,553.18
4405,71183710,2023-02-08,68.68,621.8599999999999
3049,71183710,2023-02-13,-77.91,543.95
2034,71213535,2023-01-31,0.0,686.81
7519,71213535,2023-02-07,83.34,770.15
7520,71213535,2023-02-08,136.73,906.8799999999999
7521,71213535,2023-02-08,218.9,1125.78
2035,71247681,2023-01-31,0.0,955.43
4363,71247681,2023-02-03,-114.47,840.9599999999999
4364,71247681,2023-02-11,-130.08,710.8799999999999
4365,71247681,2023-02-14,-93.52,617.3599999999999
2036,71264941,2023-01-31,0.0,195.49
914,71264941,2023-02-01,92.64,288.13
913,71264941,2023-02-01,160.38,448.51
912,71264941,2023-02-01,170.89,619.4
7134,71264941,2023-02-06,-33.32,586.0799999999999
915,71264941,2023-02-10,19.72,605.8
7135,71264941,2023-02-11,-222.05,383.75
7136,71264941,2023-02-11,-6.42,377.33
916,71264941,2023-02-11,101.84,479.16999999999996
917,71264941,2023-02-11,196.49,675.66
2037,71266283,2023-01-31,0.0,496.77
5518,71266283,2023-02-04,1218.0,1714.77
5519,71266283,2023-02-05,134.86,1849.63
7360,71266283,2023-02-07,-151.33,1698.3
7361,71266283,2023-02-09,-61.15,1637.15
5520,71266283,2023-02-09,105.21,1742.36
7362,71266283,2023-02-13,-223.88,1518.48
5521,71266283,2023-02-13,18.04,1536.52
5522,71266283,2023-02-13,138.97,1675.49
2038,71280775,2023-01-31,0.0,427.44
4393,71280775,2023-02-03,-124.88,302.56
4913,71280775,2023-02-03,65.8,368.36
4914,71280775,2023-02-04,148.06,516.42
4394,71280775,2023-02-05,-114.23,402.19
4395,71280775,2023-02-06,-1176.9,-774.71
4915,71280775,2023-02-06,91.85,-682.8600000000001
4916,71280775,2023-02-06,127.87,-554.99
4917,71280775,2023-02-09,112.69,-442.3000000000001
2039,71293250,2023-01-31,0.0,686.0
5778,71293250,2023-02-04,-5.86,680.14
6741,71293250,2023-02-06,120.15,800.29
6742,71293250,2023-02-08,90.09,890.38
5779,71293250,2023-02-11,-99.36,791.02
2040,71332337,2023-01-31,0.0,661.23
7308,71332337,2023-02-07,-1434.3,-773.0699999999999
7309,71332337,2023-02-08,-195.95,-969.02
7711,71332337,2023-02-08,113.65,-855.3699999999999
7712,71332337,2023-02-10,88.33,-767.04
7713,71332337,2023-02-12,120.12,-646.9199999999998
7310,71332337,2023-02-14,-95.87,-742.79
2041,71381278,2023-01-31,0.0,592.79
4840,71381278,2023-02-03,-66.67,526.12
8169,71381278,2023-02-09,82.1,608.2199999999999
4841,71381278,2023-02-11,-190.18,418.03999999999996
8170,71381278,2023-02-11,1243.0,1661.04
4842,71381278,2023-02-12,-245.7,1415.34
8171,71381278,2023-02-14,125.94,1541.28
2042,71383376,2023-01-31,0.0,448.26
931,71383376,2023-02-01,-170.96,277.29999999999995
4515,71383376,2023-02-03,1619.6,1896.8999999999999
932,71383376,2023-02-04,-884.9,1011.9999999999999
4516,71383376,2023-02-07,92.7,1104.6999999999998
933,71383376,2023-02-09,-105.71,998.9899999999999
4517,71383376,2023-02-10,94.14,1093.1299999999999
4518,71383376,2023-02-11,39.58,1132.71
2043,71394875,2023-01-31,0.0,778.77
1815,71394875,2023-02-01,-112.34,666.43
4928,71394875,2023-02-03,165.51,831.9399999999999
4929,71394875,2023-02-04,40.15,872.0899999999999
4930,71394875,2023-02-05,68.75,940.8399999999999
1816,71394875,2023-02-06,-144.68,796.16
4931,71394875,2023-02-13,158.03,954.1899999999999
1817,71394875,2023-02-14,-67.36,886.8299999999999
2044,71444662,2023-01-31,0.0,276.78
1798,71444662,2023-02-01,-101.08,175.7
1799,71444662,2023-02-02,-116.0,59.69999999999999
1800,71444662,2023-02-04,-1131.3,-1071.6
7606,71444662,2023-02-07,87.19,-984.4099999999999
1801,71444662,2023-02-12,-67.65,-1052.06
7607,71444662,2023-02-13,181.51,-870.55
1802,71444662,2023-02-14,-124.76,-995.31
2045,71469803,2023-01-31,0.0,14.79
6572,71469803,2023-02-05,-118.02,-103.22999999999999
6082,71469803,2023-02-05,151.15,47.92000000000001
6573,71469803,2023-02-11,-191.93,-144.01000000000002
6574,71469803,2023-02-14,-64.89,-208.9
6083,71469803,2023-02-14,141.49,-67.41
2046,71536854,2023-01-31,0.0,42.99
7064,71536854,2023-02-06,-93.96,-50.96999999999999
7065,71536854,2023-02-10,-181.0,-231.96999999999997
7066,71536854,2023-02-11,-112.1,-344.06999999999994
8474,71536854,2023-02-11,142.47,-201.59999999999997
2047,71562080,2023-01-31,0.0,352.05
5442,71562080,2023-02-04,63.81,415.86
5443,71562080,2023-02-09,101.51,517.37
8651,71562080,2023-02-14,-135.72,381.65000000000003
2048,71594658,2023-01-31,0.0,392.66
7326,71594658,2023-02-07,67.95,460.61
8244,71594658,2023-02-10,-93.37,367.24
8245,71594658,2023-02-11,-102.91,264.33000000000004
7327,71594658,2023-02-11,36.36,300.69000000000005
7329,71594658,2023-02-12,81.87,382.56000000000006
7328,71594658,2023-02-12,108.19,490.75
8246,71594658,2023-02-14,-7.26,483.49
2049,71643841,2023-01-31,0.0,232.5
4555,71643841,2023-02-03,161.37,393.87
7142,71643841,2023-02-06,-113.63,280.24
4556,71643841,2023-02-12,71.39,351.63
4557,71643841,2023-02-13,125.16,476.79
7143,71643841,2023-02-14,-1308.6,-831.81
2050,71675127,2023-01-31,0.0,353.48
2607,71675127,2023-02-02,143.95,497.43
7641,71675127,2023-02-07,-171.53,325.9
2608,71675127,2023-02-11,82.38,408.28
2051,71718483,2023-01-31,0.0,747.34
236,71718483,2023-02-01,1089.6,1836.94
2625,71718483,2023-02-02,-112.35,1724.59
2624,71718483,2023-02-02,-100.61,1623.98
237,71718483,2023-02-02,94.57,1718.55
238,71718483,2023-02-02,1193.3,2911.85
239,71718483,2023-02-09,42.25,2954.1000000000004
240,71718483,2023-02-12,90.33,3044.4300000000003
241,71718483,2023-02-13,167.52,3211.9500000000003
2052,71791483,2023-01-31,0.0,873.44
3905,71791483,2023-02-03,99.93,973.3700000000001
5055,71791483,2023-02-04,-34.64,938.73
5056,71791483,2023-02-12,-86.27,852.46
2053,71792376,2023-01-31,0.0,4.39
2849,71792376,2023-02-02,-50.71,-46.32
2850,71792376,2023-02-03,-76.87,-123.19000000000001
7460,71792376,2023-02-07,74.77,-48.420000000000016
2851,71792376,2023-02-09,-160.1,-208.52000000000004
2852,71792376,2023-02-09,-68.62,-277.14
2853,71792376,2023-02-11,-84.08,-361.22
7461,71792376,2023-02-11,52.48,-308.74
7462,71792376,2023-02-14,90.48,-218.26000000000002
2054,71825742,2023-01-31,0.0,665.75
2425,71825742,2023-02-02,198.28,864.03
7676,71825742,2023-02-08,-968.8,-104.76999999999998
2055,71852263,2023-01-31,0.0,676.77
8299,71852263,2023-02-10,42.14,718.91
8300,71852263,2023-02-14,163.23,882.14
2056,71868471,2023-01-31,0.0,474.32
6463,71868471,2023-02-05,-1315.1,-840.78
7627,71868471,2023-02-07,189.62,-651.1600000000001
7628,71868471,2023-02-08,196.25,-454.9099999999999
6464,71868471,2023-02-11,-121.25,-576.1600000000001
7629,71868471,2023-02-12,7.59,-568.5699999999999
2057,71913103,2023-01-31,0.0,5.42
2598,71913103,2023-02-02,117.49,122.91
2599,71913103,2023-02-06,121.13,244.04
2600,71913103,2023-02-07,127.37,371.41
2601,71913103,2023-02-08,40.97,412.38
2058,71934515,2023-01-31,0.0,340.99
5949,71934515,2023-02-05,59.47,400.46000000000004
6911,71934515,2023-02-06,-1011.5,-611.04
6912,71934515,2023-02-08,-358.9,-969.9399999999998
5950,71934515,2023-02-08,150.55,-819.3899999999999
6913,71934515,2023-02-09,-82.1,-901.49
2059,71939863,2023-01-31,0.0,116.31
1937,71939863,2023-02-01,136.22,252.53
1938,71939863,2023-02-05,110.09,362.62
1939,71939863,2023-02-06,995.2,1357.82
1940,71939863,2023-02-11,102.84,1460.6599999999999
2060,72008772,2023-01-31,0.0,725.22
445,72008772,2023-02-01,-110.9,614.32
3871,72008772,2023-02-03,1791.6,2405.92
446,72008772,2023-02-04,-112.22,2293.7
3873,72008772,2023-02-06,60.85,2354.55
3872,72008772,2023-02-06,95.71,2450.2599999999998
447,72008772,2023-02-09,-175.39,2274.87
3874,72008772,2023-02-09,83.64,2358.5099999999998
3875,72008772,2023-02-13,81.86,2440.37
448,72008772,2023-02-14,-113.47,2326.8999999999996
2061,72050477,2023-01-31,0.0,95.87
4809,72050477,2023-02-03,-106.6,-10.72999999999999
7913,72050477,2023-02-08,156.86,146.13000000000002
2062,72055977,2023-01-31,0.0,172.73
7983,72055977,2023-02-09,108.23,280.96
7984,72055977,2023-02-09,624.2,905.1600000000001
8362,72055977,2023-02-10,-178.01,727.1500000000001
7985,72055977,2023-02-11,78.66,805.8100000000001
2063,72087700,2023-01-31,0.0,359.55
7136,72087700,2023-02-06,160.25,519.8
7137,72087700,2023-02-07,229.29,749.0899999999999
7138,72087700,2023-02-09,25.58,774.6700000000001
8552,72087700,2023-02-12,-109.9,664.77
7139,72087700,2023-02-13,125.92,790.69
2064,72120467,2023-01-31,0.0,340.15
5112,72120467,2023-02-04,-75.25,264.9
5113,72120467,2023-02-11,-125.55,139.34999999999997
2065,72164482,2023-01-31,0.0,535.39
3423,72164482,2023-02-02,-83.79,451.59999999999997
3424,72164482,2023-02-09,-951.0,-499.4
3425,72164482,2023-02-10,-89.11,-588.5099999999999
8596,72164482,2023-02-12,643.6,55.09000000000003
2066,72176895,2023-01-31,0.0,109.78
3754,72176895,2023-02-03,64.91,174.69
8138,72176895,2023-02-09,-38.14,136.55
3755,72176895,2023-02-09,160.54,297.09000000000003
8139,72176895,2023-02-13,-837.4,-540.31
3756,72176895,2023-02-13,150.38,-389.93000000000006
2067,72208029,2023-01-31,0.0,11.37
744,72208029,2023-02-01,0.5,11.87
3657,72208029,2023-02-02,-181.62,-169.75
3658,72208029,2023-02-05,-139.1,-308.85
3659,72208029,2023-02-06,-1024.2,-1333.0500000000002
745,72208029,2023-02-06,66.16,-1266.89
3661,72208029,2023-02-09,-173.88,-1440.7700000000002
3660,72208029,2023-02-09,-140.11,-1580.88
3662,72208029,2023-02-10,-80.36,-1661.2400000000002
3663,72208029,2023-02-13,-102.22,-1763.4600000000003
3664,72208029,2023-02-14,-141.62,-1905.0800000000002
2068,72230395,2023-01-31,0.0,773.55
3771,72230395,2023-02-03,-130.74,642.81
4628,72230395,2023-02-03,155.02,797.8299999999999
3772,72230395,2023-02-09,-53.95,743.88
3773,72230395,2023-02-11,-86.69,657.1899999999999
3774,72230395,2023-02-13,-518.3,138.89
3775,72230395,2023-02-14,-597.7,-458.8100000000002
2069,72268811,2023-01-31,0.0,694.68
2754,72268811,2023-02-02,-151.37,543.31
2755,72268811,2023-02-02,-62.04,481.27
3914,72268811,2023-02-03,133.85,615.1199999999999
3915,72268811,2023-02-08,70.08,685.1999999999999
2756,72268811,2023-02-09,-134.21,550.99
3916,72268811,2023-02-11,132.94,683.93
3917,72268811,2023-02-12,84.13,768.06
2070,72289791,2023-01-31,0.0,502.96
2214,72289791,2023-02-02,130.94,633.9
2216,72289791,2023-02-07,11.99,645.89
2215,72289791,2023-02-07,185.39,831.28
8319,72289791,2023-02-10,-1046.8,-215.52000000000004
8320,72289791,2023-02-11,-63.8,-279.32
2071,72292735,2023-01-31,0.0,723.43
697,72292735,2023-02-01,-153.65,569.78
696,72292735,2023-02-01,-50.95,518.8299999999999
698,72292735,2023-02-04,-122.2,396.62999999999994
699,72292735,2023-02-09,-54.57,342.05999999999995
8054,72292735,2023-02-09,128.31,470.36999999999995
700,72292735,2023-02-10,-88.62,381.74999999999994
8055,72292735,2023-02-12,19.98,401.72999999999996
8056,72292735,2023-02-14,54.0,455.72999999999996
2072,72309641,2023-01-31,0.0,386.61
6546,72309641,2023-02-05,179.34,565.95
6856,72309641,2023-02-06,-96.4,469.55
6857,72309641,2023-02-07,-0.83,468.72
6858,72309641,2023-02-11,-2.2,466.52
6859,72309641,2023-02-13,-138.24,328.28
6860,72309641,2023-02-14,-1323.7,-995.42
2073,72323206,2023-01-31,0.0,372.97
6797,72323206,2023-02-06,71.4,444.37
8204,72323206,2023-02-09,-135.68,308.69000000000005
8205,72323206,2023-02-11,-126.09,182.60000000000002
6798,72323206,2023-02-13,132.93,315.53000000000003
2074,72354216,2023-01-31,0.0,852.23
3290,72354216,2023-02-02,118.23,970.46
6185,72354216,2023-02-05,-81.6,888.86
6186,72354216,2023-02-07,-145.86,743.0
6187,72354216,2023-02-10,-62.94,680.06
6188,72354216,2023-02-11,-165.48,514.58
3291,72354216,2023-02-12,742.0,1256.58
6189,72354216,2023-02-13,-147.05,1109.53
3292,72354216,2023-02-13,1127.3,2236.83
6190,72354216,2023-02-14,-2010.0,226.82999999999993
2075,72446758,2023-01-31,0.0,893.64
7686,72446758,2023-02-08,-196.25,697.39
7687,72446758,2023-02-08,-153.92,543.47
7779,72446758,2023-02-08,67.6,611.0699999999999
7688,72446758,2023-02-12,-58.82,552.25
7689,72446758,2023-02-14,-141.49,410.76
2076,72450129,2023-01-31,0.0,905.61
376,72450129,2023-02-01,-208.23,697.38
2927,72450129,2023-02-02,90.38,787.76
2929,72450129,2023-02-03,98.53,886.29
2928,72450129,2023-02-03,130.7,1016.99
2930,72450129,2023-02-10,156.28,1173.27
2931,72450129,2023-02-14,112.23,1285.5
2077,72466733,2023-01-31,0.0,580.24
5023,72466733,2023-02-03,474.7,1054.94
7879,72466733,2023-02-08,-61.29,993.65
5024,72466733,2023-02-09,138.48,1132.13
7880,72466733,2023-02-10,-78.83,1053.3
2078,72526383,2023-01-31,0.0,885.37
7451,72526383,2023-02-07,853.6,1738.97
7704,72526383,2023-02-08,-166.6,1572.37
7703,72526383,2023-02-08,-13.55,1558.8200000000002
7452,72526383,2023-02-08,93.74,1652.56
7453,72526383,2023-02-12,895.2,2547.76
7705,72526383,2023-02-13,-93.82,2453.94
2079,72558185,2023-01-31,0.0,793.9
7727,72558185,2023-02-08,77.8,871.6999999999999
2080,72600465,2023-01-31,0.0,595.44
4665,72600465,2023-02-03,108.6,704.0400000000001
8088,72600465,2023-02-09,-197.63,506.4100000000001
2081,72623919,2023-01-31,0.0,610.63
4733,72623919,2023-02-03,119.56,730.19
7654,72623919,2023-02-07,-65.6,664.59
4734,72623919,2023-02-07,644.8,1309.3899999999999
7655,72623919,2023-02-08,-72.15,1237.24
7656,72623919,2023-02-12,-803.9,433.34000000000003
4735,72623919,2023-02-13,98.45,531.7900000000001
2082,72627756,2023-01-31,0.0,473.02
3179,72627756,2023-02-02,63.42,536.4399999999999
3180,72627756,2023-02-04,44.62,581.06
5999,72627756,2023-02-05,-98.07,482.99
3181,72627756,2023-02-05,94.48,577.47
6000,72627756,2023-02-12,-54.92,522.55
3182,72627756,2023-02-12,49.53,572.0799999999999
2083,72716288,2023-01-31,0.0,167.69
6285,72716288,2023-02-05,-118.55,49.14
7367,72716288,2023-02-07,1282.4,1331.5400000000002
6286,72716288,2023-02-09,-36.48,1295.0600000000002
2084,72771982,2023-01-31,0.0,501.76
2843,72771982,2023-02-02,-95.09,406.66999999999996
2844,72771982,2023-02-05,-74.98,331.69
2845,72771982,2023-02-06,-94.32,237.37
8600,72771982,2023-02-12,81.63,319.0
2846,72771982,2023-02-13,-86.2,232.79999999999995
2085,72784766,2023-01-31,0.0,181.69
2131,72784766,2023-02-01,-142.14,39.55000000000001
978,72784766,2023-02-01,161.31,200.86
979,72784766,2023-02-09,1288.6,1489.46
981,72784766,2023-02-11,131.61,1621.0700000000002
980,72784766,2023-02-11,482.1,2103.17
982,72784766,2023-02-14,170.29,2273.46
2086,72799297,2023-01-31,0.0,614.69
5764,72799297,2023-02-04,-45.45,569.24
2087,72809561,2023-01-31,0.0,270.68
2705,72809561,2023-02-02,-62.51,208.17000000000002
2475,72809561,2023-02-02,156.52,364.69000000000005
2476,72809561,2023-02-03,111.35,476.04
2706,72809561,2023-02-09,-69.0,407.04
2707,72809561,2023-02-10,-151.75,255.29000000000002
2088,72809943,2023-01-31,0.0,870.72
3593,72809943,2023-02-02,-91.97,778.75
3071,72809943,2023-02-02,71.36,850.11
3594,72809943,2023-02-03,-111.24,738.87
3595,72809943,2023-02-06,-96.19,642.6800000000001
3596,72809943,2023-02-06,-57.47,585.21
3598,72809943,2023-02-07,-125.73,459.48
3597,72809943,2023-02-07,-113.01,346.47
3599,72809943,2023-02-08,-93.19,253.27999999999997
3600,72809943,2023-02-09,-118.62,134.66000000000008
3072,72809943,2023-02-12,99.3,233.96000000000004
3073,72809943,2023-02-14,116.09,350.05000000000007
3074,72809943,2023-02-14,1297.2,1647.25
2089,72812647,2023-01-31,0.0,351.84
1140,72812647,2023-02-01,-134.43,217.40999999999997
1141,72812647,2023-02-02,-73.15,144.25999999999996
6898,72812647,2023-02-06,20.39,164.64999999999998
6899,72812647,2023-02-07,74.77,239.41999999999996
6900,72812647,2023-02-08,209.9,449.31999999999994
1142,72812647,2023-02-11,-159.08,290.23999999999995
2090,72856610,2023-01-31,0.0,576.08
1917,72856610,2023-02-01,103.99,680.07
1918,72856610,2023-02-02,107.47,787.54
6261,72856610,2023-02-05,-76.11,711.4300000000001
1919,72856610,2023-02-05,8.72,720.1500000000001
1920,72856610,2023-02-06,140.03,860.1800000000001
1921,72856610,2023-02-08,114.69,974.87
6262,72856610,2023-02-13,-74.01,900.86
2091,72894034,2023-01-31,0.0,74.8
1067,72894034,2023-02-01,164.31,239.11
1068,72894034,2023-02-04,79.24,318.35
8570,72894034,2023-02-12,-57.16,261.19
2092,72925782,2023-01-31,0.0,351.64
2525,72925782,2023-02-02,121.58,473.21999999999997
2526,72925782,2023-02-04,761.9,1235.12
6070,72925782,2023-02-05,-12.23,1222.8899999999999
6071,72925782,2023-02-09,-99.11,1123.78
6072,72925782,2023-02-11,-149.84,973.9399999999999
2093,72934756,2023-01-31,0.0,829.55
1987,72934756,2023-02-01,-127.57,701.98
731,72934756,2023-02-01,12.83,714.81
730,72934756,2023-02-01,856.5,1571.31
1988,72934756,2023-02-02,-94.69,1476.62
732,72934756,2023-02-03,28.47,1505.09
1989,72934756,2023-02-04,-1080.2,424.8899999999999
733,72934756,2023-02-07,66.78,491.66999999999985
1990,72934756,2023-02-14,-63.85,427.8199999999999
2094,72971287,2023-01-31,0.0,890.23
1088,72971287,2023-02-01,-65.26,824.97
648,72971287,2023-02-01,67.52,892.49
649,72971287,2023-02-02,122.23,1014.72
1089,72971287,2023-02-10,-1038.8,-24.079999999999927
1090,72971287,2023-02-11,-87.08,-111.15999999999997
650,72971287,2023-02-13,109.33,-1.8299999999999272
2095,72986897,2023-01-31,0.0,603.23
5806,72986897,2023-02-04,-42.74,560.49
5807,72986897,2023-02-07,-182.69,377.8
7957,72986897,2023-02-08,72.05,449.85
7958,72986897,2023-02-09,69.41,519.26
7959,72986897,2023-02-12,1682.4,2201.66
7960,72986897,2023-02-14,86.1,2287.76
2096,72995062,2023-01-31,0.0,506.73
937,72995062,2023-02-01,321.2,827.9300000000001
4923,72995062,2023-02-03,-105.23,722.7
938,72995062,2023-02-03,121.77,844.47
4924,72995062,2023-02-05,-175.88,668.59
939,72995062,2023-02-08,173.81,842.4
4925,72995062,2023-02-09,-73.82,768.58
940,72995062,2023-02-14,321.9,1090.48
2097,72996601,2023-01-31,0.0,730.27
3840,72996601,2023-02-03,-201.14,529.13
3839,72996601,2023-02-03,-50.42,478.71
3841,72996601,2023-02-04,-84.53,394.18
7442,72996601,2023-02-07,78.2,472.38
7443,72996601,2023-02-08,157.52,629.9
3842,72996601,2023-02-10,-989.8,-359.89999999999986
7444,72996601,2023-02-10,93.87,-266.03
3843,72996601,2023-02-11,-113.52,-379.54999999999995
3844,72996601,2023-02-13,-106.08,-485.6299999999999
2098,73009461,2023-01-31,0.0,938.52
5590,73009461,2023-02-04,-89.19,849.3299999999999
8091,73009461,2023-02-09,125.67,975.0
8092,73009461,2023-02-10,97.88,1072.88
5591,73009461,2023-02-13,-26.0,1046.8799999999999
8093,73009461,2023-02-14,88.67,1135.55
2099,73015538,2023-01-31,0.0,634.94
52,73015538,2023-02-01,249.75,884.69
3041,73015538,2023-02-02,-526.8,357.8900000000001
3042,73015538,2023-02-03,-37.15,320.7400000000001
3043,73015538,2023-02-07,-1190.8,-870.06
53,73015538,2023-02-08,903.3,33.24000000000024
54,73015538,2023-02-09,107.47,140.71000000000026
55,73015538,2023-02-10,85.7,226.41000000000025
56,73015538,2023-02-11,557.0,783.4100000000003
2100,73039019,2023-01-31,0.0,360.0
6562,73039019,2023-02-05,175.88,535.88
8032,73039019,2023-02-09,-176.56,359.32
8033,73039019,2023-02-11,-35.07,324.25
2101,73059951,2023-01-31,0.0,955.01
3519,73059951,2023-02-02,128.13,1083.1399999999999
3520,73059951,2023-02-03,53.78,1136.92
3521,73059951,2023-02-04,198.37,1335.29
3522,73059951,2023-02-07,65.96,1401.25
3523,73059951,2023-02-12,206.28,1607.53
2102,73080553,2023-01-31,0.0,880.06
5773,73080553,2023-02-04,-79.24,800.8199999999999
8283,73080553,2023-02-10,59.44,860.26
5774,73080553,2023-02-11,-120.19,740.0699999999999
8284,73080553,2023-02-11,79.43,819.5
2103,73124762,2023-01-31,0.0,110.47
1105,73124762,2023-02-01,-50.33,60.14
1104,73124762,2023-02-01,-49.48,10.659999999999997
1106,73124762,2023-02-06,-24.38,-13.719999999999999
7575,73124762,2023-02-07,87.94,74.22
7577,73124762,2023-02-09,177.2,251.42
7576,73124762,2023-02-09,196.64,448.05999999999995
1107,73124762,2023-02-11,-51.94,396.12
7578,73124762,2023-02-12,78.65,474.77
2104,73208971,2023-01-31,0.0,107.97
3311,73208971,2023-02-02,-185.26,-77.28999999999999
7267,73208971,2023-02-07,484.1,406.81000000000006
7268,73208971,2023-02-12,95.07,501.88
2105,73234341,2023-01-31,0.0,811.71
5057,73234341,2023-02-04,101.3,913.01
8503,73234341,2023-02-11,-2044.6,-1131.59
5058,73234341,2023-02-11,107.95,-1023.6399999999999
2106,73269307,2023-01-31,0.0,485.86
5278,73269307,2023-02-04,42.73,528.59
5279,73269307,2023-02-04,98.27,626.86
2107,73275714,2023-01-31,0.0,924.88
5415,73275714,2023-02-04,-173.75,751.13
5416,73275714,2023-02-06,-123.09,628.04
8512,73275714,2023-02-11,135.38,763.42
2108,73282074,2023-01-31,0.0,220.48
1585,73282074,2023-02-01,-61.23,159.25
1586,73282074,2023-02-04,-97.9,61.349999999999994
1587,73282074,2023-02-07,-147.36,-86.01000000000002
1588,73282074,2023-02-07,-105.38,-191.39000000000001
1589,73282074,2023-02-09,-239.1,-430.49
1590,73282074,2023-02-11,-54.29,-484.78
1591,73282074,2023-02-13,-71.18,-555.96
2109,73321391,2023-01-31,0.0,100.12
4553,73321391,2023-02-03,-174.25,-74.13
4554,73321391,2023-02-04,-18.25,-92.38
4555,73321391,2023-02-11,-80.85,-173.23000000000002
4556,73321391,2023-02-12,-61.95,-235.18
4557,73321391,2023-02-13,-80.74,-315.91999999999996
8676,73321391,2023-02-14,78.83,-237.08999999999997
2110,73328955,2023-01-31,0.0,404.7
6889,73328955,2023-02-06,-30.45,374.25
6890,73328955,2023-02-07,-1819.0,-1444.75
7987,73328955,2023-02-09,149.44,-1295.31
6891,73328955,2023-02-10,-50.5,-1345.81
7988,73328955,2023-02-13,77.1,-1268.71
2111,73410227,2023-01-31,0.0,820.36
1001,73410227,2023-02-01,-219.71,600.65
6766,73410227,2023-02-06,52.84,653.49
6767,73410227,2023-02-09,38.14,691.63
1002,73410227,2023-02-12,-107.09,584.54
2112,73439131,2023-01-31,0.0,863.01
2906,73439131,2023-02-02,-88.1,774.91
2907,73439131,2023-02-02,-71.36,703.55
2908,73439131,2023-02-02,-54.93,648.62
2909,73439131,2023-02-03,-149.58,499.03999999999996
2910,73439131,2023-02-04,-123.49,375.55
5823,73439131,2023-02-04,107.38,482.93
2911,73439131,2023-02-06,-1069.0,-586.0699999999999
5824,73439131,2023-02-07,69.6,-516.47
2912,73439131,2023-02-09,-98.98,-615.45
2913,73439131,2023-02-14,-53.79,-669.24
5825,73439131,2023-02-14,105.25,-563.99
2113,73510067,2023-01-31,0.0,895.82
5431,73510067,2023-02-04,135.72,1031.54
7563,73510067,2023-02-07,-135.77,895.77
5432,73510067,2023-02-14,22.59,918.36
2114,73512834,2023-01-31,0.0,424.59
1480,73512834,2023-02-01,103.58,528.17
1481,73512834,2023-02-02,110.43,638.5999999999999
5297,73512834,2023-02-04,-578.7,59.89999999999992
5298,73512834,2023-02-05,-6.73,53.1699999999999
1482,73512834,2023-02-06,113.54,166.70999999999992
5299,73512834,2023-02-09,-176.84,-10.130000000000052
1483,73512834,2023-02-09,54.35,44.219999999999914
1484,73512834,2023-02-10,123.35,167.56999999999988
5300,73512834,2023-02-11,-110.11,57.45999999999992
5301,73512834,2023-02-11,-31.41,26.049999999999898
1485,73512834,2023-02-12,121.0,147.0499999999999
1486,73512834,2023-02-14,163.28,310.3299999999999
2115,73534143,2023-01-31,0.0,804.34
8568,73534143,2023-02-12,-85.27,719.07
2116,73538236,2023-01-31,0.0,231.93
248,73538236,2023-02-01,60.58,292.51
8621,73538236,2023-02-13,-99.01,193.5
2117,73604500,2023-01-31,0.0,689.4
2502,73604500,2023-02-02,-186.07,503.33
7219,73604500,2023-02-06,193.27,696.6
7220,73604500,2023-02-12,140.65,837.25
2118,73642628,2023-01-31,0.0,300.06
6777,73642628,2023-02-06,-128.02,172.04
7125,73642628,2023-02-06,1042.0,1214.04
7126,73642628,2023-02-07,109.32,1323.36
7127,73642628,2023-02-08,128.53,1451.8899999999999
7128,73642628,2023-02-09,105.05,1556.94
7129,73642628,2023-02-14,109.13,1666.07
2119,73652359,2023-01-31,0.0,80.58
7914,73652359,2023-02-08,68.73,149.31
7915,73652359,2023-02-12,135.05,284.36
7916,73652359,2023-02-14,12.8,297.16
2120,73668192,2023-01-31,0.0,371.47
3682,73668192,2023-02-02,1495.8,1867.27
5426,73668192,2023-02-04,-153.96,1713.31
3684,73668192,2023-02-05,37.76,1751.07
3683,73668192,2023-02-05,149.4,1900.47
5427,73668192,2023-02-07,-93.03,1807.44
5428,73668192,2023-02-10,-11.9,1795.54
3685,73668192,2023-02-10,111.12,1906.66
5429,73668192,2023-02-13,-62.93,1843.73
2121,73700087,2023-01-31,0.0,274.17
5840,73700087,2023-02-04,-44.37,229.8
5685,73700087,2023-02-04,116.66,346.46000000000004
5841,73700087,2023-02-06,-106.53,239.93
5686,73700087,2023-02-08,70.5,310.43
5687,73700087,2023-02-10,70.11,380.54
5842,73700087,2023-02-12,-84.72,295.82
2122,73744504,2023-01-31,0.0,270.6
6244,73744504,2023-02-05,-54.49,216.11
6245,73744504,2023-02-07,-52.52,163.59000000000003
7885,73744504,2023-02-08,51.75,215.34000000000003
6246,73744504,2023-02-09,-70.71,144.63000000000002
6248,73744504,2023-02-10,-127.34,17.29000000000002
6247,73744504,2023-02-10,-69.64,-52.349999999999966
6249,73744504,2023-02-11,-69.64,-121.99000000000001
7886,73744504,2023-02-11,89.18,-32.809999999999945
6250,73744504,2023-02-12,-128.61,-161.41999999999996
6251,73744504,2023-02-13,-137.58,-299.0
7887,73744504,2023-02-13,165.67,-133.33000000000004
2123,73762750,2023-01-31,0.0,221.12
873,73762750,2023-02-01,-66.19,154.93
4662,73762750,2023-02-03,1505.1,1660.0299999999997
874,73762750,2023-02-05,-129.71,1530.3199999999997
4663,73762750,2023-02-06,106.97,1637.29
4664,73762750,2023-02-08,156.53,1793.8199999999997
2124,73782061,2023-01-31,0.0,891.9
2422,73782061,2023-02-02,-58.23,833.67
2424,73782061,2023-02-13,-164.0,669.67
2423,73782061,2023-02-13,-69.25,600.42
2125,73878828,2023-01-31,0.0,845.19
207,73878828,2023-02-01,-58.02,787.1700000000001
208,73878828,2023-02-04,-973.3,-186.12999999999988
6976,73878828,2023-02-06,42.82,-143.30999999999983
6977,73878828,2023-02-09,117.9,-25.409999999999854
209,73878828,2023-02-10,-7.29,-32.69999999999993
6978,73878828,2023-02-10,74.6,41.90000000000009
210,73878828,2023-02-13,-62.41,-20.509999999999877
6979,73878828,2023-02-13,86.65,66.1400000000001
2126,73983591,2023-01-31,0.0,292.39
25,73983591,2023-02-01,117.31,409.7
26,73983591,2023-02-05,72.56,482.26
6716,73983591,2023-02-06,-124.22,358.03999999999996
27,73983591,2023-02-07,7.57,365.61
6717,73983591,2023-02-08,-1668.5,-1302.8899999999999
6718,73983591,2023-02-10,-83.3,-1386.19
6719,73983591,2023-02-11,-152.46,-1538.65
6720,73983591,2023-02-13,-83.87,-1622.52
2127,73983601,2023-01-31,0.0,617.23
5835,73983601,2023-02-04,-186.59,430.64
5836,73983601,2023-02-06,-111.97,318.67
7865,73983601,2023-02-08,62.88,381.55
5837,73983601,2023-02-10,-136.73,244.82000000000005
7866,73983601,2023-02-11,81.42,326.24
5838,73983601,2023-02-12,-37.22,289.02000000000004
5839,73983601,2023-02-13,-140.52,148.5
7867,73983601,2023-02-14,82.4,230.89999999999998
2128,74012560,2023-01-31,0.0,414.56
7731,74012560,2023-02-08,-51.04,363.52
7733,74012560,2023-02-10,-150.3,213.22
7732,74012560,2023-02-10,-71.14,142.07999999999998
7734,74012560,2023-02-10,-70.94,71.13999999999999
8256,74012560,2023-02-10,75.51,146.65000000000003
8255,74012560,2023-02-10,2476.1,2622.75
7735,74012560,2023-02-14,-96.98,2525.77
2129,74154906,2023-01-31,0.0,743.84
8000,74154906,2023-02-09,32.68,776.52
2130,74163559,2023-01-31,0.0,45.76
3562,74163559,2023-02-02,-105.59,-59.830000000000005
2559,74163559,2023-02-02,100.89,41.059999999999995
2560,74163559,2023-02-07,84.66,125.72
3563,74163559,2023-02-09,-91.85,33.87
3564,74163559,2023-02-10,-108.57,-74.69999999999999
3565,74163559,2023-02-11,-80.75,-155.45
2131,74218001,2023-01-31,0.0,133.02
6320,74218001,2023-02-05,68.53,201.55
8103,74218001,2023-02-09,-7.4,194.15
6321,74218001,2023-02-09,898.2,1092.3500000000001
2132,74252410,2023-01-31,0.0,278.47
21,74252410,2023-02-01,-117.31,161.16000000000003
22,74252410,2023-02-01,-105.25,55.910000000000025
1749,74252410,2023-02-01,37.94,93.85000000000002
23,74252410,2023-02-03,-145.42,-51.569999999999936
1750,74252410,2023-02-03,126.21,74.64000000000004
24,74252410,2023-02-08,-32.44,42.200000000000045
1751,74252410,2023-02-10,1531.0,1573.2
25,74252410,2023-02-11,-1207.7,365.5
1752,74252410,2023-02-13,99.01,464.51
1753,74252410,2023-02-14,625.3,1089.81
2133,74255305,2023-01-31,0.0,3.7
3686,74255305,2023-02-02,162.41,166.10999999999999
3687,74255305,2023-02-03,106.51,272.62
3688,74255305,2023-02-06,93.96,366.58
3689,74255305,2023-02-07,85.44,452.02
8449,74255305,2023-02-11,-1672.7,-1220.68
8450,74255305,2023-02-11,-167.02,-1387.7
2134,74281404,2023-01-31,0.0,678.89
816,74281404,2023-02-01,-456.2,222.69
5872,74281404,2023-02-04,139.28,361.97
5873,74281404,2023-02-08,89.88,451.85
817,74281404,2023-02-11,-145.81,306.03999999999996
2135,74304084,2023-01-31,0.0,883.35
1166,74304084,2023-02-01,131.58,1014.9300000000001
1167,74304084,2023-02-08,570.9,1585.83
1168,74304084,2023-02-10,89.61,1675.44
8649,74304084,2023-02-14,-122.61,1552.83
2136,74365725,2023-01-31,0.0,518.04
3982,74365725,2023-02-03,-97.42,420.61999999999995
6880,74365725,2023-02-06,24.84,445.46
6881,74365725,2023-02-10,81.71,527.17
6882,74365725,2023-02-13,163.71,690.88
2137,74367877,2023-01-31,0.0,818.92
1344,74367877,2023-02-01,45.64,864.56
2538,74367877,2023-02-02,-104.03,760.53
1345,74367877,2023-02-03,472.5,1233.03
2539,74367877,2023-02-08,-70.08,1162.95
2540,74367877,2023-02-10,-118.64,1044.31
1346,74367877,2023-02-13,48.97,1093.28
2138,74387481,2023-01-31,0.0,883.93
3629,74387481,2023-02-02,-117.73,766.1999999999999
5496,74387481,2023-02-04,106.46,872.66
3630,74387481,2023-02-07,-644.8,227.86
3631,74387481,2023-02-07,-87.94,139.91999999999996
5497,74387481,2023-02-07,88.5,228.41999999999996
5498,74387481,2023-02-08,162.49,390.91
3632,74387481,2023-02-09,-163.2,227.71000000000004
3633,74387481,2023-02-10,-91.88,135.83000000000004
3634,74387481,2023-02-13,-61.95,73.88
2139,74441123,2023-01-31,0.0,833.24
125,74441123,2023-02-01,-143.97,689.27
2228,74441123,2023-02-02,61.45,750.72
126,74441123,2023-02-08,-124.5,626.22
127,74441123,2023-02-09,-128.5,497.72
128,74441123,2023-02-10,-139.35,358.37
129,74441123,2023-02-13,-1154.7,-796.3300000000002
2140,74539170,2023-01-31,0.0,417.58
5384,74539170,2023-02-04,-74.02,343.56
5481,74539170,2023-02-04,143.01,486.57
5385,74539170,2023-02-07,-142.95,343.62
5386,74539170,2023-02-10,-126.49,217.13
5387,74539170,2023-02-11,-1.71,215.42
5482,74539170,2023-02-11,84.22,299.64
5388,74539170,2023-02-12,-20.81,278.83000000000004
2141,74544582,2023-01-31,0.0,407.96
800,74544582,2023-02-01,-58.96,349.0
7084,74544582,2023-02-06,107.8,456.79999999999995
7085,74544582,2023-02-07,89.17,545.97
801,74544582,2023-02-08,-1010.6,-464.63000000000005
802,74544582,2023-02-10,-122.82,-587.45
803,74544582,2023-02-11,-28.8,-616.25
804,74544582,2023-02-11,-16.09,-632.3399999999999
805,74544582,2023-02-13,-196.46,-828.8
806,74544582,2023-02-13,-46.08,-874.8800000000001
2142,74604471,2023-01-31,0.0,661.57
4102,74604471,2023-02-03,-21.47,640.1
8439,74604471,2023-02-11,1096.1,1736.1999999999998
8438,74604471,2023-02-11,1199.0,2935.2000000000003
2143,74662976,2023-01-31,0.0,782.3
1899,74662976,2023-02-01,1634.7,2417.0
1900,74662976,2023-02-06,213.44,2630.44
8194,74662976,2023-02-09,-105.05,2525.3900000000003
8195,74662976,2023-02-11,-111.96,2413.4300000000003
8196,74662976,2023-02-14,-69.61,2343.8199999999997
2144,74703933,2023-01-31,0.0,321.42
1429,74703933,2023-02-01,239.72,561.14
2783,74703933,2023-02-02,-68.12,493.02
2784,74703933,2023-02-04,-157.05,335.97
1430,74703933,2023-02-04,58.74,394.71000000000004
1431,74703933,2023-02-07,949.2,1343.91
2785,74703933,2023-02-11,-152.17,1191.74
1432,74703933,2023-02-13,81.27,1273.01
2145,74709026,2023-01-31,0.0,465.39
4997,74709026,2023-02-04,-119.96,345.43
4998,74709026,2023-02-05,-53.54,291.89
8068,74709026,2023-02-09,58.09,349.98
4999,74709026,2023-02-11,-152.47,197.51
8069,74709026,2023-02-14,162.35,359.86
2146,74768567,2023-01-31,0.0,557.15
5750,74768567,2023-02-04,39.82,596.97
7710,74768567,2023-02-08,-58.95,538.02
7711,74768567,2023-02-10,-103.06,434.96
7712,74768567,2023-02-11,-119.83,315.13
2147,74770758,2023-01-31,0.0,643.52
963,74770758,2023-02-01,143.86,787.38
3477,74770758,2023-02-02,-507.1,280.28
964,74770758,2023-02-02,645.8,926.0799999999999
3478,74770758,2023-02-05,-23.74,902.3399999999999
3479,74770758,2023-02-07,-115.83,786.51
965,74770758,2023-02-07,27.88,814.3899999999999
966,74770758,2023-02-07,155.73,970.1199999999999
967,74770758,2023-02-10,119.83,1089.9499999999998
3480,74770758,2023-02-11,-62.47,1027.48
968,74770758,2023-02-13,39.74,1067.2199999999998
969,74770758,2023-02-13,180.81,1248.03
3482,74770758,2023-02-14,-541.0,707.03
3481,74770758,2023-02-14,-97.35,609.68
970,74770758,2023-02-14,90.79,700.47
2148,74822001,2023-01-31,0.0,673.61
4054,74822001,2023-02-03,113.25,786.86
4055,74822001,2023-02-04,84.91,871.77
4056,74822001,2023-02-06,157.11,1028.88
7706,74822001,2023-02-08,-42.88,986.0
2149,75000628,2023-01-31,0.0,117.33
4103,75000628,2023-02-03,-102.49,14.840000000000003
4104,75000628,2023-02-06,-967.8,-952.9599999999999
7380,75000628,2023-02-07,23.9,-929.0599999999998
7381,75000628,2023-02-07,111.95,-817.1099999999999
7382,75000628,2023-02-09,119.86,-697.2499999999999
4105,75000628,2023-02-11,-102.03,-799.28
7383,75000628,2023-02-11,160.56,-638.7199999999999
7384,75000628,2023-02-12,24.74,-613.9799999999999
4106,75000628,2023-02-14,-122.88,-736.8599999999999
2150,75004471,2023-01-31,0.0,435.54
7067,75004471,2023-02-06,-90.19,345.35
7068,75004471,2023-02-07,-71.12,274.23
7990,75004471,2023-02-09,161.19,435.42
7069,75004471,2023-02-10,-54.73,380.69
2151,75027308,2023-01-31,0.0,307.44
6033,75027308,2023-02-05,70.81,378.25
8605,75027308,2023-02-13,-21.73,356.52
8606,75027308,2023-02-14,-42.03,314.49
2152,75068844,2023-01-31,0.0,852.47
7407,75068844,2023-02-07,32.26,884.73
8154,75068844,2023-02-09,-174.92,709.8100000000001
8155,75068844,2023-02-10,-205.21,504.6
7408,75068844,2023-02-13,56.42,561.02
2153,75094093,2023-01-31,0.0,478.09
7931,75094093,2023-02-08,-66.58,411.51
7932,75094093,2023-02-10,-86.39,325.12
7933,75094093,2023-02-14,-120.62,204.49999999999994
2154,75134291,2023-01-31,0.0,903.25
7349,75134291,2023-02-07,905.3,1808.55
7918,75134291,2023-02-08,-137.66,1670.8899999999999
7350,75134291,2023-02-10,145.13,1816.02
7351,75134291,2023-02-11,63.08,1879.1
7352,75134291,2023-02-11,1677.5,3556.6
7919,75134291,2023-02-12,-1261.6,2295.0
7353,75134291,2023-02-13,138.85,2433.85
2155,75164598,2023-01-31,0.0,569.4
72,75164598,2023-02-01,84.96,654.36
73,75164598,2023-02-03,1529.4,2183.76
74,75164598,2023-02-13,83.87,2267.63
8682,75164598,2023-02-14,-130.44,2137.19
2156,75172199,2023-01-31,0.0,955.0
1898,75172199,2023-02-01,800.0,1755.0
6241,75172199,2023-02-05,-110.09,1644.9099999999999
6242,75172199,2023-02-10,-108.6,1536.31
6243,75172199,2023-02-14,-41.12,1495.19
2157,75205767,2023-01-31,0.0,113.75
1007,75205767,2023-02-01,12.5,126.25
4917,75205767,2023-02-03,-59.01,67.24000000000001
4918,75205767,2023-02-08,-26.82,40.42
1008,75205767,2023-02-09,117.38,157.8
1009,75205767,2023-02-10,964.8,1122.6
1010,75205767,2023-02-11,52.74,1175.34
4919,75205767,2023-02-12,-195.95,979.3899999999999
2158,75216128,2023-01-31,0.0,671.26
6542,75216128,2023-02-05,-51.76,619.5
6120,75216128,2023-02-05,848.7,1468.2
6543,75216128,2023-02-06,-50.86,1417.3400000000001
6544,75216128,2023-02-10,-113.81,1303.5300000000002
6121,75216128,2023-02-11,136.0,1439.53
6122,75216128,2023-02-13,37.31,1476.8400000000001
6123,75216128,2023-02-13,145.9,1622.74
6545,75216128,2023-02-14,-110.13,1512.6100000000001
2159,75223089,2023-01-31,0.0,557.48
3210,75223089,2023-02-02,-97.37,460.11
6738,75223089,2023-02-06,140.76,600.87
6739,75223089,2023-02-08,0.47,601.34
6740,75223089,2023-02-10,71.41,672.75
2160,75258542,2023-01-31,0.0,772.67
6901,75258542,2023-02-06,59.16,831.8299999999999
2161,75331062,2023-01-31,0.0,117.81
1813,75331062,2023-02-01,124.73,242.54000000000002
1815,75331062,2023-02-02,153.2,395.74
1814,75331062,2023-02-02,192.68,588.4200000000001
8188,75331062,2023-02-09,-103.8,484.62
1816,75331062,2023-02-10,76.32,560.94
1817,75331062,2023-02-12,168.57,729.51
1818,75331062,2023-02-12,182.63,912.1399999999999
2162,75355842,2023-01-31,0.0,621.95
2939,75355842,2023-02-02,-107.62,514.33
2940,75355842,2023-02-08,-167.23,347.1
2941,75355842,2023-02-13,-65.62,281.48
8626,75355842,2023-02-13,36.43,317.91
2163,75394177,2023-01-31,0.0,191.04
277,75394177,2023-02-01,-189.07,1.9699999999999989
1703,75394177,2023-02-01,212.26,214.23
1704,75394177,2023-02-05,84.35,298.58
278,75394177,2023-02-07,-96.08,202.5
279,75394177,2023-02-09,-67.76,134.73999999999998
280,75394177,2023-02-13,-12.26,122.47999999999998
2164,75428657,2023-01-31,0.0,455.8
2009,75428657,2023-02-01,96.14,551.94
2010,75428657,2023-02-04,72.24,624.1800000000001
6701,75428657,2023-02-06,-107.32,516.86
6700,75428657,2023-02-06,-89.47,427.39
6702,75428657,2023-02-07,-166.06,261.33000000000004
6703,75428657,2023-02-12,-133.04,128.29000000000002
2165,75468090,2023-01-31,0.0,984.92
3298,75468090,2023-02-02,-94.47,890.4499999999999
3299,75468090,2023-02-03,-110.96,779.49
6066,75468090,2023-02-05,143.3,922.79
3300,75468090,2023-02-06,-28.36,894.43
6067,75468090,2023-02-09,82.14,976.5699999999999
6068,75468090,2023-02-13,2264.3,3240.8700000000003
3301,75468090,2023-02-14,-156.02,3084.8500000000004
6069,75468090,2023-02-14,86.73,3171.5800000000004
2166,75551521,2023-01-31,0.0,538.64
875,75551521,2023-02-01,-170.89,367.75
876,75551521,2023-02-10,-175.95,191.8
877,75551521,2023-02-11,-40.81,150.99
2167,75553043,2023-01-31,0.0,669.59
1024,75553043,2023-02-01,-124.86,544.73
1025,75553043,2023-02-02,-66.42,478.31000000000006
1026,75553043,2023-02-07,-46.14,432.17
7832,75553043,2023-02-08,45.54,477.71000000000004
7833,75553043,2023-02-12,87.33,565.04
7834,75553043,2023-02-12,150.22,715.26
1028,75553043,2023-02-13,-156.04,559.22
1027,75553043,2023-02-13,-126.86,432.36
7835,75553043,2023-02-13,172.54,604.9000000000001
2168,75569387,2023-01-31,0.0,249.27
955,75569387,2023-02-01,1775.6,2024.87
4860,75569387,2023-02-03,-177.23,1847.6399999999999
956,75569387,2023-02-05,76.31,1923.9499999999998
4862,75569387,2023-02-08,-155.15,1768.8
4861,75569387,2023-02-08,-137.97,1630.83
957,75569387,2023-02-09,173.2,1804.03
4863,75569387,2023-02-10,-177.19,1626.84
958,75569387,2023-02-12,95.61,1722.4499999999998
2169,75573750,2023-01-31,0.0,159.92
680,75573750,2023-02-01,-614.1,-454.18000000000006
679,75573750,2023-02-01,-57.37,-511.55000000000007
8410,75573750,2023-02-11,95.68,-415.87
2170,75687743,2023-01-31,0.0,668.39
2493,75687743,2023-02-02,-121.53,546.86
2492,75687743,2023-02-02,-77.04,469.82
6734,75687743,2023-02-06,68.98,538.8
6735,75687743,2023-02-08,710.3,1249.1
2494,75687743,2023-02-13,-124.44,1124.6599999999999
2495,75687743,2023-02-13,-101.21,1023.4499999999999
2171,75692380,2023-01-31,0.0,477.28
7585,75692380,2023-02-07,13.71,490.98999999999995
7586,75692380,2023-02-12,76.48,567.47
2172,75696521,2023-01-31,0.0,660.34
2689,75696521,2023-02-02,151.37,811.71
5917,75696521,2023-02-04,-113.97,697.74
2690,75696521,2023-02-09,124.33,822.07
5918,75696521,2023-02-12,-443.1,378.97
2691,75696521,2023-02-13,105.96,484.93
2173,75747094,2023-01-31,0.0,289.48
841,75747094,2023-02-01,-108.17,181.31
842,75747094,2023-02-02,-111.34,69.97000000000003
844,75747094,2023-02-03,-170.7,-100.72999999999996
843,75747094,2023-02-03,-88.14,-188.86999999999995
845,75747094,2023-02-06,-179.08,-367.95000000000005
846,75747094,2023-02-07,-69.34,-437.28999999999996
847,75747094,2023-02-09,-24.49,-461.78
8035,75747094,2023-02-09,125.74,-336.03999999999996
848,75747094,2023-02-12,-1314.3,-1650.34
8037,75747094,2023-02-12,119.08,-1531.26
8036,75747094,2023-02-12,198.39,-1332.87
8038,75747094,2023-02-14,51.36,-1281.51
2174,75762044,2023-01-31,0.0,980.08
4114,75762044,2023-02-03,-117.47,862.61
6142,75762044,2023-02-05,80.83,943.44
6143,75762044,2023-02-05,617.7,1561.14
4115,75762044,2023-02-07,-1107.6,453.5400000000002
4116,75762044,2023-02-07,-79.53,374.0100000000002
4117,75762044,2023-02-08,-238.9,135.11000000000024
6144,75762044,2023-02-09,84.51,219.62000000000023
4119,75762044,2023-02-12,-94.0,125.62000000000023
4118,75762044,2023-02-12,-64.23,61.390000000000214
4120,75762044,2023-02-14,-87.33,-25.939999999999827
2175,75782714,2023-01-31,0.0,105.34
2850,75782714,2023-02-02,182.71,288.05
2851,75782714,2023-02-04,93.96,382.01
2852,75782714,2023-02-07,97.29,479.30000000000007
7852,75782714,2023-02-08,-58.82,420.48
2853,75782714,2023-02-11,53.59,474.07000000000005
2176,75839704,2023-01-31,0.0,202.34
7130,75839704,2023-02-06,59.6,261.94
8494,75839704,2023-02-11,-157.05,104.88999999999999
7131,75839704,2023-02-12,44.96,149.85
2177,75893682,2023-01-31,0.0,573.74
3722,75893682,2023-02-03,104.78,678.52
3723,75893682,2023-02-04,102.31,780.83
7828,75893682,2023-02-08,-105.88,674.95
3724,75893682,2023-02-09,148.56,823.51
2178,75925793,2023-01-31,0.0,425.69
1516,75925793,2023-02-01,107.97,533.66
4498,75925793,2023-02-03,-50.4,483.26
4499,75925793,2023-02-04,-87.65,395.61
4500,75925793,2023-02-11,-143.15,252.45999999999998
1517,75925793,2023-02-11,77.62,330.08
2179,75946768,2023-01-31,0.0,103.05
2175,75946768,2023-02-02,158.32,261.37
4382,75946768,2023-02-03,-121.58,139.79
4383,75946768,2023-02-04,-85.27,54.519999999999996
2176,75946768,2023-02-11,157.4,211.92000000000002
2180,75954317,2023-01-31,0.0,583.28
3284,75954317,2023-02-02,92.9,676.18
3285,75954317,2023-02-05,41.21,717.39
3286,75954317,2023-02-11,129.66,847.05
3288,75954317,2023-02-13,122.87,969.92
3287,75954317,2023-02-13,760.4,1730.32
3289,75954317,2023-02-14,85.66,1815.98
2181,75969874,2023-01-31,0.0,454.25
6090,75969874,2023-02-05,165.42,619.67
6091,75969874,2023-02-05,325.0,944.67
7926,75969874,2023-02-08,-42.92,901.75
6092,75969874,2023-02-09,48.05,949.8
2182,76078639,2023-01-31,0.0,318.17
61,76078639,2023-02-01,9.8,327.97
62,76078639,2023-02-06,154.69,482.66
63,76078639,2023-02-08,109.06,591.72
8209,76078639,2023-02-09,-25.58,566.1400000000001
2183,76096120,2023-01-31,0.0,996.6
1524,76096120,2023-02-01,-115.85,880.75
2438,76096120,2023-02-02,101.22,981.97
2437,76096120,2023-02-02,142.28,1124.25
2439,76096120,2023-02-03,85.29,1209.54
1525,76096120,2023-02-05,-142.12,1067.42
2440,76096120,2023-02-06,99.42,1166.8400000000001
1526,76096120,2023-02-13,-90.4,1076.44
2184,76099143,2023-01-31,0.0,525.4
2480,76099143,2023-02-02,-118.6,406.79999999999995
6502,76099143,2023-02-05,61.09,467.89
2481,76099143,2023-02-13,-53.33,414.56
2185,76122310,2023-01-31,0.0,985.6
8307,76122310,2023-02-10,-616.1,369.5
8411,76122310,2023-02-11,32.2,401.70000000000005
8412,76122310,2023-02-13,148.74,550.44
2186,76146870,2023-01-31,0.0,414.24
4029,76146870,2023-02-03,1278.2,1692.44
6696,76146870,2023-02-06,-165.65,1526.79
4030,76146870,2023-02-07,141.27,1668.0600000000002
4031,76146870,2023-02-07,168.17,1836.23
6697,76146870,2023-02-08,-86.36,1749.8700000000001
4032,76146870,2023-02-11,101.6,1851.47
6699,76146870,2023-02-14,-1053.5,797.97
6698,76146870,2023-02-14,-104.18,693.79
4033,76146870,2023-02-14,88.1,781.89
2187,76169332,2023-01-31,0.0,615.46
2781,76169332,2023-02-02,-1695.5,-1080.04
3362,76169332,2023-02-02,83.79,-996.25
2782,76169332,2023-02-03,-28.0,-1024.25
3363,76169332,2023-02-07,84.19,-940.06
2188,76206810,2023-01-31,0.0,887.63
0,76206810,2023-02-01,-128.78,758.85
1,76206810,2023-02-05,-104.42,654.4300000000001
8522,76206810,2023-02-12,104.78,759.21
8523,76206810,2023-02-12,108.81,868.02
8524,76206810,2023-02-14,37.74,905.76
2189,76245103,2023-01-31,0.0,814.75
7454,76245103,2023-02-07,171.4,986.15
7961,76245103,2023-02-08,-72.19,913.96
7962,76245103,2023-02-10,-108.64,805.32
7963,76245103,2023-02-11,-194.38,610.94
7964,76245103,2023-02-11,-126.42,484.52
7455,76245103,2023-02-14,64.58,549.1
2190,76256026,2023-01-31,0.0,36.71
703,76256026,2023-02-01,114.21,150.92
2269,76256026,2023-02-02,-122.54,28.37999999999999
2270,76256026,2023-02-03,-65.14,-36.76000000000001
704,76256026,2023-02-05,76.57,39.80999999999998
2271,76256026,2023-02-06,-583.7,-543.89
2272,76256026,2023-02-06,-91.5,-635.39
2273,76256026,2023-02-07,-62.85,-698.24
705,76256026,2023-02-08,154.47,-543.77
706,76256026,2023-02-09,125.05,-418.72
2274,76256026,2023-02-12,-107.03,-525.75
707,76256026,2023-02-12,1145.7,619.95
708,76256026,2023-02-12,1251.2,1871.15
2191,76257915,2023-01-31,0.0,795.66
5075,76257915,2023-02-04,87.08,882.74
5076,76257915,2023-02-05,108.03,990.77
7485,76257915,2023-02-07,-1236.7,-245.93000000000018
5077,76257915,2023-02-14,51.78,-194.14999999999998
2192,76273831,2023-01-31,0.0,866.62
3327,76273831,2023-02-02,49.14,915.76
4528,76273831,2023-02-03,-113.59,802.17
3328,76273831,2023-02-07,109.58,911.75
3329,76273831,2023-02-08,99.77,1011.52
4529,76273831,2023-02-12,-110.79,900.73
4530,76273831,2023-02-13,-124.45,776.28
3330,76273831,2023-02-14,129.25,905.53
2193,76318330,2023-01-31,0.0,710.56
1421,76318330,2023-02-01,-960.8,-250.24
1422,76318330,2023-02-03,-1.03,-251.26999999999998
1424,76318330,2023-02-04,-165.42,-416.69000000000005
1423,76318330,2023-02-04,-49.52,-466.21000000000004
5174,76318330,2023-02-04,41.13,-425.0799999999999
5175,76318330,2023-02-06,128.02,-297.05999999999995
5176,76318330,2023-02-06,405.7,108.63999999999999
5177,76318330,2023-02-14,156.27,264.90999999999997
2194,76336076,2023-01-31,0.0,288.71
7277,76336076,2023-02-07,109.43,398.14
8636,76336076,2023-02-13,-96.98,301.15999999999997
8637,76336076,2023-02-14,-1376.0,-1074.84
2195,76342664,2023-01-31,0.0,371.62
3982,76342664,2023-02-03,42.34,413.96000000000004
3983,76342664,2023-02-04,124.23,538.19
6358,76342664,2023-02-05,-44.51,493.68
3984,76342664,2023-02-12,100.06,593.74
2196,76343783,2023-01-31,0.0,42.36
3384,76343783,2023-02-02,133.38,175.74
3385,76343783,2023-02-08,1253.6,1429.34
3386,76343783,2023-02-10,113.56,1542.8999999999999
3387,76343783,2023-02-13,1505.7,3048.6
2197,76355557,2023-01-31,0.0,285.61
4588,76355557,2023-02-03,110.56,396.17
8359,76355557,2023-02-10,-206.97,189.20000000000002
4589,76355557,2023-02-10,65.54,254.74
4590,76355557,2023-02-11,184.5,439.24
8360,76355557,2023-02-13,-73.19,366.05
2198,76454427,2023-01-31,0.0,267.03
8146,76454427,2023-02-09,32.83,299.85999999999996
8147,76454427,2023-02-10,64.12,363.97999999999996
8509,76454427,2023-02-12,-170.4,193.57999999999998
2199,76470405,2023-01-31,0.0,606.3
1511,76470405,2023-02-01,120.13,726.43
2349,76470405,2023-02-02,-65.2,661.2299999999999
1512,76470405,2023-02-02,62.52,723.75
2350,76470405,2023-02-05,-41.21,682.54
1514,76470405,2023-02-05,104.2,786.74
1513,76470405,2023-02-05,175.68,962.42
2351,76470405,2023-02-07,-98.61,863.81
1515,76470405,2023-02-07,56.28,920.0899999999999
2352,76470405,2023-02-10,-116.06,804.03
2200,76474111,2023-01-31,0.0,563.43
1363,76474111,2023-02-01,88.99,652.42
6532,76474111,2023-02-05,-69.19,583.2299999999999
6533,76474111,2023-02-07,-17.39,565.8399999999999
1364,76474111,2023-02-07,173.35,739.1899999999999
6534,76474111,2023-02-09,-158.25,580.9399999999999
6535,76474111,2023-02-11,-73.94,506.99999999999994
1366,76474111,2023-02-12,85.9,592.9
1365,76474111,2023-02-12,109.6,702.5
1367,76474111,2023-02-14,626.8,1329.2999999999997
2201,76482858,2023-01-31,0.0,568.63
5309,76482858,2023-02-04,-1084.8,-516.17
6252,76482858,2023-02-05,124.61,-391.55999999999995
6253,76482858,2023-02-06,202.83,-188.7299999999999
6254,76482858,2023-02-07,1236.7,1047.9700000000003
5310,76482858,2023-02-08,-782.7,265.2700000000001
2202,76524911,2023-01-31,0.0,190.9
100,76524911,2023-02-01,-41.55,149.35000000000002
101,76524911,2023-02-05,-65.57,83.78000000000002
7680,76524911,2023-02-07,176.26,260.04
7681,76524911,2023-02-13,69.71,329.75
2203,76537084,2023-01-31,0.0,884.7
4667,76537084,2023-02-03,-86.49,798.21
4989,76537084,2023-02-03,77.14,875.35
4668,76537084,2023-02-05,-117.8,757.5500000000001
4990,76537084,2023-02-06,83.76,841.3100000000001
4991,76537084,2023-02-11,84.29,925.6
4669,76537084,2023-02-12,-76.36,849.24
4992,76537084,2023-02-13,76.58,925.82
2204,76546657,2023-01-31,0.0,434.77
3904,76546657,2023-02-03,-99.85,334.91999999999996
3905,76546657,2023-02-05,-122.25,212.67
3906,76546657,2023-02-06,-88.52,124.14999999999998
3908,76546657,2023-02-07,-85.6,38.55000000000001
3907,76546657,2023-02-07,-14.81,23.74000000000001
3909,76546657,2023-02-08,-1123.1,-1099.36
8061,76546657,2023-02-09,1363.6,264.24
8062,76546657,2023-02-10,209.84,474.08000000000004
2205,76629706,2023-01-31,0.0,962.66
5557,76629706,2023-02-04,52.76,1015.42
5556,76629706,2023-02-04,126.02,1141.44
5558,76629706,2023-02-07,105.66,1247.1
8202,76629706,2023-02-09,-158.66,1088.44
5559,76629706,2023-02-10,74.41,1162.85
2206,76662799,2023-01-31,0.0,296.68
1072,76662799,2023-02-01,-84.07,212.61
1073,76662799,2023-02-04,-76.66,135.95000000000002
1074,76662799,2023-02-06,-77.47,58.48000000000002
1075,76662799,2023-02-08,-67.17,-8.689999999999998
7756,76662799,2023-02-08,60.7,52.01000000000002
7757,76662799,2023-02-09,70.71,122.72000000000003
1076,76662799,2023-02-10,-1394.1,-1271.3799999999999
7758,76662799,2023-02-14,95.2,-1176.1799999999998
2207,76698056,2023-01-31,0.0,827.36
2413,76698056,2023-02-02,98.37,925.73
2412,76698056,2023-02-02,111.34,1037.07
2414,76698056,2023-02-02,206.91,1243.98
2415,76698056,2023-02-03,9.03,1253.01
7625,76698056,2023-02-07,-124.31,1128.7
2416,76698056,2023-02-07,84.97,1213.67
2417,76698056,2023-02-08,221.0,1434.67
2208,76720959,2023-01-31,0.0,436.06
5784,76720959,2023-02-04,100.63,536.69
5785,76720959,2023-02-05,93.03,629.72
5786,76720959,2023-02-07,93.88,723.5999999999999
8229,76720959,2023-02-10,-166.54,557.06
5787,76720959,2023-02-13,133.35,690.41
2209,76787359,2023-01-31,0.0,386.73
4171,76787359,2023-02-03,-110.59,276.14
4499,76787359,2023-02-03,116.55,392.69
4500,76787359,2023-02-04,1398.7,1791.39
4172,76787359,2023-02-06,-61.92,1729.47
4173,76787359,2023-02-07,-808.1,921.3700000000001
4174,76787359,2023-02-07,-151.4,769.9700000000001
4501,76787359,2023-02-08,154.93,924.9000000000001
2210,76799768,2023-01-31,0.0,981.08
486,76799768,2023-02-01,-77.81,903.27
487,76799768,2023-02-03,-644.3,258.97000000000014
488,76799768,2023-02-03,-100.81,158.1600000000002
4521,76799768,2023-02-03,50.4,208.56000000000017
4523,76799768,2023-02-04,49.53,258.09000000000015
4524,76799768,2023-02-04,53.8,311.8900000000001
4522,76799768,2023-02-04,73.93,385.82000000000016
489,76799768,2023-02-06,-71.52,314.3000000000002
4525,76799768,2023-02-09,81.65,395.95000000000016
4526,76799768,2023-02-14,55.79,451.7400000000001
2211,76847816,2023-01-31,0.0,197.8
1563,76847816,2023-02-01,-129.39,68.41000000000003
1564,76847816,2023-02-01,-16.06,52.35000000000002
1565,76847816,2023-02-02,-699.5,-647.1500000000001
4867,76847816,2023-02-03,1259.6,612.4499999999998
1566,76847816,2023-02-07,-1282.4,-669.9500000000003
4868,76847816,2023-02-09,160.1,-509.8500000000002
4869,76847816,2023-02-10,115.98,-393.8700000000002
1567,76847816,2023-02-12,-92.93,-486.80000000000024
4870,76847816,2023-02-12,1268.1,781.2999999999997
1568,76847816,2023-02-13,-67.88,713.4199999999996
2212,76857747,2023-01-31,0.0,952.88
5771,76857747,2023-02-04,-122.06,830.8199999999999
5770,76857747,2023-02-04,-63.46,767.36
5772,76857747,2023-02-05,-70.81,696.55
7052,76857747,2023-02-06,112.33,808.88
7053,76857747,2023-02-07,97.82,906.6999999999999
7054,76857747,2023-02-08,117.22,1023.92
7055,76857747,2023-02-09,107.22,1131.1399999999999
7056,76857747,2023-02-10,205.21,1336.35
7057,76857747,2023-02-11,75.48,1411.83
7058,76857747,2023-02-12,122.61,1534.44
2213,76869201,2023-01-31,0.0,515.62
397,76869201,2023-02-01,-98.26,417.36
398,76869201,2023-02-04,-149.33,268.03
399,76869201,2023-02-05,-84.35,183.68
8039,76869201,2023-02-09,1485.0,1668.6799999999998
400,76869201,2023-02-12,-128.28,1540.4
401,76869201,2023-02-14,-20.41,1519.9899999999998
2214,76869375,2023-01-31,0.0,894.84
250,76869375,2023-02-01,41.18,936.02
249,76869375,2023-02-01,92.35,1028.3700000000001
3156,76869375,2023-02-02,-103.03,925.34
251,76869375,2023-02-03,141.16,1066.5
252,76869375,2023-02-04,96.31,1162.81
3157,76869375,2023-02-05,-54.79,1108.02
3158,76869375,2023-02-06,-82.75,1025.27
253,76869375,2023-02-13,148.17,1173.44
2215,76953050,2023-01-31,0.0,453.1
5425,76953050,2023-02-04,-89.97,363.13
6076,76953050,2023-02-05,129.47,492.6
6077,76953050,2023-02-09,39.39,531.99
6078,76953050,2023-02-10,102.06,634.05
6079,76953050,2023-02-14,120.54,754.59
2216,77010964,2023-01-31,0.0,899.11
6339,77010964,2023-02-05,91.81,990.9200000000001
6340,77010964,2023-02-07,57.25,1048.17
8297,77010964,2023-02-10,-116.67,931.5
8298,77010964,2023-02-11,-70.24,861.26
6341,77010964,2023-02-11,85.0,946.26
2217,77017650,2023-01-31,0.0,699.24
170,77017650,2023-02-01,-103.04,596.2
5004,77017650,2023-02-03,121.15,717.35
171,77017650,2023-02-04,-92.05,625.3
5005,77017650,2023-02-07,38.41,663.71
5006,77017650,2023-02-07,121.9,785.61
172,77017650,2023-02-08,-104.18,681.4300000000001
5007,77017650,2023-02-08,96.4,777.83
174,77017650,2023-02-12,-95.8,682.03
173,77017650,2023-02-12,-57.5,624.53
175,77017650,2023-02-13,-56.42,568.11
5008,77017650,2023-02-13,98.44,666.55
176,77017650,2023-02-14,-116.74,549.81
177,77017650,2023-02-14,-49.55,500.26
5009,77017650,2023-02-14,113.46,613.72
2218,77026279,2023-01-31,0.0,126.05
6036,77026279,2023-02-05,-39.2,86.85
6894,77026279,2023-02-06,101.4,188.25
6895,77026279,2023-02-08,36.78,225.03
6037,77026279,2023-02-09,-105.04,119.99
6896,77026279,2023-02-12,1640.8,1760.79
6038,77026279,2023-02-13,-136.98,1623.81
6897,77026279,2023-02-13,101.58,1725.3899999999999
2219,77207452,2023-01-31,0.0,696.83
5086,77207452,2023-02-04,35.68,732.51
5084,77207452,2023-02-04,65.13,797.6400000000001
5085,77207452,2023-02-04,104.45,902.09
8041,77207452,2023-02-09,-77.75,824.34
8042,77207452,2023-02-10,-1975.6,-1151.2599999999998
8043,77207452,2023-02-10,-104.39,-1255.65
8044,77207452,2023-02-11,-531.4,-1787.0500000000002
8045,77207452,2023-02-11,-482.1,-2269.15
5087,77207452,2023-02-11,150.26,-2118.89
2220,77241606,2023-01-31,0.0,761.38
2295,77241606,2023-02-02,-106.05,655.33
2296,77241606,2023-02-07,-97.26,558.0699999999999
7599,77241606,2023-02-07,174.77,732.84
2297,77241606,2023-02-08,-84.11,648.73
2298,77241606,2023-02-09,-5.59,643.14
7600,77241606,2023-02-12,77.9,721.04
7601,77241606,2023-02-12,141.01,862.05
2221,77243259,2023-01-31,0.0,614.86
395,77243259,2023-02-01,-106.89,507.97
1871,77243259,2023-02-01,86.97,594.94
1872,77243259,2023-02-02,86.62,681.5600000000001
396,77243259,2023-02-08,-164.7,516.86
1873,77243259,2023-02-08,97.07,613.9300000000001
1874,77243259,2023-02-10,90.2,704.13
1875,77243259,2023-02-12,123.95,828.08
2222,77289104,2023-01-31,0.0,737.08
4536,77289104,2023-02-03,145.14,882.22
4537,77289104,2023-02-06,134.08,1016.3000000000001
4538,77289104,2023-02-07,67.04,1083.3400000000001
8306,77289104,2023-02-10,-148.04,935.3000000000001
4539,77289104,2023-02-13,93.21,1028.51
2223,77342574,2023-01-31,0.0,907.34
1956,77342574,2023-02-01,-115.41,791.9300000000001
1957,77342574,2023-02-02,-1774.7,-982.7700000000001
1959,77342574,2023-02-02,-1666.0,-2648.77
1958,77342574,2023-02-02,-132.64,-2781.41
2976,77342574,2023-02-02,24.05,-2757.36
1960,77342574,2023-02-04,-127.8,-2885.16
1961,77342574,2023-02-10,-187.69,-3072.85
2977,77342574,2023-02-13,211.13,-2861.72
1962,77342574,2023-02-14,-130.66,-2992.38
1963,77342574,2023-02-14,-40.73,-3033.11
2978,77342574,2023-02-14,114.72,-2918.39
2224,77377150,2023-01-31,0.0,673.03
1437,77377150,2023-02-01,-8.07,664.9599999999999
1438,77377150,2023-02-06,-144.03,520.93
1439,77377150,2023-02-08,-112.44,408.49
1440,77377150,2023-02-11,-139.56,268.92999999999995
1441,77377150,2023-02-12,-791.8,-522.8700000000001
2225,77379844,2023-01-31,0.0,32.65
3196,77379844,2023-02-02,55.08,87.72999999999999
3916,77379844,2023-02-03,-139.16,-51.43
3917,77379844,2023-02-04,-137.7,-189.12999999999997
3197,77379844,2023-02-06,136.6,-52.52999999999998
3918,77379844,2023-02-13,-37.83,-90.35999999999999
2226,77387016,2023-01-31,0.0,894.34
5972,77387016,2023-02-05,505.0,1399.3400000000001
5973,77387016,2023-02-14,707.3,2106.64
2227,77418940,2023-01-31,0.0,263.71
4653,77418940,2023-02-03,159.42,423.13
4654,77418940,2023-02-04,127.76,550.89
6520,77418940,2023-02-05,-83.83,467.05999999999995
6521,77418940,2023-02-05,-37.76,429.29999999999995
4655,77418940,2023-02-10,92.09,521.39
6522,77418940,2023-02-11,-187.53,333.86
6523,77418940,2023-02-11,-130.61,203.24999999999997
6524,77418940,2023-02-11,-80.51,122.73999999999995
4656,77418940,2023-02-11,1012.8,1135.54
2228,77447018,2023-01-31,0.0,754.64
4312,77447018,2023-02-03,-56.34,698.3
4314,77447018,2023-02-08,-163.05,535.25
4313,77447018,2023-02-08,-59.47,475.78
4315,77447018,2023-02-10,-123.76,352.02
8358,77447018,2023-02-10,159.2,511.21999999999997
4317,77447018,2023-02-11,-147.81,363.40999999999997
4316,77447018,2023-02-11,-50.07,313.34
2229,77504884,2023-01-31,0.0,221.03
1745,77504884,2023-02-01,695.3,916.3299999999999
1746,77504884,2023-02-07,122.99,1039.32
7833,77504884,2023-02-08,-43.89,995.43
1748,77504884,2023-02-08,92.11,1087.54
1747,77504884,2023-02-08,108.51,1196.05
7834,77504884,2023-02-12,-118.61,1077.44
7835,77504884,2023-02-12,-51.05,1026.3899999999999
2230,77551209,2023-01-31,0.0,7.33
5833,77551209,2023-02-04,1795.8,1803.1299999999999
6626,77551209,2023-02-05,-69.16,1733.9699999999998
5835,77551209,2023-02-09,136.79,1870.7599999999998
5834,77551209,2023-02-09,666.4,2537.16
6627,77551209,2023-02-11,-573.2,1963.9599999999998
6628,77551209,2023-02-13,-104.56,1859.3999999999999
2231,77554032,2023-01-31,0.0,646.5
3702,77554032,2023-02-02,-124.34,522.16
2751,77554032,2023-02-02,45.75,567.91
2752,77554032,2023-02-04,58.86,626.77
3703,77554032,2023-02-07,-1029.9,-403.1300000000001
3704,77554032,2023-02-07,-198.21,-601.3400000000001
3706,77554032,2023-02-10,-101.72,-703.0600000000002
3705,77554032,2023-02-10,-23.96,-727.0200000000002
2232,77587664,2023-01-31,0.0,769.43
5153,77587664,2023-02-04,-72.49,696.9399999999999
5154,77587664,2023-02-05,-90.66,606.28
6786,77587664,2023-02-06,51.05,657.3299999999999
6785,77587664,2023-02-06,154.81,812.14
5155,77587664,2023-02-07,-33.35,778.79
5156,77587664,2023-02-09,-89.39,689.4
6787,77587664,2023-02-12,72.94,762.3399999999999
2233,77646359,2023-01-31,0.0,434.93
8445,77646359,2023-02-11,43.47,478.4
2234,77668890,2023-01-31,0.0,804.88
2824,77668890,2023-02-02,-103.44,701.44
2825,77668890,2023-02-03,-101.3,600.14
4678,77668890,2023-02-03,590.1,1190.24
2826,77668890,2023-02-05,-149.93,1040.31
2827,77668890,2023-02-10,-120.91,919.4
2828,77668890,2023-02-11,-174.4,745.0
2829,77668890,2023-02-13,-98.34,646.66
2830,77668890,2023-02-14,-33.09,613.5699999999999
2831,77668890,2023-02-14,-18.83,594.74
4680,77668890,2023-02-14,18.83,613.5699999999999
4679,77668890,2023-02-14,132.75,746.3199999999999
2235,77688406,2023-01-31,0.0,224.2
6162,77688406,2023-02-05,49.84,274.03999999999996
7159,77688406,2023-02-06,-16.5,257.53999999999996
6163,77688406,2023-02-07,1516.3,1773.84
7160,77688406,2023-02-08,-140.07,1633.77
6164,77688406,2023-02-10,95.08,1728.85
7161,77688406,2023-02-14,-101.1,1627.75
2236,77717508,2023-01-31,0.0,493.27
610,77717508,2023-02-01,-173.96,319.30999999999995
611,77717508,2023-02-03,-73.31,245.99999999999997
5289,77717508,2023-02-04,119.83,365.83
5290,77717508,2023-02-12,99.41,465.23999999999995
5292,77717508,2023-02-12,110.26,575.5
5291,77717508,2023-02-12,125.62,701.12
2237,77722115,2023-01-31,0.0,735.94
1793,77722115,2023-02-01,-160.76,575.1800000000001
1794,77722115,2023-02-02,-130.9,444.2800000000001
4777,77722115,2023-02-03,129.36,573.6400000000001
1795,77722115,2023-02-05,-138.32,435.32000000000005
4778,77722115,2023-02-05,80.56,515.8800000000001
4779,77722115,2023-02-05,92.6,608.48
4780,77722115,2023-02-06,134.96,743.44
1796,77722115,2023-02-07,-204.81,538.6300000000001
4781,77722115,2023-02-09,178.61,717.2400000000001
1797,77722115,2023-02-14,-142.86,574.3800000000001
2238,77737443,2023-01-31,0.0,220.7
4086,77737443,2023-02-03,-115.87,104.82999999999998
4087,77737443,2023-02-04,-187.19,-82.36000000000001
6861,77737443,2023-02-06,103.08,20.71999999999997
6862,77737443,2023-02-07,44.02,64.73999999999998
6863,77737443,2023-02-11,73.94,138.67999999999998
6864,77737443,2023-02-12,11.78,150.45999999999998
6865,77737443,2023-02-12,93.78,244.23999999999998
2239,77792490,2023-01-31,0.0,822.76
1500,77792490,2023-02-01,-150.38,672.38
4558,77792490,2023-02-03,122.22,794.6
1501,77792490,2023-02-04,-133.46,661.14
1502,77792490,2023-02-04,-123.43,537.71
4559,77792490,2023-02-06,124.17,661.88
1503,77792490,2023-02-11,-92.62,569.26
1504,77792490,2023-02-11,-89.5,479.76
4560,77792490,2023-02-12,132.28,612.04
4561,77792490,2023-02-13,111.75,723.79
2240,77797288,2023-01-31,0.0,199.97
3491,77797288,2023-02-02,-68.63,131.34
6137,77797288,2023-02-05,1852.7,1984.0400000000002
3492,77797288,2023-02-12,-108.19,1875.85
6138,77797288,2023-02-12,1808.9,3684.7499999999995
2241,77802960,2023-01-31,0.0,157.47
6713,77802960,2023-02-06,-156.97,0.5
6714,77802960,2023-02-07,-106.8,-106.29999999999998
8679,77802960,2023-02-14,140.97,34.66999999999999
2242,77838890,2023-01-31,0.0,951.16
1582,77838890,2023-02-01,85.61,1036.77
1583,77838890,2023-02-10,812.8,1849.57
8477,77838890,2023-02-11,-11.3,1838.27
1584,77838890,2023-02-13,101.4,1939.67
1585,77838890,2023-02-14,56.24,1995.9099999999999
2243,77841390,2023-01-31,0.0,673.82
5734,77841390,2023-02-04,-81.91,591.9100000000001
5735,77841390,2023-02-07,-98.66,493.25000000000006
7741,77841390,2023-02-08,1908.7,2401.9500000000003
5736,77841390,2023-02-12,-151.37,2250.5800000000004
5737,77841390,2023-02-13,-61.83,2188.75
5738,77841390,2023-02-14,-44.44,2144.31
2244,77847751,2023-01-31,0.0,850.14
8038,77847751,2023-02-09,-74.39,775.75
8039,77847751,2023-02-10,-195.79,579.96
8649,77847751,2023-02-13,26.0,605.96
8040,77847751,2023-02-14,-302.7,303.26
2245,77867306,2023-01-31,0.0,907.96
6798,77867306,2023-02-06,-168.93,739.03
6799,77867306,2023-02-09,-787.2,-48.17000000000007
6800,77867306,2023-02-09,-190.68,-238.85000000000014
6801,77867306,2023-02-11,-851.2,-1090.0500000000002
8604,77867306,2023-02-12,76.15,-1013.9000000000001
6802,77867306,2023-02-14,-69.99,-1083.89
2246,77880852,2023-01-31,0.0,550.69
2578,77880852,2023-02-02,179.67,730.36
4637,77880852,2023-02-03,-113.03,617.33
2579,77880852,2023-02-04,55.7,673.0300000000001
2580,77880852,2023-02-04,1649.2,2322.23
4638,77880852,2023-02-06,-140.03,2182.2
2581,77880852,2023-02-07,81.45,2263.65
4639,77880852,2023-02-10,-103.62,2160.0299999999997
2582,77880852,2023-02-10,47.22,2207.25
2583,77880852,2023-02-12,68.38,2275.63
2247,77911836,2023-01-31,0.0,87.75
3053,77911836,2023-02-02,-51.61,36.14
3054,77911836,2023-02-03,-622.9,-586.76
3750,77911836,2023-02-03,46.29,-540.47
3055,77911836,2023-02-06,-114.33,-654.8
3751,77911836,2023-02-08,99.5,-555.3
2248,77913078,2023-01-31,0.0,885.96
709,77913078,2023-02-01,14.22,900.1800000000001
710,77913078,2023-02-02,93.5,993.6800000000001
4975,77913078,2023-02-03,-193.29,800.3900000000001
711,77913078,2023-02-10,43.52,843.9100000000001
712,77913078,2023-02-12,154.82,998.73
2249,77917083,2023-01-31,0.0,929.41
5465,77917083,2023-02-04,135.89,1065.3
6374,77917083,2023-02-05,-78.8,986.5
5466,77917083,2023-02-08,1119.6,2106.1
2250,77931114,2023-01-31,0.0,480.52
578,77931114,2023-02-01,57.95,538.47
579,77931114,2023-02-05,64.41,602.88
6936,77931114,2023-02-06,-67.96,534.92
6937,77931114,2023-02-07,-99.87,435.04999999999995
6938,77931114,2023-02-09,-82.99,352.06
6939,77931114,2023-02-11,-181.51,170.55
6940,77931114,2023-02-12,-1041.9,-871.3500000000001
2251,77966293,2023-01-31,0.0,904.28
4221,77966293,2023-02-03,-77.0,827.28
5372,77966293,2023-02-04,44.5,871.78
5373,77966293,2023-02-05,81.21,952.99
5374,77966293,2023-02-06,22.54,975.53
5375,77966293,2023-02-08,96.66,1072.19
5376,77966293,2023-02-08,132.99,1205.1799999999998
4222,77966293,2023-02-12,-134.41,1070.77
4223,77966293,2023-02-13,-81.41,989.36
5377,77966293,2023-02-14,100.41,1089.77
2252,77980498,2023-01-31,0.0,893.87
105,77980498,2023-02-01,-102.31,791.56
106,77980498,2023-02-01,-81.36,710.2
107,77980498,2023-02-01,-50.55,659.65
108,77980498,2023-02-04,-46.96,612.69
8285,77980498,2023-02-10,819.0,1431.69
8286,77980498,2023-02-11,36.07,1467.76
2253,78004131,2023-01-31,0.0,723.24
94,78004131,2023-02-01,-34.17,689.07
95,78004131,2023-02-04,-37.75,651.32
96,78004131,2023-02-07,-12.69,638.63
97,78004131,2023-02-08,-1245.5,-606.8699999999999
8265,78004131,2023-02-10,156.94,-449.92999999999984
2254,78047487,2023-01-31,0.0,417.33
8600,78047487,2023-02-13,-61.15,356.18
2255,78065026,2023-01-31,0.0,356.26
2832,78065026,2023-02-02,-80.01,276.25
2833,78065026,2023-02-05,-41.55,234.7
2834,78065026,2023-02-07,-75.46,159.24
7970,78065026,2023-02-09,38.34,197.57999999999998
2835,78065026,2023-02-13,-194.21,3.3700000000000045
2256,78072161,2023-01-31,0.0,914.19
1309,78072161,2023-02-01,-76.69,837.5
4214,78072161,2023-02-03,70.99,908.49
1310,78072161,2023-02-05,-175.05,733.44
1311,78072161,2023-02-06,-118.48,614.96
4215,78072161,2023-02-07,111.08,726.0400000000001
1312,78072161,2023-02-11,-102.26,623.78
2257,78076137,2023-01-31,0.0,290.47
641,78076137,2023-02-01,128.93,419.40000000000003
2815,78076137,2023-02-02,-45.75,373.65000000000003
2816,78076137,2023-02-04,-130.12,243.53000000000003
642,78076137,2023-02-04,1231.2,1474.73
2817,78076137,2023-02-05,-357.9,1116.83
2818,78076137,2023-02-10,-171.22,945.61
643,78076137,2023-02-12,78.91,1024.52
2819,78076137,2023-02-13,-734.3,290.22
644,78076137,2023-02-13,115.5,405.72
2258,78129803,2023-01-31,0.0,233.76
4926,78129803,2023-02-03,-168.33,65.42999999999998
3955,78129803,2023-02-03,38.61,104.03999999999996
3956,78129803,2023-02-05,540.8,644.8399999999999
4927,78129803,2023-02-08,-154.46,490.3799999999999
3957,78129803,2023-02-11,35.03,525.4099999999999
4928,78129803,2023-02-12,-122.36,403.0499999999999
3958,78129803,2023-02-12,146.81,549.8599999999999
4929,78129803,2023-02-13,-79.84,470.01999999999987
4930,78129803,2023-02-13,-41.75,428.26999999999987
2259,78133064,2023-01-31,0.0,103.96
2526,78133064,2023-02-02,-156.52,-52.56000000000002
2763,78133064,2023-02-02,103.44,50.87999999999998
2764,78133064,2023-02-03,1935.5,1986.38
2765,78133064,2023-02-10,129.69,2116.07
2527,78133064,2023-02-12,-100.06,2016.0100000000002
2767,78133064,2023-02-12,149.27,2165.28
2766,78133064,2023-02-12,177.52,2342.8
2260,78167719,2023-01-31,0.0,969.06
3968,78167719,2023-02-03,-130.91,838.15
4766,78167719,2023-02-03,53.43,891.5799999999999
4767,78167719,2023-02-04,71.57,963.15
4768,78167719,2023-02-04,944.5,1907.65
3969,78167719,2023-02-07,-84.81,1822.84
4769,78167719,2023-02-07,142.95,1965.79
3970,78167719,2023-02-09,-63.95,1901.84
3971,78167719,2023-02-14,-147.72,1754.12
3972,78167719,2023-02-14,-110.42,1643.6999999999998
3973,78167719,2023-02-14,-97.06,1546.6399999999999
2261,78175956,2023-01-31,0.0,124.55
2457,78175956,2023-02-02,114.44,238.99
5224,78175956,2023-02-04,-74.84,164.14999999999998
2458,78175956,2023-02-06,106.31,270.46
5225,78175956,2023-02-09,-10.05,260.40999999999997
5226,78175956,2023-02-14,-61.34,199.07
2262,78184766,2023-01-31,0.0,98.1
6505,78184766,2023-02-05,-109.41,-11.310000000000002
6506,78184766,2023-02-08,-68.63,-79.94
7739,78184766,2023-02-08,43.9,-36.03999999999999
6507,78184766,2023-02-10,-75.51,-111.55000000000001
6508,78184766,2023-02-12,-76.71,-188.26000000000002
2263,78234498,2023-01-31,0.0,697.88
1212,78234498,2023-02-01,69.18,767.06
1213,78234498,2023-02-04,1369.6,2136.66
1214,78234498,2023-02-13,112.88,2249.54
2264,78257880,2023-01-31,0.0,933.22
4281,78257880,2023-02-03,97.96,1031.18
4279,78257880,2023-02-03,180.52,1211.7
4280,78257880,2023-02-03,753.5,1965.2
4282,78257880,2023-02-08,151.47,2116.67
8136,78257880,2023-02-09,-587.9,1528.77
4283,78257880,2023-02-09,548.3,2077.0699999999997
8137,78257880,2023-02-10,-31.28,2045.79
2265,78268704,2023-01-31,0.0,888.99
6231,78268704,2023-02-05,141.36,1030.35
6230,78268704,2023-02-05,997.4,2027.75
6232,78268704,2023-02-06,431.9,2459.6499999999996
7210,78268704,2023-02-07,-86.16,2373.49
7209,78268704,2023-02-07,-26.33,2347.16
7211,78268704,2023-02-13,-24.32,2322.84
2266,78296743,2023-01-31,0.0,406.97
1515,78296743,2023-02-01,-1888.2,-1481.23
1516,78296743,2023-02-02,-108.67,-1589.9
1517,78296743,2023-02-07,-94.27,-1684.1699999999998
1518,78296743,2023-02-08,-154.6,-1838.7700000000002
1519,78296743,2023-02-08,-36.72,-1875.49
7805,78296743,2023-02-08,96.34,-1779.1499999999999
1520,78296743,2023-02-09,-103.44,-1882.59
1522,78296743,2023-02-10,-143.84,-2026.43
1521,78296743,2023-02-10,-66.19,-2092.62
1523,78296743,2023-02-13,-334.9,-2427.5199999999995
7806,78296743,2023-02-13,62.36,-2365.16
2267,78303304,2023-01-31,0.0,921.4
4196,78303304,2023-02-03,-108.32,813.0799999999999
4197,78303304,2023-02-06,-91.58,721.5
7840,78303304,2023-02-08,130.43,851.9300000000001
2268,78343618,2023-01-31,0.0,30.43
726,78343618,2023-02-01,9.32,39.75
725,78343618,2023-02-01,80.43,120.18
3246,78343618,2023-02-02,-1193.3,-1073.12
727,78343618,2023-02-02,72.9,-1000.2199999999999
3247,78343618,2023-02-03,-1632.0,-2632.22
728,78343618,2023-02-08,107.47,-2524.75
729,78343618,2023-02-13,164.76,-2359.9900000000002
2269,78362587,2023-01-31,0.0,390.79
1284,78362587,2023-02-01,-1292.5,-901.71
1285,78362587,2023-02-02,-1499.9,-2401.61
3145,78362587,2023-02-02,142.45,-2259.1600000000003
1286,78362587,2023-02-04,-1510.5,-3769.66
1287,78362587,2023-02-04,-66.32,-3835.9800000000005
3146,78362587,2023-02-04,1266.4,-2569.58
1288,78362587,2023-02-07,-136.3,-2705.88
1289,78362587,2023-02-10,-25.41,-2731.29
3147,78362587,2023-02-10,35.64,-2695.65
1290,78362587,2023-02-12,-118.77,-2814.42
2270,78392456,2023-01-31,0.0,592.04
2196,78392456,2023-02-02,123.8,715.8399999999999
5149,78392456,2023-02-04,-41.13,674.7099999999999
2197,78392456,2023-02-05,65.73,740.4399999999999
5150,78392456,2023-02-07,-71.99,668.4499999999999
2198,78392456,2023-02-09,158.77,827.22
5151,78392456,2023-02-10,-222.4,604.8199999999999
2200,78392456,2023-02-11,94.31,699.13
2199,78392456,2023-02-11,205.44,904.5699999999999
2201,78392456,2023-02-12,108.51,1013.0799999999999
5152,78392456,2023-02-13,-42.54,970.54
2271,78395863,2023-01-31,0.0,458.24
1497,78395863,2023-02-01,168.34,626.58
2475,78395863,2023-02-02,-101.46,525.12
1498,78395863,2023-02-02,379.5,904.62
2476,78395863,2023-02-03,-153.58,751.04
2477,78395863,2023-02-09,-49.68,701.36
1499,78395863,2023-02-10,85.31,786.67
2478,78395863,2023-02-11,-126.78,659.89
2479,78395863,2023-02-12,-1619.3,-959.4100000000001
1500,78395863,2023-02-13,177.52,-781.8899999999999
2272,78493642,2023-01-31,0.0,748.98
3523,78493642,2023-02-02,-103.47,645.51
3524,78493642,2023-02-02,-54.11,591.4000000000001
2380,78493642,2023-02-02,53.59,644.99
2382,78493642,2023-02-07,65.6,710.59
2381,78493642,2023-02-07,113.23,823.82
2383,78493642,2023-02-07,185.02,1008.84
2384,78493642,2023-02-09,134.78,1143.62
2385,78493642,2023-02-10,167.69,1311.31
2386,78493642,2023-02-13,161.8,1473.1100000000001
2273,78501355,2023-01-31,0.0,910.42
5474,78501355,2023-02-04,1610.8,2521.22
5475,78501355,2023-02-07,210.28,2731.5
5476,78501355,2023-02-10,1038.8,3770.3
2274,78541427,2023-01-31,0.0,366.51
4447,78541427,2023-02-03,718.2,1084.71
7023,78541427,2023-02-06,-1751.6,-666.8899999999999
7022,78541427,2023-02-06,-981.9,-1648.7899999999997
4448,78541427,2023-02-07,76.58,-1572.2099999999998
7024,78541427,2023-02-09,-32.87,-1605.08
4449,78541427,2023-02-13,116.3,-1488.78
7025,78541427,2023-02-14,-95.3,-1584.08
2275,78580221,2023-01-31,0.0,271.94
175,78580221,2023-02-01,105.16,377.1
7048,78580221,2023-02-06,-121.13,255.97
7049,78580221,2023-02-12,-197.29,58.68000000000001
7050,78580221,2023-02-12,-96.6,-37.920000000000016
176,78580221,2023-02-14,119.48,81.56
2276,78584818,2023-01-31,0.0,723.21
3041,78584818,2023-02-02,122.42,845.63
3042,78584818,2023-02-03,119.02,964.6500000000001
3043,78584818,2023-02-07,124.55,1089.2
8206,78584818,2023-02-09,-56.03,1033.17
2277,78667134,2023-01-31,0.0,672.23
3178,78667134,2023-02-02,-93.09,579.14
3179,78667134,2023-02-03,-135.44,443.70000000000005
5081,78667134,2023-02-04,39.71,483.41
5082,78667134,2023-02-04,153.31,636.72
3180,78667134,2023-02-08,-97.07,539.6500000000001
3181,78667134,2023-02-13,-55.07,484.58000000000004
5083,78667134,2023-02-13,77.77,562.35
3182,78667134,2023-02-14,-68.56,493.79
2278,78673350,2023-01-31,0.0,307.25
4932,78673350,2023-02-03,74.72,381.97
4933,78673350,2023-02-08,112.44,494.40999999999997
8076,78673350,2023-02-09,-137.17,357.24
4934,78673350,2023-02-14,18.62,375.86
2279,78716149,2023-01-31,0.0,658.83
1317,78716149,2023-02-01,-49.84,608.99
1318,78716149,2023-02-02,-184.29,424.70000000000005
6838,78716149,2023-02-06,38.7,463.40000000000003
6839,78716149,2023-02-08,40.13,503.5300000000001
1319,78716149,2023-02-10,-106.03,397.50000000000006
6840,78716149,2023-02-14,85.81,483.31000000000006
2280,78767161,2023-01-31,0.0,248.42
1442,78767161,2023-02-01,-115.41,133.01
1443,78767161,2023-02-02,-133.59,-0.5800000000000125
3201,78767161,2023-02-02,22.54,21.95999999999998
1444,78767161,2023-02-05,-185.3,-163.34
1445,78767161,2023-02-06,-69.84,-233.18000000000004
3202,78767161,2023-02-06,8.04,-225.14000000000001
3203,78767161,2023-02-08,110.07,-115.07000000000002
3204,78767161,2023-02-11,75.14,-39.930000000000035
1446,78767161,2023-02-14,-103.18,-143.11000000000004
2281,78773905,2023-01-31,0.0,511.78
8352,78773905,2023-02-10,-189.51,322.27
8353,78773905,2023-02-11,-1104.5,-782.23
8354,78773905,2023-02-12,-51.02,-833.25
8565,78773905,2023-02-12,116.83,-716.4200000000001
8355,78773905,2023-02-13,-38.13,-754.55
2282,78807944,2023-01-31,0.0,442.48
2085,78807944,2023-02-01,-90.9,351.58000000000004
2086,78807944,2023-02-04,-134.34,217.24
6663,78807944,2023-02-06,141.23,358.47
6664,78807944,2023-02-07,226.83,585.3
2087,78807944,2023-02-08,-9.19,576.11
6665,78807944,2023-02-10,152.17,728.28
2088,78807944,2023-02-12,-169.34,558.94
2089,78807944,2023-02-12,-75.44,483.5
2090,78807944,2023-02-13,-161.8,321.7
6666,78807944,2023-02-13,92.53,414.23
2283,78844183,2023-01-31,0.0,194.7
2854,78844183,2023-02-02,-12.35,182.35
2855,78844183,2023-02-05,-181.42,0.9300000000000068
2856,78844183,2023-02-06,-132.29,-131.35999999999996
2857,78844183,2023-02-12,-50.34,-181.7
2858,78844183,2023-02-13,-101.09,-282.79
2284,78905675,2023-01-31,0.0,11.18
948,78905675,2023-02-01,-84.08,-72.9
949,78905675,2023-02-04,-138.04,-210.94
950,78905675,2023-02-05,-101.84,-312.78
7715,78905675,2023-02-08,53.66,-259.11999999999995
7716,78905675,2023-02-08,100.85,-158.26999999999998
7714,78905675,2023-02-08,129.7,-28.57
7717,78905675,2023-02-09,35.18,6.609999999999999
7718,78905675,2023-02-10,11.07,17.68
951,78905675,2023-02-13,-79.92,-62.24
952,78905675,2023-02-13,-48.01,-110.25
2285,78913378,2023-01-31,0.0,378.08
1268,78913378,2023-02-01,-84.25,293.83
1269,78913378,2023-02-03,-127.62,166.20999999999998
1270,78913378,2023-02-04,-143.88,22.329999999999984
5838,78913378,2023-02-04,68.87,91.19999999999999
1271,78913378,2023-02-05,-58.45,32.75
1272,78913378,2023-02-06,-711.2,-678.45
5839,78913378,2023-02-08,146.5,-531.95
1273,78913378,2023-02-12,-85.39,-617.3399999999999
1274,78913378,2023-02-12,-72.09,-689.4300000000001
2286,78927989,2023-01-31,0.0,825.23
3558,78927989,2023-02-02,22.64,847.87
6395,78927989,2023-02-05,-1174.8,-326.92999999999984
6396,78927989,2023-02-05,-60.35,-387.27999999999975
6397,78927989,2023-02-07,-105.18,-492.4599999999998
3559,78927989,2023-02-09,153.45,-339.00999999999976
3560,78927989,2023-02-09,217.27,-121.73999999999978
6398,78927989,2023-02-11,-148.81,-270.5499999999997
3561,78927989,2023-02-12,66.32,-204.2299999999998
3563,78927989,2023-02-13,52.26,-151.9699999999998
3562,78927989,2023-02-13,66.55,-85.41999999999985
6400,78927989,2023-02-14,-34.84,-120.25999999999988
6399,78927989,2023-02-14,-31.7,-151.9599999999998
2287,78945298,2023-01-31,0.0,609.68
4286,78945298,2023-02-03,100.81,710.49
4287,78945298,2023-02-04,1320.2,2030.69
4288,78945298,2023-02-05,115.53,2146.22
4289,78945298,2023-02-05,119.75,2265.97
7341,78945298,2023-02-07,-194.01,2071.96
4290,78945298,2023-02-07,883.6,2955.56
4291,78945298,2023-02-08,58.82,3014.3799999999997
7342,78945298,2023-02-09,-115.06,2899.3199999999997
2288,78953379,2023-01-31,0.0,45.3
3514,78953379,2023-02-02,-181.56,-136.26
3515,78953379,2023-02-05,-325.0,-461.26
6480,78953379,2023-02-05,53.54,-407.71999999999997
6481,78953379,2023-02-10,80.36,-327.35999999999996
6482,78953379,2023-02-12,53.57,-273.78999999999996
6483,78953379,2023-02-12,85.93,-187.86
3516,78953379,2023-02-14,-63.74,-251.59999999999997
2289,79015773,2023-01-31,0.0,706.11
4870,79015773,2023-02-03,-74.72,631.39
8260,79015773,2023-02-10,111.05,742.44
8261,79015773,2023-02-11,74.36,816.8
4871,79015773,2023-02-12,-95.84,720.96
4872,79015773,2023-02-12,-91.81,629.15
8262,79015773,2023-02-13,39.15,668.3
8263,79015773,2023-02-14,118.75,787.05
2290,79033058,2023-01-31,0.0,97.12
343,79033058,2023-02-01,-167.53,-70.41
344,79033058,2023-02-02,-117.49,-187.89999999999998
5048,79033058,2023-02-04,1454.9,1267.0
345,79033058,2023-02-09,-1504.7,-237.69999999999993
5049,79033058,2023-02-12,68.89,-168.80999999999995
346,79033058,2023-02-13,-47.82,-216.62999999999994
2291,79036903,2023-01-31,0.0,491.23
2084,79036903,2023-02-01,16.06,507.29
3974,79036903,2023-02-03,-45.41,461.88
3975,79036903,2023-02-09,-119.51,342.37
2085,79036903,2023-02-09,181.31,523.6800000000001
3976,79036903,2023-02-10,-179.1,344.58000000000004
3978,79036903,2023-02-11,-137.26,207.32000000000005
3977,79036903,2023-02-11,-72.7,134.62
3979,79036903,2023-02-11,-64.21,70.41000000000003
3980,79036903,2023-02-13,-161.44,-91.02999999999997
3981,79036903,2023-02-14,-141.13,-232.15999999999997
2292,79069274,2023-01-31,0.0,685.1
4843,79069274,2023-02-03,-104.0,581.1
4844,79069274,2023-02-09,-97.15,483.95000000000005
4845,79069274,2023-02-12,-103.74,380.21000000000004
4846,79069274,2023-02-13,-86.79,293.42
2293,79090076,2023-01-31,0.0,119.25
1628,79090076,2023-02-01,130.83,250.08
2654,79090076,2023-02-02,-551.2,-301.12
1629,79090076,2023-02-02,1520.8,1219.6799999999998
1630,79090076,2023-02-03,187.7,1407.38
2656,79090076,2023-02-07,-126.32,1281.06
2655,79090076,2023-02-07,-54.35,1226.71
2657,79090076,2023-02-09,-101.12,1125.5900000000001
1631,79090076,2023-02-09,210.8,1336.39
2658,79090076,2023-02-13,-144.82,1191.5700000000002
1632,79090076,2023-02-14,174.26,1365.8300000000002
2294,79091642,2023-01-31,0.0,961.45
2983,79091642,2023-02-02,663.6,1625.0500000000002
2984,79091642,2023-02-05,110.12,1735.17
2985,79091642,2023-02-07,133.96,1869.13
8288,79091642,2023-02-10,-125.47,1743.66
2986,79091642,2023-02-10,64.46,1808.1200000000001
2295,79118116,2023-01-31,0.0,463.1
1083,79118116,2023-02-01,-105.55,357.55
1825,79118116,2023-02-01,55.58,413.13
1084,79118116,2023-02-02,-136.38,276.75
1826,79118116,2023-02-04,122.06,398.81000000000006
1827,79118116,2023-02-06,141.06,539.87
1085,79118116,2023-02-07,-101.44,438.43000000000006
1828,79118116,2023-02-10,97.03,535.46
2296,79147964,2023-01-31,0.0,753.1
1313,79147964,2023-02-01,-52.32,700.78
778,79147964,2023-02-01,102.61,803.39
777,79147964,2023-02-01,169.68,973.07
1314,79147964,2023-02-02,-183.83,789.24
779,79147964,2023-02-02,130.9,920.14
780,79147964,2023-02-04,210.25,1130.3899999999999
1315,79147964,2023-02-05,-63.7,1066.69
2297,79163824,2023-01-31,0.0,938.15
423,79163824,2023-02-01,-899.8,38.35000000000002
424,79163824,2023-02-04,-63.81,-25.459999999999923
6959,79163824,2023-02-06,81.68,56.22000000000003
6960,79163824,2023-02-06,125.82,182.04000000000008
6961,79163824,2023-02-12,111.68,293.72
6962,79163824,2023-02-14,147.24,440.96000000000004
2298,79169988,2023-01-31,0.0,354.01
3245,79169988,2023-02-02,136.38,490.39
3246,79169988,2023-02-06,51.53,541.92
7857,79169988,2023-02-08,-102.11,439.81
7858,79169988,2023-02-08,-31.3,408.51
3247,79169988,2023-02-09,827.3,1235.81
3248,79169988,2023-02-10,212.1,1447.9099999999999
7859,79169988,2023-02-13,-93.56,1354.35
3249,79169988,2023-02-13,58.3,1412.6499999999999
2299,79181666,2023-01-31,0.0,600.88
5701,79181666,2023-02-04,103.33,704.21
7737,79181666,2023-02-08,-138.31,565.9
5702,79181666,2023-02-09,123.84,689.74
5703,79181666,2023-02-10,66.98,756.72
5704,79181666,2023-02-11,77.77,834.49
5705,79181666,2023-02-12,108.96,943.45
7738,79181666,2023-02-14,-129.29,814.16
5706,79181666,2023-02-14,129.59,943.75
2300,79213491,2023-01-31,0.0,308.65
3776,79213491,2023-02-03,-49.16,259.49
3778,79213491,2023-02-05,-216.4,43.089999999999975
3777,79213491,2023-02-05,-51.72,-8.629999999999995
3779,79213491,2023-02-07,-11.99,-20.620000000000005
3780,79213491,2023-02-09,-37.9,-58.52000000000004
2301,79307217,2023-01-31,0.0,307.87
3015,79307217,2023-02-02,93.31,401.18
3016,79307217,2023-02-08,26.82,428.0
3017,79307217,2023-02-09,101.37,529.37
3018,79307217,2023-02-10,79.08,608.45
3019,79307217,2023-02-13,60.19,668.64
2302,79309039,2023-01-31,0.0,642.08
2107,79309039,2023-02-01,-96.14,545.94
4429,79309039,2023-02-03,164.94,710.88
4430,79309039,2023-02-04,124.74,835.62
2108,79309039,2023-02-06,-977.0,-141.38
4431,79309039,2023-02-06,78.77,-62.610000000000014
2109,79309039,2023-02-11,-94.31,-156.91999999999996
2110,79309039,2023-02-11,-90.71,-247.63
2303,79325967,2023-01-31,0.0,647.65
5116,79325967,2023-02-04,157.32,804.97
2304,79329254,2023-01-31,0.0,984.43
7959,79329254,2023-02-08,-83.02,901.41
8343,79329254,2023-02-10,90.32,991.7299999999999
7960,79329254,2023-02-12,-95.14,896.5899999999999
8345,79329254,2023-02-12,164.03,1060.62
8344,79329254,2023-02-12,1143.7,2204.32
2305,79355498,2023-01-31,0.0,132.74
1701,79355498,2023-02-01,812.6,945.34
4699,79355498,2023-02-03,-119.56,825.78
4700,79355498,2023-02-05,-74.28,751.5
1702,79355498,2023-02-06,162.2,913.7
2306,79380893,2023-01-31,0.0,163.15
2074,79380893,2023-02-01,-63.11,100.04
3102,79380893,2023-02-02,174.74,274.78000000000003
2075,79380893,2023-02-03,-146.88,127.90000000000002
3103,79380893,2023-02-03,119.68,247.58000000000004
3104,79380893,2023-02-09,196.47,444.05000000000007
2077,79380893,2023-02-12,-160.14,283.91
2076,79380893,2023-02-12,-122.48,161.43
3105,79380893,2023-02-12,28.61,190.04000000000002
2307,79415620,2023-01-31,0.0,729.51
7465,79415620,2023-02-07,104.64,834.15
7981,79415620,2023-02-08,-113.38,720.77
7982,79415620,2023-02-10,-117.79,602.98
7466,79415620,2023-02-11,6.42,609.4
7983,79415620,2023-02-14,-64.1,545.3
7467,79415620,2023-02-14,95.3,640.6
2308,79435523,2023-01-31,0.0,920.0
4867,79435523,2023-02-03,-17.57,902.43
5203,79435523,2023-02-04,100.66,1003.09
4868,79435523,2023-02-08,-140.73,862.36
5204,79435523,2023-02-12,91.9,954.26
4869,79435523,2023-02-13,-1397.6,-443.3399999999999
2309,79499412,2023-01-31,0.0,159.51
1458,79499412,2023-02-01,527.1,686.61
1457,79499412,2023-02-01,960.8,1647.41
1459,79499412,2023-02-14,43.42,1690.83
2310,79566165,2023-01-31,0.0,64.47
310,79566165,2023-02-01,-86.03,-21.560000000000002
311,79566165,2023-02-04,-98.42,-119.97999999999999
6107,79566165,2023-02-05,94.45,-25.53
6106,79566165,2023-02-05,94.95,69.42
6108,79566165,2023-02-08,132.45,201.86999999999998
6109,79566165,2023-02-09,18.36,220.23
6110,79566165,2023-02-11,70.24,290.46999999999997
312,79566165,2023-02-12,-140.52,149.94999999999996
313,79566165,2023-02-14,-86.86,63.08999999999996
2311,79566627,2023-01-31,0.0,377.62
2516,79566627,2023-02-02,-876.4,-498.78
2517,79566627,2023-02-03,-108.13,-606.91
2518,79566627,2023-02-04,-105.93,-712.84
5666,79566627,2023-02-04,122.23,-590.61
2519,79566627,2023-02-05,-17.69,-608.3
5667,79566627,2023-02-07,167.72,-440.58000000000004
2520,79566627,2023-02-08,-170.5,-611.08
2521,79566627,2023-02-09,-109.28,-720.36
2522,79566627,2023-02-12,-115.11,-835.4699999999999
2523,79566627,2023-02-13,-81.86,-917.33
5668,79566627,2023-02-14,72.35,-844.9799999999999
2312,79570236,2023-01-31,0.0,91.66
6575,79570236,2023-02-05,-158.27,-66.61000000000001
6576,79570236,2023-02-07,-101.36,-167.97
7878,79570236,2023-02-08,1168.1,1000.1299999999999
6577,79570236,2023-02-11,-1000.2,-0.07000000000013529
2313,79599747,2023-01-31,0.0,393.28
2289,79599747,2023-02-02,-57.66,335.62
4946,79599747,2023-02-03,92.94,428.55999999999995
4947,79599747,2023-02-04,109.45,538.01
4948,79599747,2023-02-06,125.59,663.5999999999999
2314,79632523,2023-01-31,0.0,867.95
5576,79632523,2023-02-04,95.05,963.0
5577,79632523,2023-02-04,146.68,1109.68
5578,79632523,2023-02-04,149.33,1259.0100000000002
6618,79632523,2023-02-05,-129.27,1129.74
5579,79632523,2023-02-08,93.73,1223.47
6619,79632523,2023-02-12,-910.1,313.3700000000001
2315,79656112,2023-01-31,0.0,848.18
5104,79656112,2023-02-04,-199.41,648.77
5103,79656112,2023-02-04,-157.32,491.44999999999993
2316,79656355,2023-01-31,0.0,766.41
389,79656355,2023-02-01,1820.3,2586.71
390,79656355,2023-02-02,186.07,2772.7799999999997
6657,79656355,2023-02-05,-85.62,2687.16
391,79656355,2023-02-07,68.86,2756.02
6658,79656355,2023-02-08,-115.99,2640.0299999999997
6659,79656355,2023-02-09,-49.28,2590.75
6660,79656355,2023-02-10,-165.02,2425.73
6661,79656355,2023-02-11,-57.3,2368.43
392,79656355,2023-02-13,94.19,2462.62
6662,79656355,2023-02-14,-150.19,2312.43
393,79656355,2023-02-14,666.1,2978.5299999999997
2317,79757019,2023-01-31,0.0,369.26
1903,79757019,2023-02-01,-116.57,252.69
1904,79757019,2023-02-04,-116.65,136.04
6486,79757019,2023-02-05,51.76,187.79999999999998
6487,79757019,2023-02-07,74.11,261.90999999999997
1905,79757019,2023-02-13,-93.14,168.76999999999998
2318,79771974,2023-01-31,0.0,350.67
3895,79771974,2023-02-03,613.0,963.6700000000001
5445,79771974,2023-02-04,-104.45,859.22
3896,79771974,2023-02-04,159.42,1018.6400000000001
5446,79771974,2023-02-07,-98.57,920.0699999999999
3897,79771974,2023-02-09,67.76,987.8299999999999
5447,79771974,2023-02-14,-43.95,943.8800000000001
2319,79792810,2023-01-31,0.0,505.57
2603,79792810,2023-02-02,-308.77,196.8
2604,79792810,2023-02-11,-75.1,121.69999999999999
2605,79792810,2023-02-12,-142.78,-21.079999999999984
8548,79792810,2023-02-12,98.23,77.15000000000003
2320,79933337,2023-01-31,0.0,508.79
1290,79933337,2023-02-01,84.25,593.04
2645,79933337,2023-02-02,-78.21,514.83
1291,79933337,2023-02-03,1253.8,1768.6299999999999
1292,79933337,2023-02-04,113.62,1882.25
2646,79933337,2023-02-09,-125.98,1756.27
2647,79933337,2023-02-12,-123.95,1632.32
2321,80001684,2023-01-31,0.0,572.24
5983,80001684,2023-02-05,-539.8,32.440000000000055
5917,80001684,2023-02-05,41.33,73.77000000000004
2322,80005822,2023-01-31,0.0,930.08
6567,80005822,2023-02-05,160.23,1090.31
8226,80005822,2023-02-10,-119.92,970.39
6568,80005822,2023-02-10,90.04,1060.43
6569,80005822,2023-02-12,61.43,1121.8600000000001
6570,80005822,2023-02-14,756.9,1878.76
2323,80015485,2023-01-31,0.0,310.56
6429,80015485,2023-02-05,-56.51,254.05
6430,80015485,2023-02-10,-92.86,161.19
8688,80015485,2023-02-14,153.23,314.42
2324,80040176,2023-01-31,0.0,533.74
4374,80040176,2023-02-03,-94.07,439.67
4450,80040176,2023-02-03,137.98,577.65
4375,80040176,2023-02-07,-156.4,421.25
4376,80040176,2023-02-07,-21.02,400.23
4451,80040176,2023-02-08,110.48,510.71000000000004
4377,80040176,2023-02-11,-245.04,265.67
4378,80040176,2023-02-13,-60.19,205.48000000000002
2325,80046304,2023-01-31,0.0,951.74
4193,80046304,2023-02-03,-70.99,880.75
3950,80046304,2023-02-03,99.68,980.4300000000001
4194,80046304,2023-02-04,-167.73,812.7
3951,80046304,2023-02-04,53.03,865.73
3952,80046304,2023-02-05,190.01,1055.74
4195,80046304,2023-02-06,-109.48,946.26
3953,80046304,2023-02-13,120.16,1066.42
3954,80046304,2023-02-14,36.6,1103.02
2326,80135904,2023-01-31,0.0,120.34
3918,80135904,2023-02-03,993.7,1114.04
6412,80135904,2023-02-05,-92.28,1021.7600000000001
6413,80135904,2023-02-07,-86.83,934.9300000000001
3919,80135904,2023-02-08,119.48,1054.41
3920,80135904,2023-02-13,375.1,1429.51
2327,80168427,2023-01-31,0.0,19.01
681,80168427,2023-02-01,-181.06,-162.05
682,80168427,2023-02-01,-81.22,-243.26999999999998
4497,80168427,2023-02-03,75.28,-167.99
683,80168427,2023-02-04,-138.34,-306.33000000000004
4498,80168427,2023-02-06,102.2,-204.13
2328,80184223,2023-01-31,0.0,52.59
7498,80184223,2023-02-07,-153.24,-100.65
8214,80184223,2023-02-10,195.79,95.13999999999999
7499,80184223,2023-02-12,-13.57,81.57
8215,80184223,2023-02-12,95.71,177.27999999999997
2329,80244844,2023-01-31,0.0,774.54
1818,80244844,2023-02-01,-90.07,684.47
1819,80244844,2023-02-04,-199.36,485.10999999999996
1820,80244844,2023-02-04,-115.56,369.54999999999995
5255,80244844,2023-02-04,128.19,497.73999999999995
1821,80244844,2023-02-08,-149.73,348.01
5256,80244844,2023-02-08,140.07,488.0799999999999
5257,80244844,2023-02-09,136.3,624.38
5259,80244844,2023-02-11,40.81,665.1899999999999
5258,80244844,2023-02-11,139.56,804.75
5260,80244844,2023-02-14,51.9,856.65
2330,80283776,2023-01-31,0.0,334.03
2971,80283776,2023-02-02,-148.09,185.93999999999997
3695,80283776,2023-02-02,83.88,269.81999999999994
2972,80283776,2023-02-06,-22.17,247.64999999999998
2973,80283776,2023-02-07,-121.67,125.97999999999996
2974,80283776,2023-02-08,-123.29,2.689999999999941
3696,80283776,2023-02-08,92.84,95.52999999999997
2975,80283776,2023-02-13,-40.02,55.509999999999934
2331,80291188,2023-01-31,0.0,338.65
1359,80291188,2023-02-01,70.27,408.91999999999996
6157,80291188,2023-02-05,-124.52,284.4
1360,80291188,2023-02-07,38.29,322.69
1361,80291188,2023-02-08,23.79,346.47999999999996
6159,80291188,2023-02-11,-75.48,271.0
6158,80291188,2023-02-11,-71.24,199.76
6160,80291188,2023-02-12,-75.56,124.19999999999999
1362,80291188,2023-02-13,111.96,236.15999999999997
2332,80304720,2023-01-31,0.0,614.87
1677,80304720,2023-02-01,170.25,785.12
6680,80304720,2023-02-05,-68.75,716.37
2333,80325529,2023-01-31,0.0,996.6
4603,80325529,2023-02-03,-125.34,871.26
4227,80325529,2023-02-03,44.0,915.26
4604,80325529,2023-02-05,-196.0,719.26
4228,80325529,2023-02-05,145.13,864.39
4229,80325529,2023-02-11,590.6,1454.99
4230,80325529,2023-02-13,71.7,1526.69
2334,80355773,2023-01-31,0.0,906.28
1806,80355773,2023-02-01,-37.94,868.3399999999999
1807,80355773,2023-02-03,-5.38,862.9599999999999
4572,80355773,2023-02-03,122.53,985.49
1808,80355773,2023-02-05,-122.18,863.31
1809,80355773,2023-02-09,-82.14,781.17
4573,80355773,2023-02-13,56.91,838.0799999999999
1810,80355773,2023-02-14,-553.6,284.4799999999999
2335,80360244,2023-01-31,0.0,658.35
3760,80360244,2023-02-03,-134.13,524.22
3761,80360244,2023-02-05,-83.59,440.63
3762,80360244,2023-02-06,-1947.3,-1506.67
3763,80360244,2023-02-06,-81.68,-1588.35
7337,80360244,2023-02-07,14.81,-1573.54
7338,80360244,2023-02-09,76.61,-1496.9300000000003
3764,80360244,2023-02-10,-11.31,-1508.2400000000002
2336,80379245,2023-01-31,0.0,793.17
1909,80379245,2023-02-01,-56.06,737.1099999999999
4493,80379245,2023-02-03,146.59,883.6999999999999
1910,80379245,2023-02-06,-1.58,882.12
4494,80379245,2023-02-06,61.92,944.04
4495,80379245,2023-02-07,106.24,1050.28
1911,80379245,2023-02-08,-85.29,964.99
1912,80379245,2023-02-09,-40.77,924.2199999999999
4496,80379245,2023-02-13,107.98,1032.2
2337,80391084,2023-01-31,0.0,466.35
4963,80391084,2023-02-03,-584.3,-117.94999999999993
7113,80391084,2023-02-06,28.34,-89.6099999999999
4964,80391084,2023-02-07,-122.13,-211.7399999999999
4965,80391084,2023-02-14,-116.9,-328.64
2338,80428983,2023-01-31,0.0,323.32
2425,80428983,2023-02-02,-53.59,269.73
5864,80428983,2023-02-04,158.41,428.14
5865,80428983,2023-02-09,87.99,516.13
2426,80428983,2023-02-11,-58.01,458.12
2427,80428983,2023-02-12,-564.4,-106.28000000000003
2428,80428983,2023-02-13,-177.52,-283.8
2429,80428983,2023-02-13,-68.69,-352.49000000000007
2430,80428983,2023-02-14,-60.97,-413.46
2339,80439799,2023-01-31,0.0,968.23
6061,80439799,2023-02-05,49.95,1018.1800000000001
8470,80439799,2023-02-11,-156.49,861.69
6062,80439799,2023-02-11,62.33,924.02
8471,80439799,2023-02-14,-90.74,833.28
2340,80464084,2023-01-31,0.0,12.73
3638,80464084,2023-02-02,145.27,158.0
3964,80464084,2023-02-03,-32.08,125.92000000000002
3965,80464084,2023-02-04,-189.06,-63.139999999999986
3639,80464084,2023-02-05,80.67,17.530000000000012
3967,80464084,2023-02-06,-213.44,-195.91
3966,80464084,2023-02-06,-70.94,-266.84999999999997
2341,80504934,2023-01-31,0.0,759.22
5912,80504934,2023-02-04,-74.95,684.27
6651,80504934,2023-02-06,165.65,849.9200000000001
5913,80504934,2023-02-11,-160.29,689.63
6652,80504934,2023-02-14,114.98,804.61
2342,80596699,2023-01-31,0.0,47.06
603,80596699,2023-02-01,123.08,170.14
602,80596699,2023-02-01,130.93,301.07
604,80596699,2023-02-03,91.37,392.44
605,80596699,2023-02-03,168.33,560.77
606,80596699,2023-02-04,58.03,618.8
6735,80596699,2023-02-06,-35.38,583.4200000000001
607,80596699,2023-02-06,85.9,669.3199999999999
608,80596699,2023-02-07,48.65,717.97
6736,80596699,2023-02-13,-26.24,691.73
2343,80610910,2023-01-31,0.0,139.54
2659,80610910,2023-02-02,-143.95,-4.409999999999997
6011,80610910,2023-02-05,164.35,159.94
2660,80610910,2023-02-06,-1032.3,-872.36
6012,80610910,2023-02-07,214.17,-658.19
2344,80678427,2023-01-31,0.0,97.72
971,80678427,2023-02-01,53.43,151.15
972,80678427,2023-02-01,102.9,254.05
5403,80678427,2023-02-04,-87.1,166.95000000000002
973,80678427,2023-02-05,142.28,309.23
5405,80678427,2023-02-08,-1051.4,-742.1700000000001
5406,80678427,2023-02-08,-144.26,-886.4300000000001
5404,80678427,2023-02-08,-136.73,-1023.1600000000001
5407,80678427,2023-02-12,-140.79,-1163.95
974,80678427,2023-02-12,106.86,-1057.0900000000001
975,80678427,2023-02-13,136.9,-920.19
2345,80678577,2023-01-31,0.0,288.61
5286,80678577,2023-02-04,94.62,383.23
5287,80678577,2023-02-11,163.65,546.88
5288,80678577,2023-02-13,75.02,621.9000000000001
2346,80709302,2023-01-31,0.0,280.92
6484,80709302,2023-02-05,144.79,425.71000000000004
6485,80709302,2023-02-11,2044.6,2470.31
2347,80747298,2023-01-31,0.0,768.33
8057,80747298,2023-02-09,119.77,888.1
8058,80747298,2023-02-13,138.24,1026.3400000000001
2348,80758476,2023-01-31,0.0,977.44
6812,80758476,2023-02-06,91.53,1068.97
7653,80758476,2023-02-07,-5.07,1063.9
6813,80758476,2023-02-11,171.55,1235.45
2349,80761210,2023-01-31,0.0,545.59
1991,80761210,2023-02-01,-143.85,401.74
1992,80761210,2023-02-04,-160.27,241.47000000000003
5421,80761210,2023-02-04,173.75,415.22
1993,80761210,2023-02-07,-105.09,310.13
5422,80761210,2023-02-08,73.68,383.81000000000006
5423,80761210,2023-02-10,113.99,497.8
2350,80778066,2023-01-31,0.0,217.49
1899,80778066,2023-02-01,-55.58,161.91000000000003
3932,80778066,2023-02-03,36.57,198.48000000000002
3933,80778066,2023-02-03,149.87,348.35
3934,80778066,2023-02-07,56.13,404.48
1900,80778066,2023-02-08,-2.72,401.76
2351,80787776,2023-01-31,0.0,460.46
182,80787776,2023-02-01,142.26,602.72
4734,80787776,2023-02-03,-22.26,580.4599999999999
183,80787776,2023-02-03,72.41,652.8699999999999
4736,80787776,2023-02-05,-1295.5,-642.6300000000001
4735,80787776,2023-02-05,-102.9,-745.5300000000002
4737,80787776,2023-02-10,-112.36,-857.8900000000001
4738,80787776,2023-02-11,-172.5,-1030.39
184,80787776,2023-02-14,150.42,-879.97
2352,80808205,2023-01-31,0.0,280.92
10,80808205,2023-02-01,-88.1,192.82000000000002
12,80808205,2023-02-02,-1698.0,-1505.1799999999998
11,80808205,2023-02-02,-1082.7,-2587.88
4333,80808205,2023-02-03,133.1,-2454.7799999999997
4334,80808205,2023-02-05,73.78,-2381.0
13,80808205,2023-02-06,-59.6,-2440.6
14,80808205,2023-02-11,-193.89,-2634.49
15,80808205,2023-02-13,-1017.6,-3652.09
4335,80808205,2023-02-13,214.61,-3437.48
2353,80811957,2023-01-31,0.0,139.95
6278,80811957,2023-02-05,85.92,225.87
7273,80811957,2023-02-07,-112.22,113.64999999999999
6279,80811957,2023-02-13,40.65,154.29999999999998
2354,80812213,2023-01-31,0.0,277.14
7237,80812213,2023-02-07,-103.35,173.79
7238,80812213,2023-02-07,-81.75,92.03999999999999
7239,80812213,2023-02-08,-67.93,24.109999999999985
2355,80818151,2023-01-31,0.0,320.64
537,80818151,2023-02-01,75.36,396.0
2990,80818151,2023-02-02,-10.1,385.9
538,80818151,2023-02-06,436.1,822.0
2356,80877479,2023-01-31,0.0,210.98
4977,80877479,2023-02-03,101.25,312.23
6205,80877479,2023-02-05,-112.01,200.21999999999997
6206,80877479,2023-02-06,-1457.8,-1257.58
6207,80877479,2023-02-06,-84.1,-1341.6799999999998
4978,80877479,2023-02-07,66.67,-1275.01
4979,80877479,2023-02-09,203.24,-1071.77
2357,80884901,2023-01-31,0.0,453.71
6646,80884901,2023-02-05,-179.02,274.68999999999994
6647,80884901,2023-02-06,-59.73,214.95999999999998
6648,80884901,2023-02-07,-85.23,129.72999999999996
6649,80884901,2023-02-09,-128.31,1.419999999999959
8518,80884901,2023-02-11,34.89,36.309999999999945
8519,80884901,2023-02-14,61.16,97.46999999999997
2358,80889919,2023-01-31,0.0,298.45
6953,80889919,2023-02-06,-20.39,278.06
7750,80889919,2023-02-08,130.71,408.77
2359,80938878,2023-01-31,0.0,29.73
3024,80938878,2023-02-02,24.23,53.96
7670,80938878,2023-02-08,-70.5,-16.539999999999996
3025,80938878,2023-02-12,151.29,134.75
2360,80939694,2023-01-31,0.0,923.76
5178,80939694,2023-02-04,861.1,1784.8600000000001
5179,80939694,2023-02-05,102.47,1887.33
7841,80939694,2023-02-08,-79.57,1807.76
5180,80939694,2023-02-08,66.57,1874.33
7842,80939694,2023-02-13,-64.31,1810.02
2361,80940019,2023-01-31,0.0,957.41
2535,80940019,2023-02-02,308.77,1266.1799999999998
4037,80940019,2023-02-03,-612.6,653.5799999999999
4038,80940019,2023-02-07,-301.0,352.5799999999999
2536,80940019,2023-02-11,152.11,504.68999999999994
2362,81049128,2023-01-31,0.0,694.91
6908,81049128,2023-02-06,113.47,808.38
8100,81049128,2023-02-09,-1727.8,-919.42
8101,81049128,2023-02-10,-191.56,-1110.98
6909,81049128,2023-02-11,74.61,-1036.37
2363,81075588,2023-01-31,0.0,297.73
163,81075588,2023-02-01,93.43,391.16
162,81075588,2023-02-01,99.3,490.46000000000004
164,81075588,2023-02-06,100.09,590.55
166,81075588,2023-02-08,117.07,707.62
165,81075588,2023-02-08,143.85,851.47
8166,81075588,2023-02-09,-123.35,728.12
167,81075588,2023-02-09,128.74,856.86
8168,81075588,2023-02-10,-169.0,687.86
8167,81075588,2023-02-10,-167.51,520.35
8170,81075588,2023-02-11,-152.76,367.59000000000003
8169,81075588,2023-02-11,-96.34,271.25000000000006
2364,81087182,2023-01-31,0.0,861.31
5552,81087182,2023-02-04,-107.78,753.53
5553,81087182,2023-02-05,-142.19,611.3399999999999
5554,81087182,2023-02-06,-136.6,474.73999999999995
5555,81087182,2023-02-09,-165.96,308.78
8654,81087182,2023-02-14,153.66,462.43999999999994
2365,81099534,2023-01-31,0.0,216.8
929,81099534,2023-02-01,-99.68,117.12
5337,81099534,2023-02-04,138.04,255.16
5338,81099534,2023-02-11,68.14,323.3
930,81099534,2023-02-14,-117.23,206.07
2366,81145048,2023-01-31,0.0,290.02
3650,81145048,2023-02-02,-115.05,174.96999999999997
3651,81145048,2023-02-03,-131.54,43.43000000000001
6022,81145048,2023-02-05,859.9,903.3299999999999
6023,81145048,2023-02-06,51.78,955.11
3652,81145048,2023-02-09,-898.2,56.90999999999997
3654,81145048,2023-02-12,-170.71,-113.80000000000007
3653,81145048,2023-02-12,-99.41,-213.21000000000004
2367,81159651,2023-01-31,0.0,466.71
3218,81159651,2023-02-02,-44.56,422.15
6578,81159651,2023-02-05,126.51,548.66
6579,81159651,2023-02-07,55.28,603.94
3219,81159651,2023-02-08,-132.1,471.84
3220,81159651,2023-02-09,-67.99,403.84999999999997
3221,81159651,2023-02-12,-109.6,294.25
6580,81159651,2023-02-13,437.5,731.75
3222,81159651,2023-02-14,-42.19,689.56
2368,81181209,2023-01-31,0.0,828.91
2988,81181209,2023-02-02,-58.23,770.68
8094,81181209,2023-02-09,7.44,778.12
8096,81181209,2023-02-09,118.7,896.8199999999999
8095,81181209,2023-02-09,181.77,1078.59
8097,81181209,2023-02-10,1210.3,2288.89
2989,81181209,2023-02-11,-104.35,2184.54
2369,81191580,2023-01-31,0.0,584.56
6967,81191580,2023-02-06,-14.55,570.01
6968,81191580,2023-02-10,-145.53,424.4799999999999
8535,81191580,2023-02-12,76.93,501.40999999999997
8534,81191580,2023-02-12,143.1,644.51
6969,81191580,2023-02-14,-135.36,509.1499999999999
2370,81200849,2023-01-31,0.0,479.29
4644,81200849,2023-02-03,132.53,611.82
6848,81200849,2023-02-06,-99.31,512.51
4645,81200849,2023-02-06,63.33,575.84
6849,81200849,2023-02-07,-76.35,499.49
4646,81200849,2023-02-08,9.98,509.47
4647,81200849,2023-02-11,18.39,527.86
6850,81200849,2023-02-12,-165.42,362.44000000000005
2371,81206535,2023-01-31,0.0,452.69
5956,81206535,2023-02-05,29.75,482.44
5957,81206535,2023-02-05,84.4,566.84
5958,81206535,2023-02-05,117.78,684.62
5959,81206535,2023-02-08,42.59,727.21
8098,81206535,2023-02-09,-22.93,704.28
5960,81206535,2023-02-10,190.89,895.1700000000001
5961,81206535,2023-02-13,47.54,942.71
8099,81206535,2023-02-14,-836.0,106.70999999999998
2372,81227009,2023-01-31,0.0,475.45
2147,81227009,2023-02-01,-33.49,441.96
1635,81227009,2023-02-01,95.83,537.79
2148,81227009,2023-02-03,-59.28,478.51
1636,81227009,2023-02-03,90.64,569.15
1637,81227009,2023-02-07,91.92,661.0699999999999
1638,81227009,2023-02-10,144.33,805.4000000000001
2149,81227009,2023-02-11,-39.39,766.01
1639,81227009,2023-02-11,75.12,841.13
1640,81227009,2023-02-12,144.19,985.3199999999999
1641,81227009,2023-02-12,541.9,1527.22
2150,81227009,2023-02-13,-136.4,1390.82
2151,81227009,2023-02-14,-111.15,1279.67
1642,81227009,2023-02-14,50.66,1330.33
2373,81245588,2023-01-31,0.0,775.87
6350,81245588,2023-02-05,-85.92,689.95
6351,81245588,2023-02-10,-120.39,569.56
8234,81245588,2023-02-10,83.51,653.07
8235,81245588,2023-02-13,69.73,722.8
8236,81245588,2023-02-14,136.73,859.53
2374,81267006,2023-01-31,0.0,425.16
3205,81267006,2023-02-02,168.67,593.83
4894,81267006,2023-02-03,-69.26,524.57
3206,81267006,2023-02-05,107.8,632.37
4895,81267006,2023-02-10,-135.89,496.48
3207,81267006,2023-02-10,1430.6,1927.08
2375,81336389,2023-01-31,0.0,210.06
927,81336389,2023-02-01,119.5,329.56
3953,81336389,2023-02-03,-188.47,141.09
928,81336389,2023-02-03,77.36,218.45
3954,81336389,2023-02-05,-106.54,111.91
3955,81336389,2023-02-06,-109.52,2.3899999999999864
929,81336389,2023-02-09,83.99,86.38
3956,81336389,2023-02-10,-216.08,-129.7
3957,81336389,2023-02-13,-149.91,-279.61
930,81336389,2023-02-13,99.54,-180.07
2376,81336468,2023-01-31,0.0,935.41
2899,81336468,2023-02-02,-1327.5,-392.09000000000003
2900,81336468,2023-02-02,-663.6,-1055.69
2323,81336468,2023-02-02,779.9,-275.7900000000001
2324,81336468,2023-02-02,807.9,532.1099999999999
2325,81336468,2023-02-05,37.98,570.0899999999999
2326,81336468,2023-02-06,75.77,645.8599999999999
2327,81336468,2023-02-07,127.56,773.4199999999998
2328,81336468,2023-02-09,146.02,919.4399999999999
2329,81336468,2023-02-09,154.98,1074.4199999999998
2377,81337623,2023-01-31,0.0,815.36
5724,81337623,2023-02-04,-185.63,629.73
7614,81337623,2023-02-07,183.44,813.1700000000001
7615,81337623,2023-02-10,101.56,914.73
7616,81337623,2023-02-10,167.13,1081.8600000000001
5725,81337623,2023-02-12,-26.35,1055.51
7617,81337623,2023-02-14,69.51,1125.02
2378,81340143,2023-01-31,0.0,647.34
5933,81340143,2023-02-05,103.36,750.7
8171,81340143,2023-02-09,-682.6,68.10000000000002
8172,81340143,2023-02-11,-47.38,20.720000000000027
2379,81384411,2023-01-31,0.0,175.86
4310,81384411,2023-02-03,174.31,350.17
5849,81384411,2023-02-04,-1361.0,-1010.83
5850,81384411,2023-02-10,-63.87,-1074.6999999999998
5851,81384411,2023-02-11,-205.44,-1280.1399999999999
4311,81384411,2023-02-11,67.21,-1212.9299999999998
5852,81384411,2023-02-12,-114.27,-1327.1999999999998
2380,81398388,2023-01-31,0.0,979.87
2482,81398388,2023-02-02,15.93,995.8
2481,81398388,2023-02-02,120.93,1116.73
8189,81398388,2023-02-09,-115.5,1001.23
8190,81398388,2023-02-10,-97.88,903.35
8191,81398388,2023-02-13,-43.87,859.48
2381,81445756,2023-01-31,0.0,267.66
3985,81445756,2023-02-03,-1253.8,-986.1399999999999
3986,81445756,2023-02-04,-110.0,-1096.1399999999999
2382,81475774,2023-01-31,0.0,568.11
4560,81475774,2023-02-03,-156.2,411.91
5426,81475774,2023-02-04,89.97,501.88
5427,81475774,2023-02-04,1059.1,1560.98
5428,81475774,2023-02-07,118.92,1679.9
4561,81475774,2023-02-10,-58.79,1621.1100000000001
4562,81475774,2023-02-12,-196.98,1424.1299999999999
4563,81475774,2023-02-13,-66.54,1357.59
2383,81527490,2023-01-31,0.0,234.05
1059,81527490,2023-02-01,-102.61,131.44
2996,81527490,2023-02-02,108.67,240.11
2997,81527490,2023-02-05,135.59,375.70000000000005
2998,81527490,2023-02-06,1.14,376.84000000000003
1060,81527490,2023-02-07,-17.58,359.26
2999,81527490,2023-02-07,69.94,429.20000000000005
1061,81527490,2023-02-09,-254.92,174.28000000000003
1062,81527490,2023-02-09,-181.77,-7.489999999999981
3000,81527490,2023-02-12,174.92,167.43
1063,81527490,2023-02-13,-115.44,51.99000000000001
3001,81527490,2023-02-13,100.05,152.04000000000002
2384,81561788,2023-01-31,0.0,454.89
3351,81561788,2023-02-02,-1106.9,-652.0100000000001
3352,81561788,2023-02-05,-94.45,-746.4600000000002
6628,81561788,2023-02-05,821.8,75.3399999999998
6629,81561788,2023-02-06,48.45,123.7899999999998
6630,81561788,2023-02-07,96.93,220.7199999999998
6631,81561788,2023-02-08,85.01,305.7299999999998
3353,81561788,2023-02-09,-109.32,196.40999999999985
6632,81561788,2023-02-11,121.33,317.73999999999984
6633,81561788,2023-02-11,1777.8,2095.54
2385,81590655,2023-01-31,0.0,742.17
5751,81590655,2023-02-04,54.34,796.51
5752,81590655,2023-02-05,103.0,899.51
8159,81590655,2023-02-09,-54.35,845.16
5753,81590655,2023-02-10,712.2,1557.3600000000001
2386,81646873,2023-01-31,0.0,188.36
2918,81646873,2023-02-02,-95.2,93.16000000000001
2919,81646873,2023-02-03,-62.59,30.569999999999993
5198,81646873,2023-02-04,78.93,109.50000000000001
5199,81646873,2023-02-06,89.63,199.13
5200,81646873,2023-02-07,81.96,281.09000000000003
2920,81646873,2023-02-09,-161.02,120.07
5201,81646873,2023-02-09,10.45,130.51999999999998
5202,81646873,2023-02-10,679.8,810.3199999999999
2921,81646873,2023-02-13,-100.5,709.8199999999999
2387,81651344,2023-01-31,0.0,219.55
7251,81651344,2023-02-06,155.37,374.92
7758,81651344,2023-02-08,-92.38,282.54
7759,81651344,2023-02-09,-78.16,204.38000000000002
2388,81655495,2023-01-31,0.0,315.33
87,81655495,2023-02-01,-1139.7,-824.3700000000001
88,81655495,2023-02-02,-1091.2,-1915.5700000000002
4639,81655495,2023-02-03,89.14,-1826.4300000000003
4640,81655495,2023-02-06,191.25,-1635.1800000000003
89,81655495,2023-02-14,-81.21,-1716.39
2389,81662619,2023-01-31,0.0,712.33
1018,81662619,2023-02-01,-137.9,574.4300000000001
7243,81662619,2023-02-06,82.51,656.94
7244,81662619,2023-02-07,152.96,809.9000000000001
1019,81662619,2023-02-10,-34.99,774.9100000000001
1020,81662619,2023-02-12,-109.89,665.0200000000001
7245,81662619,2023-02-14,141.21,806.23
2390,81727860,2023-01-31,0.0,192.44
6178,81727860,2023-02-05,-99.25,93.19
7869,81727860,2023-02-08,76.65,169.84
6179,81727860,2023-02-09,-193.78,-23.939999999999998
2391,81740267,2023-01-31,0.0,67.86
3325,81740267,2023-02-02,110.38,178.24
6737,81740267,2023-02-06,-110.09,68.14999999999999
3326,81740267,2023-02-06,81.53,149.68
2392,81823420,2023-01-31,0.0,259.73
791,81823420,2023-02-01,102.1,361.83000000000004
792,81823420,2023-02-04,201.15,562.98
6927,81823420,2023-02-06,-49.47,513.51
793,81823420,2023-02-10,8.29,521.8
794,81823420,2023-02-11,38.25,560.05
2393,81855175,2023-01-31,0.0,907.59
725,81855175,2023-02-01,-49.37,858.22
724,81855175,2023-02-01,-42.34,815.88
2709,81855175,2023-02-02,75.11,890.99
2710,81855175,2023-02-03,102.49,993.48
726,81855175,2023-02-09,-892.4,101.08000000000004
727,81855175,2023-02-10,-90.2,10.879999999999995
728,81855175,2023-02-12,-1801.4,-1790.52
729,81855175,2023-02-14,-32.96,-1823.48
2394,81923993,2023-01-31,0.0,686.37
6461,81923993,2023-02-05,-637.3,49.07000000000005
8194,81923993,2023-02-10,27.72,76.79000000000008
8196,81923993,2023-02-11,130.08,206.87000000000006
8195,81923993,2023-02-11,142.72,349.59000000000003
6462,81923993,2023-02-12,-181.41,168.18000000000006
8197,81923993,2023-02-14,541.0,709.1800000000001
2395,81932657,2023-01-31,0.0,146.81
1735,81932657,2023-02-01,58.0,204.81
1736,81932657,2023-02-01,80.7,285.51
1737,81932657,2023-02-08,1044.7,1330.21
8200,81932657,2023-02-09,-4.61,1325.6000000000001
8201,81932657,2023-02-12,-79.12,1246.48
2396,81994568,2023-01-31,0.0,578.86
4888,81994568,2023-02-03,-20.43,558.4300000000001
4457,81994568,2023-02-03,47.78,606.21
4458,81994568,2023-02-04,1510.5,2116.71
4459,81994568,2023-02-06,58.84,2175.5499999999997
4889,81994568,2023-02-10,-75.99,2099.56
4461,81994568,2023-02-10,30.61,2130.17
4460,81994568,2023-02-10,1463.6,3593.77
2397,82002852,2023-01-31,0.0,816.53
5740,82002852,2023-02-04,148.35,964.88
7139,82002852,2023-02-06,-49.21,915.67
7140,82002852,2023-02-09,-61.13,854.54
7141,82002852,2023-02-12,-119.03,735.51
2398,82023979,2023-01-31,0.0,744.37
2178,82023979,2023-02-02,-1019.5,-275.13
4121,82023979,2023-02-03,104.62,-170.51
2179,82023979,2023-02-10,-107.4,-277.90999999999997
2399,82027257,2023-01-31,0.0,681.1
3231,82027257,2023-02-02,129.77,810.87
7347,82027257,2023-02-07,-118.19,692.6800000000001
7348,82027257,2023-02-11,-184.66,508.02000000000004
3232,82027257,2023-02-11,122.19,630.21
3233,82027257,2023-02-11,147.54,777.75
7349,82027257,2023-02-12,-154.82,622.9300000000001
7350,82027257,2023-02-13,-74.3,548.6300000000001
3234,82027257,2023-02-13,88.79,637.4200000000001
2400,82043720,2023-01-31,0.0,803.68
594,82043720,2023-02-01,52.9,856.5799999999999
5183,82043720,2023-02-04,-118.34,738.24
595,82043720,2023-02-08,119.51,857.75
5184,82043720,2023-02-10,-62.15,795.5999999999999
596,82043720,2023-02-12,96.27,891.8699999999999
2401,82101740,2023-01-31,0.0,469.34
1548,82101740,2023-02-01,-72.19,397.15
2925,82101740,2023-02-02,68.21,465.35999999999996
2926,82101740,2023-02-11,30.14,495.5
1549,82101740,2023-02-12,-153.41,342.09
1550,82101740,2023-02-13,-43.53,298.55999999999995
2402,82115900,2023-01-31,0.0,446.89
8683,82115900,2023-02-14,1308.6,1755.4899999999998
2403,82177278,2023-01-31,0.0,236.32
3462,82177278,2023-02-02,-123.02,113.3
2876,82177278,2023-02-02,924.0,1037.3
3463,82177278,2023-02-08,-105.67,931.6300000000001
2877,82177278,2023-02-09,95.76,1027.39
2878,82177278,2023-02-10,75.98,1103.3700000000001
3464,82177278,2023-02-11,-64.7,1038.67
3465,82177278,2023-02-12,-130.79,907.8800000000001
3466,82177278,2023-02-13,-123.69,784.19
2879,82177278,2023-02-14,191.52,975.71
2404,82188502,2023-01-31,0.0,788.02
419,82188502,2023-02-01,-96.2,691.8199999999999
908,82188502,2023-02-01,66.19,758.01
909,82188502,2023-02-02,109.3,867.31
910,82188502,2023-02-03,45.41,912.72
420,82188502,2023-02-09,-127.38,785.3399999999999
421,82188502,2023-02-09,-109.88,675.46
422,82188502,2023-02-10,-73.39,602.0699999999999
911,82188502,2023-02-10,110.41,712.48
2405,82233451,2023-01-31,0.0,795.71
1800,82233451,2023-02-01,97.37,893.08
5990,82233451,2023-02-05,-167.85,725.23
1801,82233451,2023-02-13,155.44,880.6700000000001
2406,82259327,2023-01-31,0.0,982.72
4618,82259327,2023-02-03,-134.35,848.37
4619,82259327,2023-02-04,-944.5,-96.12999999999988
6408,82259327,2023-02-05,1463.6,1367.47
6410,82259327,2023-02-07,46.81,1414.28
6409,82259327,2023-02-07,112.11,1526.3899999999999
6411,82259327,2023-02-09,107.63,1634.02
4620,82259327,2023-02-10,-94.84,1539.18
2407,82263080,2023-01-31,0.0,928.54
4277,82263080,2023-02-03,-180.52,748.02
5655,82263080,2023-02-04,98.52,846.54
5656,82263080,2023-02-11,782.2,1628.74
5657,82263080,2023-02-12,133.67,1762.4099999999999
4278,82263080,2023-02-13,-59.69,1702.72
2408,82283956,2023-01-31,0.0,745.72
302,82283956,2023-02-01,-158.92,586.8000000000001
2379,82283956,2023-02-02,58.23,645.03
303,82283956,2023-02-03,-349.6,295.43
2409,82303710,2023-01-31,0.0,619.98
3959,82303710,2023-02-03,102.85,722.83
3960,82303710,2023-02-10,112.61,835.44
8662,82303710,2023-02-14,-1674.0,-838.56
8661,82303710,2023-02-14,-91.7,-930.26
3961,82303710,2023-02-14,208.0,-722.26
2410,82314789,2023-01-31,0.0,735.77
759,82314789,2023-02-01,53.09,788.86
5948,82314789,2023-02-04,-87.35,701.51
760,82314789,2023-02-06,155.01,856.52
5949,82314789,2023-02-09,-1340.1,-483.5799999999999
5950,82314789,2023-02-13,-75.81,-559.3899999999999
2411,82424659,2023-01-31,0.0,568.77
3640,82424659,2023-02-02,56.94,625.71
6675,82424659,2023-02-05,-186.17,439.53999999999996
6676,82424659,2023-02-09,-87.15,352.39
3641,82424659,2023-02-09,140.61,493.0
3642,82424659,2023-02-12,151.48,644.48
3643,82424659,2023-02-13,21.73,666.21
2412,82461559,2023-01-31,0.0,652.26
3932,82461559,2023-02-03,-98.38,553.88
3933,82461559,2023-02-07,-117.08,436.8
7354,82461559,2023-02-07,117.08,553.88
7355,82461559,2023-02-08,85.07,638.95
3934,82461559,2023-02-09,-6.95,632.0
7356,82461559,2023-02-12,37.14,669.14
3935,82461559,2023-02-13,-167.76,501.38
3936,82461559,2023-02-14,-118.75,382.63
2413,82543932,2023-01-31,0.0,279.1
3749,82543932,2023-02-03,-104.78,174.32000000000002
3750,82543932,2023-02-05,-167.18,7.139999999999986
6084,82543932,2023-02-05,170.9,178.04000000000002
3751,82543932,2023-02-10,-98.45,79.59000000000003
3752,82543932,2023-02-12,-187.21,-107.62
2414,82558079,2023-01-31,0.0,381.22
2238,82558079,2023-02-02,106.05,487.27000000000004
7214,82558079,2023-02-07,-65.45,421.82000000000005
2239,82558079,2023-02-12,26.9,448.72
7216,82558079,2023-02-13,-77.1,371.62
7215,82558079,2023-02-13,-54.59,317.03000000000003
2415,82568859,2023-01-31,0.0,32.21
4216,82568859,2023-02-03,37.0,69.21000000000001
4217,82568859,2023-02-03,432.2,501.40999999999997
4218,82568859,2023-02-05,87.66,589.07
7200,82568859,2023-02-06,-102.1,486.96999999999997
4219,82568859,2023-02-10,110.62,597.59
2416,82589836,2023-01-31,0.0,648.06
2446,82589836,2023-02-02,-39.13,608.93
3804,82589836,2023-02-03,207.91,816.8399999999999
3805,82589836,2023-02-08,77.26,894.0999999999999
2447,82589836,2023-02-09,-146.02,748.0799999999999
2449,82589836,2023-02-13,-137.63,610.4499999999999
2448,82589836,2023-02-13,-113.04,497.4099999999999
2417,82696309,2023-01-31,0.0,352.08
1988,82696309,2023-02-01,90.9,442.98
8437,82696309,2023-02-11,-114.97,328.01
8438,82696309,2023-02-13,-63.14,264.87
2418,82734145,2023-01-31,0.0,278.57
2349,82734145,2023-02-02,185.74,464.31
2350,82734145,2023-02-07,124.86,589.1700000000001
8207,82734145,2023-02-09,-94.06,495.11
8208,82734145,2023-02-12,-85.04,410.07
2352,82734145,2023-02-13,85.84,495.90999999999997
2353,82734145,2023-02-13,116.52,612.4300000000001
2351,82734145,2023-02-13,650.5,1262.93
2419,82764940,2023-01-31,0.0,876.37
761,82764940,2023-02-01,42.34,918.71
3712,82764940,2023-02-02,-100.46,818.25
762,82764940,2023-02-02,1117.0,1935.25
3713,82764940,2023-02-10,-1580.9,354.35
764,82764940,2023-02-12,127.13,481.48
763,82764940,2023-02-12,153.05,634.53
765,82764940,2023-02-14,182.1,816.63
2420,82776251,2023-01-31,0.0,747.11
1906,82776251,2023-02-01,91.77,838.88
1907,82776251,2023-02-03,123.38,962.26
5116,82776251,2023-02-04,-1315.2,-352.94000000000017
1908,82776251,2023-02-11,202.15,-150.78999999999996
2421,82807528,2023-01-31,0.0,117.15
3605,82807528,2023-02-02,-109.57,7.5800000000000125
3122,82807528,2023-02-02,128.03,135.61
3123,82807528,2023-02-03,79.68,215.29000000000002
3606,82807528,2023-02-09,-18.91,196.38000000000002
3607,82807528,2023-02-13,-45.1,151.28000000000003
3608,82807528,2023-02-14,-113.52,37.76000000000002
3609,82807528,2023-02-14,-71.88,-34.119999999999976
2422,82879607,2023-01-31,0.0,72.18
7156,82879607,2023-02-06,-171.29,-99.10999999999999
7828,82879607,2023-02-08,102.11,3.000000000000014
7829,82879607,2023-02-11,164.37,167.37
7157,82879607,2023-02-12,-109.8,57.57000000000002
7830,82879607,2023-02-13,75.81,133.38000000000002
7158,82879607,2023-02-14,-117.24,16.14000000000003
2423,82911152,2023-01-31,0.0,564.11
2951,82911152,2023-02-02,-68.58,495.53000000000003
3193,82911152,2023-02-02,109.06,604.59
2952,82911152,2023-02-11,-1104.0,-499.40999999999997
3194,82911152,2023-02-11,42.9,-456.51
3195,82911152,2023-02-11,118.19,-338.31999999999994
2953,82911152,2023-02-13,-169.23,-507.54999999999984
2954,82911152,2023-02-14,-156.79,-664.34
2424,82920281,2023-01-31,0.0,41.13
3240,82920281,2023-02-02,94.2,135.33
3898,82920281,2023-02-03,-1791.6,-1656.2699999999998
3899,82920281,2023-02-06,-543.9,-2200.1699999999996
3241,82920281,2023-02-10,114.72,-2085.45
2425,82927034,2023-01-31,0.0,435.71
3891,82927034,2023-02-03,-131.87,303.84
5629,82927034,2023-02-04,63.83,367.66999999999996
3892,82927034,2023-02-08,-66.93,300.73999999999995
5630,82927034,2023-02-09,86.0,386.73999999999995
3893,82927034,2023-02-11,-116.46,270.28
5631,82927034,2023-02-14,99.21,369.48999999999995
2426,82930132,2023-01-31,0.0,131.87
4592,82930132,2023-02-03,175.68,307.55
4591,82930132,2023-02-03,192.08,499.63
4593,82930132,2023-02-04,69.05,568.6800000000001
4594,82930132,2023-02-05,119.88,688.5600000000001
6790,82930132,2023-02-06,-105.81,582.75
6791,82930132,2023-02-11,-137.86,444.89
4595,82930132,2023-02-12,0.94,445.83
2427,83003822,2023-01-31,0.0,286.54
3888,83003822,2023-02-03,-143.42,143.12000000000003
3889,83003822,2023-02-10,-1430.6,-1287.48
3890,83003822,2023-02-11,-99.93,-1387.41
2428,83056011,2023-01-31,0.0,968.4
3725,83056011,2023-02-03,129.38,1097.78
3726,83056011,2023-02-08,168.14,1265.92
8439,83056011,2023-02-11,-66.39,1199.53
2429,83067540,2023-01-31,0.0,258.33
3948,83067540,2023-02-03,-111.0,147.32999999999998
3949,83067540,2023-02-03,-37.0,110.32999999999998
6911,83067540,2023-02-06,944.2,1054.53
6912,83067540,2023-02-11,133.67,1188.2
2430,83081615,2023-01-31,0.0,301.32
2618,83081615,2023-02-02,141.97,443.28999999999996
2619,83081615,2023-02-04,41.77,485.06
2620,83081615,2023-02-05,113.82,598.88
2621,83081615,2023-02-07,139.96,738.8399999999999
2622,83081615,2023-02-11,67.03,805.87
2431,83124388,2023-01-31,0.0,504.59
3614,83124388,2023-02-02,101.47,606.06
3615,83124388,2023-02-03,94.07,700.13
3616,83124388,2023-02-04,97.81,797.94
8180,83124388,2023-02-09,-64.47,733.47
8179,83124388,2023-02-09,-46.08,687.39
8181,83124388,2023-02-14,-71.41,615.98
2432,83128181,2023-01-31,0.0,816.12
536,83128181,2023-02-01,-97.36,718.76
4782,83128181,2023-02-03,82.71,801.47
4783,83128181,2023-02-07,132.91,934.38
537,83128181,2023-02-09,-1325.7,-391.32000000000005
538,83128181,2023-02-12,-1681.9,-2073.2200000000003
2433,83128544,2023-01-31,0.0,25.71
6356,83128544,2023-02-05,21.67,47.38
7391,83128544,2023-02-07,-153.16,-105.78
6357,83128544,2023-02-07,1.03,-104.74999999999997
6358,83128544,2023-02-07,181.11,76.36000000000004
7392,83128544,2023-02-08,-128.53,-52.169999999999966
7393,83128544,2023-02-13,-132.3,-184.46999999999997
6359,83128544,2023-02-14,85.67,-98.79999999999998
2434,83166098,2023-01-31,0.0,827.81
322,83166098,2023-02-01,-116.71,711.0999999999999
323,83166098,2023-02-06,-135.81,575.29
324,83166098,2023-02-07,-46.92,528.3699999999999
7400,83166098,2023-02-07,99.87,628.24
325,83166098,2023-02-08,-170.98,457.26
7401,83166098,2023-02-10,989.8,1447.06
326,83166098,2023-02-11,-110.56,1336.5
327,83166098,2023-02-13,-165.82,1170.6799999999998
7402,83166098,2023-02-13,37.83,1208.51
2435,83187508,2023-01-31,0.0,714.42
1215,83187508,2023-02-01,130.8,845.22
6039,83187508,2023-02-05,-85.78,759.4399999999999
1216,83187508,2023-02-05,35.44,794.88
1218,83187508,2023-02-06,90.78,885.66
1217,83187508,2023-02-06,106.03,991.6899999999999
6040,83187508,2023-02-08,-126.03,865.66
6041,83187508,2023-02-09,-122.79,742.87
1219,83187508,2023-02-09,65.38,808.25
1220,83187508,2023-02-10,1048.2,1856.4499999999998
6042,83187508,2023-02-11,-158.35,1698.1
1221,83187508,2023-02-13,1207.6,2905.7
6043,83187508,2023-02-14,-140.97,2764.73
2436,83191889,2023-01-31,0.0,344.33
3193,83191889,2023-02-02,-115.12,229.20999999999998
3191,83191889,2023-02-02,-101.15,128.05999999999997
3192,83191889,2023-02-02,-91.54,36.51999999999998
5137,83191889,2023-02-04,398.1,434.62
3194,83191889,2023-02-10,-88.72,345.9
5138,83191889,2023-02-10,90.73,436.63
5139,83191889,2023-02-12,170.43,607.06
5140,83191889,2023-02-13,128.78,735.8399999999999
2437,83202693,2023-01-31,0.0,165.41
3310,83202693,2023-02-02,85.17,250.57999999999998
4280,83202693,2023-02-03,-195.91,54.67
4281,83202693,2023-02-07,-336.2,-281.53
3311,83202693,2023-02-09,129.57,-151.96
3312,83202693,2023-02-11,93.53,-58.43000000000001
4282,83202693,2023-02-13,-33.04,-91.47
2438,83281565,2023-01-31,0.0,968.83
7062,83281565,2023-02-06,68.88,1037.71
7684,83281565,2023-02-08,-146.5,891.21
7683,83281565,2023-02-08,-126.11,765.1
7682,83281565,2023-02-08,-23.79,741.3100000000001
7063,83281565,2023-02-09,150.23,891.54
7685,83281565,2023-02-12,-174.92,716.62
7064,83281565,2023-02-13,106.97,823.59
7065,83281565,2023-02-14,124.76,948.35
2439,83302154,2023-01-31,0.0,465.25
3601,83302154,2023-02-02,-110.35,354.9
3602,83302154,2023-02-03,-936.3,-581.3999999999999
5293,83302154,2023-02-04,72.97,-508.42999999999995
5294,83302154,2023-02-04,598.4,89.97000000000003
3603,83302154,2023-02-06,-141.54,-51.569999999999936
5295,83302154,2023-02-10,206.87,155.30000000000007
3604,83302154,2023-02-13,-166.98,-11.67999999999995
2440,83443439,2023-01-31,0.0,97.61
4318,83443439,2023-02-03,-4.02,93.59
5025,83443439,2023-02-03,1218.0,1311.59
4319,83443439,2023-02-04,-95.13,1216.4599999999998
4320,83443439,2023-02-05,-103.0,1113.46
4321,83443439,2023-02-06,-55.3,1058.16
5026,83443439,2023-02-10,117.1,1175.26
5027,83443439,2023-02-10,216.08,1391.34
5028,83443439,2023-02-13,114.78,1506.12
2441,83475318,2023-01-31,0.0,228.96
1635,83475318,2023-02-01,-95.83,133.13
8561,83475318,2023-02-12,79.07,212.2
1636,83475318,2023-02-14,-107.71,104.49000000000001
2442,83530155,2023-01-31,0.0,638.57
2451,83530155,2023-02-02,-58.65,579.9200000000001
2452,83530155,2023-02-10,-136.31,443.61
2453,83530155,2023-02-12,-1006.5,-562.89
2454,83530155,2023-02-12,-11.78,-574.67
8637,83530155,2023-02-13,80.6,-494.07000000000005
2443,83530541,2023-01-31,0.0,630.6
7344,83530541,2023-02-07,33.35,663.95
7937,83530541,2023-02-08,-1316.4,-652.4500000000002
7938,83530541,2023-02-13,-97.98,-750.4300000000002
2444,83531401,2023-01-31,0.0,445.24
8127,83531401,2023-02-09,-11.67,433.57
8369,83531401,2023-02-10,123.19,556.76
8370,83531401,2023-02-12,67.65,624.4100000000001
2445,83539050,2023-01-31,0.0,172.33
8160,83539050,2023-02-09,-138.19,34.140000000000015
8014,83539050,2023-02-09,64.03,98.17000000000002
8015,83539050,2023-02-14,114.54,212.71000000000004
2446,83557419,2023-01-31,0.0,374.69
4935,83557419,2023-02-03,-115.71,258.98
4936,83557419,2023-02-05,-98.9,160.07999999999998
8622,83557419,2023-02-13,194.21,354.29
2447,83565726,2023-01-31,0.0,910.38
2802,83565726,2023-02-02,-792.0,118.38
2803,83565726,2023-02-02,-90.49,27.889999999999986
2804,83565726,2023-02-03,-68.43,-40.539999999999964
2805,83565726,2023-02-07,-87.52,-128.06000000000006
7409,83565726,2023-02-07,162.23,34.16999999999996
7410,83565726,2023-02-11,954.4,988.5699999999999
7411,83565726,2023-02-12,100.74,1089.31
7412,83565726,2023-02-12,119.09,1208.3999999999999
2806,83565726,2023-02-13,-959.6,248.79999999999984
2448,83573848,2023-01-31,0.0,818.5
453,83573848,2023-02-01,-94.56,723.94
2293,83573848,2023-02-02,123.95,847.89
2292,83573848,2023-02-02,133.09,980.98
454,83573848,2023-02-05,-170.9,810.0799999999999
455,83573848,2023-02-09,-125.67,684.41
2294,83573848,2023-02-09,193.78,878.19
2295,83573848,2023-02-10,83.89,962.0799999999999
2449,83639740,2023-01-31,0.0,266.62
2550,83639740,2023-02-02,105.52,372.14
2549,83639740,2023-02-02,128.3,500.44
2551,83639740,2023-02-03,38.14,538.5799999999999
2552,83639740,2023-02-09,587.9,1126.48
2553,83639740,2023-02-11,200.58,1327.06
2450,83659554,2023-01-31,0.0,548.94
7702,83659554,2023-02-08,1537.1,2086.04
8575,83659554,2023-02-12,-144.19,1941.85
7703,83659554,2023-02-12,60.3,2002.1499999999999
2451,83668302,2023-01-31,0.0,686.96
3781,83668302,2023-02-03,-46.29,640.6700000000001
3782,83668302,2023-02-07,-11.37,629.3000000000001
3784,83668302,2023-02-12,-209.98,419.32000000000005
3783,83668302,2023-02-12,-28.61,390.71000000000004
8542,83668302,2023-02-12,36.33,427.0400000000001
2452,83672404,2023-01-31,0.0,269.57
1394,83672404,2023-02-01,164.06,433.63
2193,83672404,2023-02-02,-131.02,302.61
2195,83672404,2023-02-04,-614.0,-311.39000000000004
2194,83672404,2023-02-04,-150.01,-461.40000000000003
2196,83672404,2023-02-07,-111.08,-572.48
1395,83672404,2023-02-09,55.42,-517.06
1396,83672404,2023-02-09,75.46,-441.6000000000001
2453,83693383,2023-01-31,0.0,138.05
2811,83693383,2023-02-02,-57.51,80.54000000000002
2812,83693383,2023-02-07,-905.3,-824.76
2814,83693383,2023-02-07,-166.87,-991.6299999999999
2813,83693383,2023-02-07,-38.04,-1029.67
7759,83693383,2023-02-08,189.71,-839.96
7760,83693383,2023-02-10,67.01,-772.9499999999998
7762,83693383,2023-02-14,64.89,-708.06
7761,83693383,2023-02-14,136.49,-571.5699999999999
2454,83698413,2023-01-31,0.0,223.67
7553,83698413,2023-02-07,113.6,337.27
8095,83698413,2023-02-09,-44.19,293.08
8096,83698413,2023-02-12,-100.01,193.07
8097,83698413,2023-02-13,-90.0,103.06999999999998
7554,83698413,2023-02-13,141.46,244.52999999999997
2455,83788130,2023-01-31,0.0,833.68
807,83788130,2023-02-01,-132.46,701.2199999999999
808,83788130,2023-02-02,-76.14,625.0799999999999
810,83788130,2023-02-03,-196.73,428.34999999999997
809,83788130,2023-02-03,-136.61,291.7399999999999
811,83788130,2023-02-06,-161.03,130.70999999999992
7856,83788130,2023-02-08,134.23,264.93999999999994
7857,83788130,2023-02-11,69.84,334.78
2456,83796561,2023-01-31,0.0,410.08
551,83796561,2023-02-01,-2239.3,-1829.2200000000003
552,83796561,2023-02-03,-115.16,-1944.38
5861,83796561,2023-02-04,69.83,-1874.5500000000002
5862,83796561,2023-02-13,124.65,-1749.9
5863,83796561,2023-02-14,187.3,-1562.6000000000004
2457,83828891,2023-01-31,0.0,780.59
6453,83828891,2023-02-05,-136.6,643.99
6093,83828891,2023-02-05,40.41,684.4000000000001
6094,83828891,2023-02-08,120.57,804.97
6454,83828891,2023-02-09,-51.97,753.0
6095,83828891,2023-02-12,84.03,837.03
6096,83828891,2023-02-13,116.37,953.4000000000001
6097,83828891,2023-02-14,68.67,1022.07
2458,83852014,2023-01-31,0.0,830.02
1833,83852014,2023-02-01,103.4,933.42
5481,83852014,2023-02-04,-61.88,871.54
1834,83852014,2023-02-04,57.49,929.03
5482,83852014,2023-02-05,-82.33,846.7
1835,83852014,2023-02-06,154.07,1000.77
5483,83852014,2023-02-12,-84.13,916.64
1836,83852014,2023-02-14,37.22,953.86
2459,83854141,2023-01-31,0.0,280.06
3627,83854141,2023-02-02,-126.94,153.12
3628,83854141,2023-02-04,-71.57,81.55000000000001
5905,83854141,2023-02-05,26.38,107.93
5906,83854141,2023-02-13,109.04,216.97000000000003
5907,83854141,2023-02-14,59.91,276.88
2460,83891783,2023-01-31,0.0,158.08
381,83891783,2023-02-01,-144.25,13.830000000000013
382,83891783,2023-02-02,-128.31,-114.47999999999999
3237,83891783,2023-02-02,15.77,-98.71000000000001
3238,83891783,2023-02-08,118.11,19.400000000000006
383,83891783,2023-02-09,-123.62,-104.22
384,83891783,2023-02-13,-760.4,-864.62
3239,83891783,2023-02-14,32.8,-831.8199999999999
2461,83975923,2023-01-31,0.0,837.45
734,83975923,2023-02-01,-156.79,680.6600000000001
735,83975923,2023-02-06,-68.31,612.35
736,83975923,2023-02-07,-12.66,599.69
737,83975923,2023-02-12,-131.34,468.35
2462,83981442,2023-01-31,0.0,89.35
2498,83981442,2023-02-02,93.56,182.91
2499,83981442,2023-02-02,133.34,316.25
6910,83981442,2023-02-06,-1138.4,-822.1500000000001
2500,83981442,2023-02-07,85.6,-736.5500000000001
2463,84070285,2023-01-31,0.0,796.6
3265,84070285,2023-02-02,-936.1,-139.5
3266,84070285,2023-02-04,-32.62,-172.12
6746,84070285,2023-02-06,160.17,-11.950000000000045
6747,84070285,2023-02-08,117.53,105.58000000000004
3267,84070285,2023-02-12,-128.19,-22.610000000000014
6748,84070285,2023-02-12,1128.7,1106.0900000000001
3268,84070285,2023-02-13,-69.55,1036.54
6750,84070285,2023-02-13,75.77,1112.31
6749,84070285,2023-02-13,82.37,1194.68
2464,84107088,2023-01-31,0.0,2.2
5050,84107088,2023-02-04,116.65,118.85000000000001
6076,84107088,2023-02-05,-65.92,52.93000000000001
5051,84107088,2023-02-05,105.33,158.26
6077,84107088,2023-02-07,-591.2,-432.94000000000005
6078,84107088,2023-02-09,-78.03,-510.9700000000001
6079,84107088,2023-02-09,-35.02,-545.99
2465,84187157,2023-01-31,0.0,252.9
5821,84187157,2023-02-04,-125.07,127.83000000000001
6643,84187157,2023-02-05,184.86,312.69000000000005
6644,84187157,2023-02-07,106.8,419.49
5822,84187157,2023-02-09,-96.36,323.13
5823,84187157,2023-02-14,-178.46,144.67000000000002
6645,84187157,2023-02-14,1485.7,1630.3700000000001
2466,84188877,2023-01-31,0.0,624.29
4833,84188877,2023-02-03,104.82,729.1099999999999
5905,84188877,2023-02-04,-58.55,670.56
5906,84188877,2023-02-05,-183.91,486.65
5907,84188877,2023-02-06,-110.83,375.81999999999994
4834,84188877,2023-02-06,92.7,468.52
5908,84188877,2023-02-09,-67.84,400.67999999999995
5909,84188877,2023-02-09,-56.12,344.55999999999995
5910,84188877,2023-02-10,-1800.7,-1456.1400000000003
5911,84188877,2023-02-11,-1273.1,-2729.24
4835,84188877,2023-02-11,102.13,-2627.11
4836,84188877,2023-02-12,183.73,-2443.38
2467,84275961,2023-01-31,0.0,625.24
773,84275961,2023-02-01,138.19,763.4300000000001
774,84275961,2023-02-03,98.41,861.84
775,84275961,2023-02-03,110.96,972.8
7438,84275961,2023-02-07,-79.84,892.96
776,84275961,2023-02-09,7.96,900.9200000000001
7439,84275961,2023-02-10,-182.75,718.17
2468,84280969,2023-01-31,0.0,161.7
2398,84280969,2023-02-02,92.47,254.17
2399,84280969,2023-02-09,103.44,357.61
8301,84280969,2023-02-10,-75.83,281.78
8303,84280969,2023-02-12,-119.08,162.7
8302,84280969,2023-02-12,-92.56,70.13999999999999
2469,84290934,2023-01-31,0.0,914.5
6048,84290934,2023-02-05,-81.8,832.7
6049,84290934,2023-02-06,-107.8,724.9
6050,84290934,2023-02-06,-67.41,657.49
6051,84290934,2023-02-07,-71.52,585.97
8154,84290934,2023-02-09,185.1,771.0699999999999
2470,84295462,2023-01-31,0.0,154.03
657,84295462,2023-02-01,913.5,1067.53
659,84295462,2023-02-10,89.47,1157.0
658,84295462,2023-02-10,136.73,1293.73
660,84295462,2023-02-11,128.07,1421.8
8531,84295462,2023-02-12,-49.41,1372.3899999999999
2471,84310867,2023-01-31,0.0,258.66
1612,84310867,2023-02-01,65.12,323.78000000000003
8231,84310867,2023-02-10,-144.29,179.49000000000004
1613,84310867,2023-02-11,104.35,283.84000000000003
1615,84310867,2023-02-12,70.46,354.3
1614,84310867,2023-02-12,893.8,1248.1
8232,84310867,2023-02-14,-1295.6,-47.49999999999994
2472,84333228,2023-01-31,0.0,330.99
3699,84333228,2023-02-02,-75.84,255.15
3153,84333228,2023-02-02,190.92,446.07
3154,84333228,2023-02-03,114.6,560.67
3701,84333228,2023-02-05,-118.78,441.89
3700,84333228,2023-02-05,-96.05,345.84
3155,84333228,2023-02-11,84.08,429.91999999999996
2473,84334262,2023-01-31,0.0,525.57
3701,84334262,2023-02-02,93.94,619.51
5341,84334262,2023-02-04,-110.05,509.46000000000004
3702,84334262,2023-02-06,133.3,642.7600000000001
3704,84334262,2023-02-11,105.66,748.4200000000001
3703,84334262,2023-02-11,409.8,1158.2200000000003
5342,84334262,2023-02-12,-207.6,950.6200000000001
3705,84334262,2023-02-13,104.24,1054.8600000000001
5343,84334262,2023-02-14,-201.83,853.0300000000001
2474,84366763,2023-01-31,0.0,734.48
3124,84366763,2023-02-02,-110.43,624.05
6380,84366763,2023-02-05,76.24,700.29
3125,84366763,2023-02-06,-470.6,229.69
3126,84366763,2023-02-11,-1012.8,-783.1099999999999
6382,84366763,2023-02-11,74.51,-708.5999999999999
6381,84366763,2023-02-11,107.54,-601.06
2475,84375036,2023-01-31,0.0,356.1
452,84375036,2023-02-01,114.22,470.32000000000005
7518,84375036,2023-02-07,-313.5,156.82000000000002
453,84375036,2023-02-07,115.15,271.97
454,84375036,2023-02-08,155.15,427.12
7519,84375036,2023-02-11,-130.89,296.23
455,84375036,2023-02-11,69.64,365.87000000000006
456,84375036,2023-02-13,510.4,876.27
2476,84396180,2023-01-31,0.0,103.83
5819,84396180,2023-02-04,54.15,157.98
7984,84396180,2023-02-08,-130.54,27.440000000000012
7985,84396180,2023-02-10,-964.8,-937.36
5820,84396180,2023-02-10,100.43,-836.93
5821,84396180,2023-02-11,31.4,-805.5299999999999
5822,84396180,2023-02-13,156.37,-649.1599999999999
2477,84406205,2023-01-31,0.0,818.63
6044,84406205,2023-02-05,46.34,864.97
6045,84406205,2023-02-08,94.34,959.31
8588,84406205,2023-02-13,-1827.6,-868.2899999999998
8589,84406205,2023-02-14,-72.94,-941.2299999999999
2478,84411377,2023-01-31,0.0,870.25
7539,84411377,2023-02-07,112.51,982.76
8559,84411377,2023-02-12,-351.6,631.16
7540,84411377,2023-02-13,139.83,770.99
2479,84411930,2023-01-31,0.0,916.61
5484,84411930,2023-02-04,-58.05,858.5600000000001
5485,84411930,2023-02-05,-95.84,762.72
5486,84411930,2023-02-05,-36.77,725.95
5487,84411930,2023-02-06,-52.31,673.64
5488,84411930,2023-02-07,-56.32,617.3199999999999
8571,84411930,2023-02-12,163.83,781.1500000000001
2480,84416510,2023-01-31,0.0,793.45
2342,84416510,2023-02-02,-88.86,704.59
2341,84416510,2023-02-02,-31.64,672.95
8122,84416510,2023-02-09,84.55,757.5
8123,84416510,2023-02-11,954.4,1711.9
8124,84416510,2023-02-12,124.59,1836.49
8125,84416510,2023-02-13,72.94,1909.43
2343,84416510,2023-02-14,-404.9,1504.53
2481,84418749,2023-01-31,0.0,457.27
230,84418749,2023-02-01,-78.47,378.79999999999995
1692,84418749,2023-02-01,200.4,579.2
1693,84418749,2023-02-02,46.77,625.97
231,84418749,2023-02-08,-109.06,516.91
1694,84418749,2023-02-09,116.81,633.72
1695,84418749,2023-02-12,21.61,655.3299999999999
1696,84418749,2023-02-13,93.39,748.72
2482,84448752,2023-01-31,0.0,412.15
6903,84448752,2023-02-06,88.91,501.05999999999995
6902,84448752,2023-02-06,1409.6,1910.6599999999999
7787,84448752,2023-02-08,-1253.6,657.0600000000001
6904,84448752,2023-02-08,1368.6,2025.6599999999999
2483,84471701,2023-01-31,0.0,89.27
360,84471701,2023-02-01,62.0,151.26999999999998
361,84471701,2023-02-02,97.37,248.64
6409,84471701,2023-02-05,-55.81,192.82999999999998
362,84471701,2023-02-08,77.23,270.06
2484,84656105,2023-01-31,0.0,547.59
4275,84656105,2023-02-03,-56.77,490.82000000000005
6964,84656105,2023-02-06,109.51,600.33
6963,84656105,2023-02-06,1457.8,2058.13
6965,84656105,2023-02-07,100.78,2158.91
6966,84656105,2023-02-08,189.28,2348.19
4276,84656105,2023-02-13,-105.18,2243.01
2485,84682032,2023-01-31,0.0,612.1
3796,84682032,2023-02-03,-3.5,608.6
3797,84682032,2023-02-09,-149.44,459.16
3798,84682032,2023-02-14,-123.85,335.31000000000006
3799,84682032,2023-02-14,-79.89,255.42000000000002
2486,84695068,2023-01-31,0.0,693.94
8147,84695068,2023-02-09,-74.41,619.5300000000001
8247,84695068,2023-02-10,34.71,654.24
8248,84695068,2023-02-12,1764.4,2418.6400000000003
8148,84695068,2023-02-13,-9.8,2408.84
2487,84714323,2023-01-31,0.0,667.61
4039,84714323,2023-02-03,-43.31,624.3
5152,84714323,2023-02-04,1268.7,1893.0
2488,84746166,2023-01-31,0.0,806.73
4944,84746166,2023-02-03,20.43,827.16
4945,84746166,2023-02-04,24.15,851.3100000000001
6557,84746166,2023-02-05,-59.8,791.51
6558,84746166,2023-02-08,-157.06,634.45
6559,84746166,2023-02-09,-1202.9,-568.45
6560,84746166,2023-02-11,-32.0,-600.45
6561,84746166,2023-02-13,-124.65,-725.1000000000001
6562,84746166,2023-02-14,-98.03,-823.1300000000001
2489,84778718,2023-01-31,0.0,521.14
4375,84778718,2023-02-03,37.49,558.63
4376,84778718,2023-02-05,101.46,660.0899999999999
4377,84778718,2023-02-09,133.43,793.52
8488,84778718,2023-02-11,-78.25,715.27
4378,84778718,2023-02-12,1183.8,1899.0699999999997
4379,84778718,2023-02-13,70.58,1969.65
2490,84822607,2023-01-31,0.0,425.79
3635,84822607,2023-02-02,-93.16,332.63
4825,84822607,2023-02-03,65.15,397.78000000000003
3636,84822607,2023-02-07,-209.73,188.05000000000004
4826,84822607,2023-02-07,77.96,266.01000000000005
4827,84822607,2023-02-08,134.18,400.19000000000005
4828,84822607,2023-02-10,90.33,490.52000000000004
2491,84853260,2023-01-31,0.0,925.31
7327,84853260,2023-02-07,-74.75,850.56
7328,84853260,2023-02-09,-72.3,778.26
8631,84853260,2023-02-13,128.84,907.0999999999999
8632,84853260,2023-02-14,142.57,1049.67
2492,84928531,2023-01-31,0.0,236.36
1601,84928531,2023-02-01,-75.09,161.27
5651,84928531,2023-02-04,186.01,347.28
1602,84928531,2023-02-06,-87.2,260.08
5652,84928531,2023-02-06,138.32,398.4
1603,84928531,2023-02-09,-69.41,328.99
2493,84951477,2023-01-31,0.0,316.2
2651,84951477,2023-02-02,-68.17,248.02999999999997
4235,84951477,2023-02-03,39.9,287.93
4236,84951477,2023-02-06,144.68,432.61
2652,84951477,2023-02-10,-551.6,-118.99000000000007
4237,84951477,2023-02-10,141.06,22.069999999999936
4238,84951477,2023-02-10,174.71,196.77999999999994
2653,84951477,2023-02-13,-61.34,135.43999999999994
2494,84964879,2023-01-31,0.0,629.81
1886,84964879,2023-02-01,106.68,736.49
1887,84964879,2023-02-03,15.12,751.6099999999999
1888,84964879,2023-02-05,45.42,797.03
1889,84964879,2023-02-07,1653.3,2450.33
7802,84964879,2023-02-08,-113.98,2336.35
7803,84964879,2023-02-11,-59.1,2277.25
2495,84969883,2023-01-31,0.0,672.74
3568,84969883,2023-02-02,-128.13,544.61
3569,84969883,2023-02-03,-1179.0,-634.3900000000001
6052,84969883,2023-02-05,139.34,-495.0500000000002
6053,84969883,2023-02-12,845.0,349.94999999999993
6054,84969883,2023-02-13,57.17,407.11999999999995
3570,84969883,2023-02-14,-707.3,-300.18000000000006
3571,84969883,2023-02-14,-117.34,-417.52
2496,84995019,2023-01-31,0.0,731.41
66,84995019,2023-02-01,-126.06,605.3499999999999
65,84995019,2023-02-01,-89.01,516.3399999999999
67,84995019,2023-02-02,-118.32,398.02
4085,84995019,2023-02-03,64.43,462.45
4086,84995019,2023-02-03,195.63,658.0799999999999
68,84995019,2023-02-04,-64.93,593.15
4088,84995019,2023-02-04,85.5,678.65
4087,84995019,2023-02-04,133.46,812.11
4089,84995019,2023-02-04,482.7,1294.81
4090,84995019,2023-02-05,146.21,1441.02
4091,84995019,2023-02-10,148.09,1589.1100000000001
69,84995019,2023-02-11,-69.11,1520.0
4092,84995019,2023-02-14,58.59,1578.5900000000001
2497,85001424,2023-01-31,0.0,653.31
1005,85001424,2023-02-01,-103.68,549.6299999999999
1006,85001424,2023-02-06,-82.51,467.11999999999995
1007,85001424,2023-02-09,-126.2,340.91999999999996
1008,85001424,2023-02-11,-107.51,233.4099999999999
8492,85001424,2023-02-11,149.84,383.24999999999994
8494,85001424,2023-02-14,44.4,427.65
8493,85001424,2023-02-14,94.55,522.1999999999999
2498,85057916,2023-01-31,0.0,656.89
4175,85057916,2023-02-03,18.28,675.17
4176,85057916,2023-02-05,74.52,749.6899999999999
4177,85057916,2023-02-09,26.26,775.95
8345,85057916,2023-02-10,-167.69,608.26
4178,85057916,2023-02-10,76.06,684.3199999999999
4179,85057916,2023-02-10,150.39,834.71
2499,85128569,2023-01-31,0.0,340.68
4220,85128569,2023-02-03,114.58,455.26
7515,85128569,2023-02-07,-65.37,389.89
7516,85128569,2023-02-11,-105.27,284.62
7517,85128569,2023-02-14,-122.97,161.65
2500,85140734,2023-01-31,0.0,699.57
152,85140734,2023-02-01,131.36,830.9300000000001
151,85140734,2023-02-01,205.89,1036.8200000000002
153,85140734,2023-02-02,70.63,1107.45
4256,85140734,2023-02-03,-79.37,1028.08
154,85140734,2023-02-04,77.13,1105.21
4257,85140734,2023-02-08,-2113.3,-1008.0900000000003
4258,85140734,2023-02-12,-143.0,-1151.0900000000001
155,85140734,2023-02-12,71.65,-1079.44
2501,85156953,2023-01-31,0.0,900.09
2777,85156953,2023-02-02,-16.74,883.35
4116,85156953,2023-02-03,81.73,965.08
4117,85156953,2023-02-05,103.29,1068.3700000000001
4118,85156953,2023-02-10,168.19,1236.56
2778,85156953,2023-02-12,-93.42,1143.14
4119,85156953,2023-02-13,68.93,1212.0700000000002
4120,85156953,2023-02-14,2134.6,3346.67
2502,85177718,2023-01-31,0.0,478.18
3869,85177718,2023-02-03,513.3,991.48
6511,85177718,2023-02-05,-131.36,860.1199999999999
3870,85177718,2023-02-14,125.03,985.1499999999999
2503,85182642,2023-01-31,0.0,451.38
7420,85182642,2023-02-07,-108.09,343.28999999999996
7421,85182642,2023-02-08,-96.42,246.87
8413,85182642,2023-02-11,99.35,346.21999999999997
2504,85192761,2023-01-31,0.0,982.48
5893,85192761,2023-02-04,95.76,1078.24
6029,85192761,2023-02-05,-1922.5,-844.26
5894,85192761,2023-02-08,52.45,-791.81
5895,85192761,2023-02-12,151.09,-640.72
2505,85238291,2023-01-31,0.0,665.68
1869,85238291,2023-02-01,-142.98,522.6999999999999
1871,85238291,2023-02-02,-645.8,-123.10000000000002
1870,85238291,2023-02-02,-28.99,-152.09000000000003
1872,85238291,2023-02-05,-94.84,-246.93000000000006
7278,85238291,2023-02-07,163.8,-83.13
7279,85238291,2023-02-08,197.96,114.83000000000004
7280,85238291,2023-02-13,115.9,230.73000000000002
2506,85250129,2023-01-31,0.0,400.91
1275,85250129,2023-02-01,-119.21,281.70000000000005
2561,85250129,2023-02-02,77.14,358.84000000000003
1276,85250129,2023-02-06,-87.33,271.51000000000005
1277,85250129,2023-02-08,-118.76,152.75000000000003
2562,85250129,2023-02-08,952.0,1104.75
1278,85250129,2023-02-10,-135.21,969.54
1279,85250129,2023-02-12,-56.37,913.1700000000001
2507,85265080,2023-01-31,0.0,992.6
1494,85265080,2023-02-01,-126.36,866.24
1493,85265080,2023-02-01,-78.22,788.02
1495,85265080,2023-02-12,-1111.4,-323.38
2508,85310930,2023-01-31,0.0,688.91
7458,85310930,2023-02-07,108.09,797.0
7459,85310930,2023-02-09,121.5,918.5
8421,85310930,2023-02-11,-81.42,837.0799999999999
2509,85336547,2023-01-31,0.0,785.57
4761,85336547,2023-02-03,120.76,906.33
7843,85336547,2023-02-08,-83.2,823.1300000000001
4762,85336547,2023-02-10,222.4,1045.5300000000002
2510,85341369,2023-01-31,0.0,932.11
1061,85341369,2023-02-01,146.39,1078.5
2881,85341369,2023-02-02,-187.4,891.1
2880,85341369,2023-02-02,-149.36,741.74
1062,85341369,2023-02-05,36.56,778.3
2882,85341369,2023-02-06,-34.38,743.92
1063,85341369,2023-02-06,178.4,922.3199999999999
1064,85341369,2023-02-09,67.84,990.16
1065,85341369,2023-02-11,28.34,1018.5
1066,85341369,2023-02-13,137.63,1156.13
2511,85344981,2023-01-31,0.0,874.46
6547,85344981,2023-02-05,-85.08,789.38
7167,85344981,2023-02-06,1024.2,1813.58
7168,85344981,2023-02-08,203.1,2016.68
7169,85344981,2023-02-09,121.16,2137.84
7170,85344981,2023-02-11,120.98,2258.8199999999997
6548,85344981,2023-02-12,-1128.7,1130.12
7171,85344981,2023-02-13,105.71,1235.83
7172,85344981,2023-02-14,64.22,1300.05
2512,85362253,2023-01-31,0.0,790.41
791,85362253,2023-02-01,-63.28,727.13
792,85362253,2023-02-03,-178.54,548.5899999999999
793,85362253,2023-02-04,-61.06,487.53
7645,85362253,2023-02-07,78.85,566.38
7646,85362253,2023-02-08,92.43,658.81
794,85362253,2023-02-12,-76.86,581.95
7647,85362253,2023-02-14,544.0,1125.95
2513,85399459,2023-01-31,0.0,705.94
2185,85399459,2023-02-02,-89.7,616.24
2186,85399459,2023-02-07,-169.12,447.12000000000006
8216,85399459,2023-02-10,37.83,484.95000000000005
2187,85399459,2023-02-11,-1037.0,-552.05
2188,85399459,2023-02-13,-89.1,-641.1499999999999
2514,85420056,2023-01-31,0.0,107.03
5851,85420056,2023-02-04,26.76,133.79
7925,85420056,2023-02-08,-120.11,13.680000000000007
5852,85420056,2023-02-09,94.81,108.49000000000001
5853,85420056,2023-02-11,177.1,285.59000000000003
5854,85420056,2023-02-13,48.77,334.36
2515,85423742,2023-01-31,0.0,131.14
2159,85423742,2023-02-02,84.91,216.04999999999998
2160,85423742,2023-02-09,106.29,322.34
2161,85423742,2023-02-11,11.69,334.03
2162,85423742,2023-02-11,858.7,1192.73
8548,85423742,2023-02-12,-79.07,1113.6599999999999
2163,85423742,2023-02-12,122.62,1236.2800000000002
8549,85423742,2023-02-14,-87.55,1148.73
2516,85435135,2023-01-31,0.0,106.63
3260,85435135,2023-02-02,-72.58,34.05
3261,85435135,2023-02-03,-90.48,-56.43000000000001
3909,85435135,2023-02-03,56.77,0.3400000000000034
3908,85435135,2023-02-03,127.62,127.96000000000001
3910,85435135,2023-02-07,127.93,255.89000000000001
3912,85435135,2023-02-11,110.28,366.17
3911,85435135,2023-02-11,141.75,507.92
3262,85435135,2023-02-12,-178.37,329.55
3913,85435135,2023-02-13,126.46,456.01
2517,85482194,2023-01-31,0.0,997.62
4486,85482194,2023-02-03,160.1,1157.72
4487,85482194,2023-02-05,114.53,1272.25
4488,85482194,2023-02-07,145.86,1418.1100000000001
4489,85482194,2023-02-08,45.23,1463.3400000000001
4490,85482194,2023-02-08,141.86,1605.2
8028,85482194,2023-02-09,-1216.6,388.60000000000014
8029,85482194,2023-02-11,-137.43,251.1700000000002
4491,85482194,2023-02-11,33.64,284.8100000000002
2518,85490561,2023-01-31,0.0,512.78
3852,85490561,2023-02-03,-140.5,372.28
4736,85490561,2023-02-03,119.2,491.47999999999996
4737,85490561,2023-02-07,75.08,566.56
4738,85490561,2023-02-08,190.37,756.93
3853,85490561,2023-02-09,-205.74,551.1899999999999
3854,85490561,2023-02-09,-97.54,453.65
3855,85490561,2023-02-13,-86.25,367.4
2519,85493851,2023-01-31,0.0,796.35
6139,85493851,2023-02-05,-121.03,675.32
7140,85493851,2023-02-06,1.46,676.78
7141,85493851,2023-02-08,96.95,773.73
6140,85493851,2023-02-09,-142.59,631.14
6141,85493851,2023-02-09,-134.75,496.39
7142,85493851,2023-02-14,93.61,590.0
2520,85496714,2023-01-31,0.0,353.13
4022,85496714,2023-02-03,-129.19,223.94
4024,85496714,2023-02-04,-117.79,106.14999999999998
4023,85496714,2023-02-04,-91.41,14.740000000000009
6969,85496714,2023-02-06,60.39,75.13
4025,85496714,2023-02-08,-153.79,-78.65999999999997
6970,85496714,2023-02-09,63.04,-15.620000000000005
4026,85496714,2023-02-10,-116.54,-132.15999999999997
6971,85496714,2023-02-11,110.56,-21.600000000000023
6972,85496714,2023-02-12,69.85,48.25
6973,85496714,2023-02-12,1314.3,1362.55
6975,85496714,2023-02-13,32.94,1395.4899999999998
6974,85496714,2023-02-13,99.37,1494.8600000000001
2521,85498335,2023-01-31,0.0,745.08
5702,85498335,2023-02-04,-80.51,664.57
7639,85498335,2023-02-07,84.97,749.5400000000001
7640,85498335,2023-02-09,122.79,872.33
7641,85498335,2023-02-09,149.64,1021.97
2522,85498936,2023-01-31,0.0,47.77
4758,85498936,2023-02-03,-1935.5,-1887.73
8049,85498936,2023-02-09,158.52,-1729.21
8050,85498936,2023-02-10,39.45,-1689.76
8051,85498936,2023-02-13,0.58,-1689.18
2523,85501046,2023-01-31,0.0,354.76
1003,85501046,2023-02-01,-152.04,202.72
6187,85501046,2023-02-05,158.24,360.96000000000004
1004,85501046,2023-02-08,-57.32,303.64
2524,85503501,2023-01-31,0.0,13.66
1197,85503501,2023-02-01,53.46,67.12
5927,85503501,2023-02-04,-148.08,-80.96000000000001
5928,85503501,2023-02-05,-55.52,-136.48000000000002
1198,85503501,2023-02-05,186.17,49.68999999999997
1199,85503501,2023-02-06,394.5,444.19
1200,85503501,2023-02-08,178.49,622.68
1201,85503501,2023-02-09,190.68,813.36
1202,85503501,2023-02-13,59.04,872.4
2525,85551186,2023-01-31,0.0,909.25
7652,85551186,2023-02-07,-1198.9,-289.6500000000001
7456,85551186,2023-02-07,102.52,-187.1300000000001
7457,85551186,2023-02-09,99.59,-87.54000000000008
2526,85559926,2023-01-31,0.0,423.28
719,85559926,2023-02-01,-125.68,297.59999999999997
7225,85559926,2023-02-06,16.67,314.27
720,85559926,2023-02-07,-56.13,258.14
7226,85559926,2023-02-09,1727.8,1985.9399999999998
7227,85559926,2023-02-10,71.14,2057.08
7228,85559926,2023-02-10,89.09,2146.17
7229,85559926,2023-02-11,50.07,2196.24
721,85559926,2023-02-12,-177.52,2018.7199999999998
7230,85559926,2023-02-12,1071.4,3090.12
2527,85562851,2023-01-31,0.0,499.37
3292,85562851,2023-02-02,-144.51,354.86
3293,85562851,2023-02-03,-141.05,213.81
3294,85562851,2023-02-07,-226.83,-13.019999999999982
7281,85562851,2023-02-07,119.25,106.23000000000002
3295,85562851,2023-02-08,-186.34,-80.11000000000001
3296,85562851,2023-02-08,-19.11,-99.22000000000003
7282,85562851,2023-02-09,158.25,59.02999999999997
3297,85562851,2023-02-12,-66.67,-7.640000000000043
2528,85609963,2023-01-31,0.0,424.83
5233,85609963,2023-02-04,189.72,614.55
5234,85609963,2023-02-05,142.79,757.3399999999999
5235,85609963,2023-02-10,156.22,913.56
2529,85652943,2023-01-31,0.0,424.5
3211,85652943,2023-02-02,-95.52,328.98
3212,85652943,2023-02-03,-854.4,-525.42
4180,85652943,2023-02-03,110.59,-414.8299999999999
4181,85652943,2023-02-09,121.95,-292.88
2530,85679194,2023-01-31,0.0,891.99
6917,85679194,2023-02-06,104.32,996.31
7664,85679194,2023-02-07,-185.02,811.29
6918,85679194,2023-02-09,79.45,890.74
6919,85679194,2023-02-10,31.28,922.02
6920,85679194,2023-02-13,38.26,960.28
2531,85709972,2023-01-31,0.0,936.57
6547,85709972,2023-02-05,45.1,981.6700000000001
6548,85709972,2023-02-11,173.7,1155.3700000000001
2532,85723355,2023-01-31,0.0,745.34
6113,85723355,2023-02-05,-6.72,738.62
6114,85723355,2023-02-08,-187.24,551.38
8528,85723355,2023-02-12,112.23,663.61
6115,85723355,2023-02-13,-30.37,633.24
6116,85723355,2023-02-14,-1773.6,-1140.3599999999997
2533,85724829,2023-01-31,0.0,189.94
2431,85724829,2023-02-02,-2.63,187.31
2501,85724829,2023-02-02,49.63,236.94
2432,85724829,2023-02-03,-23.5,213.44
2433,85724829,2023-02-08,-122.81,90.63
2502,85724829,2023-02-08,108.96,199.58999999999997
2434,85724829,2023-02-10,-74.15,125.43999999999998
2503,85724829,2023-02-10,141.46,266.9
2504,85724829,2023-02-10,148.63,415.53
2505,85724829,2023-02-11,185.47,601.0
2506,85724829,2023-02-13,39.15,640.15
2534,85771346,2023-01-31,0.0,458.88
7374,85771346,2023-02-07,-201.7,257.18
7375,85771346,2023-02-08,-570.9,-313.7199999999999
2535,85826354,2023-01-31,0.0,611.74
3591,85826354,2023-02-02,-80.3,531.44
4809,85826354,2023-02-03,52.49,583.9300000000001
4810,85826354,2023-02-05,100.81,684.74
3592,85826354,2023-02-13,-44.38,640.36
4811,85826354,2023-02-13,64.85,705.21
2536,85839285,2023-01-31,0.0,728.06
313,85839285,2023-02-01,637.1,1365.1599999999999
3767,85839285,2023-02-03,-136.43,1228.73
314,85839285,2023-02-06,104.85,1333.58
315,85839285,2023-02-07,124.7,1458.28
3768,85839285,2023-02-09,-65.77,1392.51
3769,85839285,2023-02-10,-193.12,1199.3899999999999
3770,85839285,2023-02-13,-68.86,1130.53
2537,85841767,2023-01-31,0.0,458.43
1723,85841767,2023-02-01,-111.89,346.54
3752,85841767,2023-02-03,90.58,437.12
1724,85841767,2023-02-04,-90.44,346.68
3753,85841767,2023-02-04,14.63,361.31
1725,85841767,2023-02-06,-110.66,250.65
1726,85841767,2023-02-08,-134.88,115.77000000000004
1727,85841767,2023-02-08,-70.92,44.85000000000002
1728,85841767,2023-02-10,-168.64,-123.79000000000002
1729,85841767,2023-02-13,-216.37,-340.1599999999999
1730,85841767,2023-02-14,-37.74,-377.8999999999999
2538,85846175,2023-01-31,0.0,22.88
4603,85846175,2023-02-03,56.99,79.87
5726,85846175,2023-02-04,-117.97,-38.099999999999994
4604,85846175,2023-02-04,112.13,74.03
4605,85846175,2023-02-07,15.66,89.69
5727,85846175,2023-02-08,-113.65,-23.960000000000004
5728,85846175,2023-02-09,-101.26,-125.22000000000003
4607,85846175,2023-02-11,114.34,-10.880000000000006
4606,85846175,2023-02-11,197.9,187.01999999999998
4608,85846175,2023-02-12,115.87,302.89
4609,85846175,2023-02-14,164.38,467.27
2539,85848442,2023-01-31,0.0,118.46
2671,85848442,2023-02-02,-141.97,-23.510000000000005
2672,85848442,2023-02-07,-118.92,-142.43
7426,85848442,2023-02-07,301.0,158.57
2673,85848442,2023-02-08,-1537.1,-1378.5299999999997
2674,85848442,2023-02-08,-103.57,-1482.0999999999997
2675,85848442,2023-02-10,-168.35,-1650.4499999999998
7427,85848442,2023-02-10,74.72,-1575.7299999999998
7428,85848442,2023-02-10,87.35,-1488.3799999999997
2677,85848442,2023-02-11,-77.54,-1565.9199999999998
2676,85848442,2023-02-11,-45.67,-1611.5899999999997
2540,85874418,2023-01-31,0.0,151.83
1304,85874418,2023-02-01,-151.41,0.4200000000000159
1305,85874418,2023-02-02,-33.06,-32.639999999999986
3026,85874418,2023-02-02,110.52,77.88000000000001
1306,85874418,2023-02-03,-247.64,-169.75999999999996
3027,85874418,2023-02-03,113.54,-56.21999999999994
3028,85874418,2023-02-06,111.97,55.75000000000004
1307,85874418,2023-02-08,-1805.6,-1749.85
1308,85874418,2023-02-12,-61.36,-1811.2099999999998
2541,85902834,2023-01-31,0.0,357.94
3460,85902834,2023-02-02,88.86,446.8
3461,85902834,2023-02-03,23.24,470.03999999999996
7172,85902834,2023-02-06,-107.61,362.43
3462,85902834,2023-02-06,178.37,540.8
7173,85902834,2023-02-07,-127.93,412.87
7174,85902834,2023-02-08,-120.35,292.52
7175,85902834,2023-02-10,-160.72,131.8
3463,85902834,2023-02-11,138.48,270.28
7176,85902834,2023-02-13,-83.84,186.44
3464,85902834,2023-02-13,731.4,917.8399999999999
2542,85919813,2023-01-31,0.0,647.36
1228,85919813,2023-02-01,106.8,754.16
7449,85919813,2023-02-07,-171.45,582.71
7450,85919813,2023-02-09,-77.66,505.05
7451,85919813,2023-02-12,-81.83,423.22
2543,85924719,2023-01-31,0.0,472.05
7940,85924719,2023-02-08,1872.8,2344.85
8184,85924719,2023-02-09,-77.33,2267.52
7941,85924719,2023-02-11,1010.6,3278.12
2544,85939269,2023-01-31,0.0,223.1
882,85939269,2023-02-01,-121.91,101.19
2257,85939269,2023-02-02,534.5,635.69
883,85939269,2023-02-05,-181.23,454.46000000000004
884,85939269,2023-02-06,-151.33,303.13
885,85939269,2023-02-10,-174.71,128.42000000000002
886,85939269,2023-02-13,-121.3,7.120000000000033
2258,85939269,2023-02-13,154.15,161.27
2545,85940057,2023-01-31,0.0,521.37
1675,85940057,2023-02-01,1069.7,1591.0700000000002
5797,85940057,2023-02-04,-100.53,1490.54
5798,85940057,2023-02-05,-1136.4,354.14
1676,85940057,2023-02-05,49.85,403.99
5799,85940057,2023-02-12,-989.2,-585.2100000000002
5800,85940057,2023-02-12,-110.14,-695.35
2546,85951663,2023-01-31,0.0,385.0
941,85951663,2023-02-01,99.45,484.45
3132,85951663,2023-02-02,-133.67,350.78000000000003
942,85951663,2023-02-02,184.29,535.0699999999999
943,85951663,2023-02-02,233.36,768.4300000000001
3133,85951663,2023-02-03,-122.22,646.21
944,85951663,2023-02-04,255.0,901.21
3135,85951663,2023-02-08,-215.14,686.07
3134,85951663,2023-02-08,-105.97,580.1
3136,85951663,2023-02-14,-125.03,455.07000000000005
2547,85994636,2023-01-31,0.0,819.24
1115,85994636,2023-02-01,-114.04,705.2
1116,85994636,2023-02-02,-104.79,600.41
1117,85994636,2023-02-04,-1410.9,-810.49
5798,85994636,2023-02-04,1361.0,550.51
5799,85994636,2023-02-08,65.85,616.36
1118,85994636,2023-02-09,-96.08,520.28
5800,85994636,2023-02-12,63.33,583.61
5801,85994636,2023-02-12,123.24,706.85
5802,85994636,2023-02-13,104.7,811.55
2548,86007729,2023-01-31,0.0,320.78
6551,86007729,2023-02-05,97.55,418.33
8249,86007729,2023-02-10,-29.52,388.80999999999995
6552,86007729,2023-02-12,111.6,500.40999999999997
6553,86007729,2023-02-13,72.81,573.22
2549,86020532,2023-01-31,0.0,972.95
6146,86020532,2023-02-05,-95.98,876.97
8485,86020532,2023-02-11,120.19,997.1600000000001
8486,86020532,2023-02-12,44.97,1042.13
6147,86020532,2023-02-13,-56.91,985.22
2550,86031592,2023-01-31,0.0,637.42
2103,86031592,2023-02-01,-135.0,502.41999999999996
45,86031592,2023-02-01,124.24,626.66
47,86031592,2023-02-02,51.28,677.9399999999999
46,86031592,2023-02-02,180.16,858.0999999999999
2104,86031592,2023-02-03,-56.89,801.2099999999999
48,86031592,2023-02-03,70.8,872.01
2105,86031592,2023-02-04,-398.1,473.9099999999999
49,86031592,2023-02-05,78.96,552.8699999999999
50,86031592,2023-02-10,144.29,697.1599999999999
2106,86031592,2023-02-11,-331.8,365.3599999999999
51,86031592,2023-02-13,86.51,451.8699999999999
2551,86053438,2023-01-31,0.0,303.06
64,86053438,2023-02-01,1152.9,1455.96
65,86053438,2023-02-02,116.0,1571.96
5925,86053438,2023-02-04,-150.45,1421.51
5926,86053438,2023-02-10,-42.14,1379.3700000000001
67,86053438,2023-02-13,77.52,1456.89
66,86053438,2023-02-13,147.5,1604.39
2552,86068003,2023-01-31,0.0,567.14
4564,86068003,2023-02-03,-129.77,437.37
4723,86068003,2023-02-03,3.24,440.60999999999996
4724,86068003,2023-02-06,63.7,504.31
4725,86068003,2023-02-07,79.99,584.3
4565,86068003,2023-02-08,-693.4,-109.10000000000002
4567,86068003,2023-02-11,-56.7,-165.80000000000007
4566,86068003,2023-02-11,-42.95,-208.75
4726,86068003,2023-02-12,84.03,-124.72000000000003
4727,86068003,2023-02-14,2620.1,2495.3799999999997
2553,86086812,2023-01-31,0.0,832.82
2847,86086812,2023-02-02,-106.61,726.21
2848,86086812,2023-02-13,-105.74,620.47
2554,86092750,2023-01-31,0.0,261.57
4369,86092750,2023-02-03,952.0,1213.57
7790,86092750,2023-02-08,-91.53,1122.04
4370,86092750,2023-02-09,155.22,1277.26
7791,86092750,2023-02-10,-80.91,1196.35
2555,86106528,2023-01-31,0.0,238.55
3699,86106528,2023-02-02,120.72,359.27
3700,86106528,2023-02-06,11.94,371.21000000000004
2556,86108287,2023-01-31,0.0,523.61
6247,86108287,2023-02-05,61.25,584.86
6248,86108287,2023-02-08,167.35,752.21
8299,86108287,2023-02-10,-1210.3,-458.0899999999999
8300,86108287,2023-02-10,-86.14,-544.2299999999999
6249,86108287,2023-02-11,40.3,-503.92999999999995
2557,86131065,2023-01-31,0.0,920.08
6308,86131065,2023-02-05,-114.02,806.0600000000001
7255,86131065,2023-02-07,26.33,832.3900000000001
7256,86131065,2023-02-08,154.2,986.59
6309,86131065,2023-02-09,-73.98,912.61
2558,86155528,2023-01-31,0.0,772.38
1295,86155528,2023-02-01,81.56,853.94
1296,86155528,2023-02-06,161.12,1015.06
7896,86155528,2023-02-08,-63.8,951.26
7897,86155528,2023-02-09,-107.63,843.63
1297,86155528,2023-02-13,33.04,876.6700000000001
2559,86169883,2023-01-31,0.0,452.25
6812,86169883,2023-02-06,-52.84,399.40999999999997
7675,86169883,2023-02-07,98.66,498.07
6813,86169883,2023-02-08,-165.79,332.28
6815,86169883,2023-02-12,-191.61,140.66999999999996
6814,86169883,2023-02-12,-164.03,-23.360000000000014
6816,86169883,2023-02-12,-151.06,-174.42000000000007
6817,86169883,2023-02-13,-57.17,-231.59000000000003
6818,86169883,2023-02-14,-143.83,-375.4200000000001
7676,86169883,2023-02-14,69.79,-305.63
2560,86190489,2023-01-31,0.0,237.72
4331,86190489,2023-02-03,-108.09,129.63
6145,86190489,2023-02-05,860.7,990.33
4333,86190489,2023-02-07,-184.29,806.0400000000001
4332,86190489,2023-02-07,-182.27,623.77
4334,86190489,2023-02-13,-136.67,487.1
4335,86190489,2023-02-13,-89.42,397.68000000000006
6146,86190489,2023-02-14,191.09,588.77
2561,86207903,2023-01-31,0.0,911.44
1738,86207903,2023-02-01,-131.27,780.1700000000001
1737,86207903,2023-02-01,-41.18,738.99
1739,86207903,2023-02-05,-97.55,641.44
1740,86207903,2023-02-06,-54.71,586.73
6650,86207903,2023-02-06,1085.4,1672.13
1741,86207903,2023-02-07,-189.62,1482.5100000000002
1742,86207903,2023-02-10,-108.81,1373.7
1743,86207903,2023-02-11,-1035.1,338.60000000000014
1744,86207903,2023-02-12,-92.53,246.07000000000016
2562,86218347,2023-01-31,0.0,481.16
1042,86218347,2023-02-01,165.66,646.82
7299,86218347,2023-02-07,-80.47,566.35
1043,86218347,2023-02-07,1581.8,2148.15
7300,86218347,2023-02-09,-52.73,2095.42
7301,86218347,2023-02-10,-1463.6,631.8200000000002
1044,86218347,2023-02-10,146.12,777.94
1045,86218347,2023-02-11,100.23,878.1700000000001
1046,86218347,2023-02-14,156.02,1034.19
2563,86228741,2023-01-31,0.0,562.04
6756,86228741,2023-02-06,-114.11,447.92999999999995
6757,86228741,2023-02-10,-139.65,308.28
8623,86228741,2023-02-13,156.49,464.77
2564,86263956,2023-01-31,0.0,852.67
8341,86263956,2023-02-10,-80.77,771.9
8342,86263956,2023-02-12,-111.68,660.22
2565,86266595,2023-01-31,0.0,539.96
1946,86266595,2023-02-01,-156.73,383.23
3611,86266595,2023-02-02,115.05,498.28000000000003
1947,86266595,2023-02-05,-159.3,338.98
3612,86266595,2023-02-05,357.9,696.88
1948,86266595,2023-02-09,-47.07,649.81
1949,86266595,2023-02-09,-8.38,641.43
3613,86266595,2023-02-10,122.66,764.0899999999999
1950,86266595,2023-02-11,-60.37,703.72
1951,86266595,2023-02-13,-100.05,603.67
1952,86266595,2023-02-14,-36.2,567.47
2566,86268635,2023-01-31,0.0,679.32
2993,86268635,2023-02-02,77.54,756.86
2994,86268635,2023-02-03,84.12,840.98
2995,86268635,2023-02-04,152.48,993.46
2567,86272488,2023-01-31,0.0,11.73
822,86272488,2023-02-01,-90.79,-79.06
823,86272488,2023-02-03,-156.35,-235.41
4397,86272488,2023-02-03,13.61,-221.80000000000004
4398,86272488,2023-02-05,144.1,-77.7
4399,86272488,2023-02-14,88.35,10.649999999999988
2568,86297017,2023-01-31,0.0,803.81
190,86297017,2023-02-01,103.04,906.8499999999999
4857,86297017,2023-02-03,-80.26,826.5899999999999
4858,86297017,2023-02-04,-67.91,758.68
191,86297017,2023-02-10,715.5,1474.1799999999998
192,86297017,2023-02-11,531.4,2005.58
4859,86297017,2023-02-13,-89.3,1916.28
2569,86339581,2023-01-31,0.0,91.76
3646,86339581,2023-02-02,126.16,217.92000000000002
3647,86339581,2023-02-03,48.23,266.15
5577,86339581,2023-02-04,-47.33,218.82
5578,86339581,2023-02-06,-246.82,-27.999999999999986
5579,86339581,2023-02-07,-108.09,-136.08999999999997
3648,86339581,2023-02-08,166.36,30.270000000000024
5580,86339581,2023-02-10,-74.6,-44.32999999999997
5581,86339581,2023-02-11,-1107.1,-1151.4299999999998
3649,86339581,2023-02-11,133.59,-1017.8399999999999
2570,86339899,2023-01-31,0.0,460.69
2063,86339899,2023-02-01,-601.7,-141.01000000000005
1460,86339899,2023-02-01,615.8,474.7899999999999
1461,86339899,2023-02-03,171.99,646.78
2064,86339899,2023-02-04,-127.8,518.9799999999999
2065,86339899,2023-02-06,-138.32,380.6599999999999
1462,86339899,2023-02-06,1792.7,2173.36
1463,86339899,2023-02-07,71.01,2244.37
2066,86339899,2023-02-10,-64.28,2180.09
1464,86339899,2023-02-10,80.58,2260.67
2067,86339899,2023-02-11,-114.84,2145.83
2571,86406958,2023-01-31,0.0,842.43
2568,86406958,2023-02-02,-27.69,814.7399999999999
2569,86406958,2023-02-06,-687.1,127.63999999999987
8371,86406958,2023-02-10,34.99,162.62999999999988
8372,86406958,2023-02-13,93.14,255.76999999999987
8373,86406958,2023-02-14,66.88,322.64999999999986
8374,86406958,2023-02-14,68.7,391.34999999999985
2572,86439949,2023-01-31,0.0,782.42
2333,86439949,2023-02-02,12.87,795.29
2332,86439949,2023-02-02,66.42,861.7099999999999
4445,86439949,2023-02-03,-56.99,804.7199999999999
4444,86439949,2023-02-03,-27.88,776.8399999999999
4446,86439949,2023-02-05,-109.7,667.14
4447,86439949,2023-02-09,-735.1,-67.96000000000004
2573,86489618,2023-01-31,0.0,488.7
4362,86489618,2023-02-03,-5.31,483.39
6801,86489618,2023-02-06,37.9,521.29
6802,86489618,2023-02-09,166.16,687.45
6803,86489618,2023-02-13,2.0,689.45
2574,86496446,2023-01-31,0.0,124.84
1578,86496446,2023-02-01,-85.61,39.230000000000004
7357,86496446,2023-02-07,137.51,176.74
7358,86496446,2023-02-08,138.31,315.04999999999995
7359,86496446,2023-02-11,151.17,466.22
7360,86496446,2023-02-14,95.87,562.09
2575,86530050,2023-01-31,0.0,447.17
609,86530050,2023-02-01,103.16,550.33
4074,86530050,2023-02-03,-90.66,459.67
4075,86530050,2023-02-04,-128.26,331.41
4076,86530050,2023-02-07,-169.25,162.16000000000003
4077,86530050,2023-02-09,-102.35,59.81
4078,86530050,2023-02-09,-57.36,2.4500000000000455
611,86530050,2023-02-09,31.87,34.32000000000005
610,86530050,2023-02-09,138.85,173.17000000000002
4079,86530050,2023-02-14,-119.1,54.06999999999999
612,86530050,2023-02-14,30.74,84.81
613,86530050,2023-02-14,158.33,243.14000000000004
2576,86596620,2023-01-31,0.0,512.69
5741,86596620,2023-02-04,42.74,555.4300000000001
7479,86596620,2023-02-07,-24.34,531.09
7480,86596620,2023-02-10,-70.43,460.6600000000001
5742,86596620,2023-02-11,84.35,545.01
7481,86596620,2023-02-12,-142.86,402.15000000000003
2577,86624158,2023-01-31,0.0,818.29
5237,86624158,2023-02-04,-124.23,694.06
6155,86624158,2023-02-05,97.55,791.6099999999999
6156,86624158,2023-02-07,169.03,960.64
5238,86624158,2023-02-08,-101.89,858.75
6157,86624158,2023-02-09,56.03,914.78
5239,86624158,2023-02-10,-94.45,820.3299999999999
6159,86624158,2023-02-11,126.42,946.75
6158,86624158,2023-02-11,179.27,1126.02
2578,86637863,2023-01-31,0.0,672.86
4871,86637863,2023-02-03,105.11,777.97
4872,86637863,2023-02-04,155.63,933.6
6435,86637863,2023-02-05,-78.36,855.24
6436,86637863,2023-02-06,-27.56,827.6800000000001
4873,86637863,2023-02-08,87.73,915.4100000000001
6437,86637863,2023-02-12,-91.23,824.1800000000001
2579,86655008,2023-01-31,0.0,671.72
562,86655008,2023-02-01,-52.9,618.82
1096,86655008,2023-02-01,84.07,702.89
563,86655008,2023-02-03,-198.29,504.6
564,86655008,2023-02-04,-900.7,-396.10000000000014
565,86655008,2023-02-09,-66.83,-462.93000000000006
1097,86655008,2023-02-09,98.31,-364.6200000000001
566,86655008,2023-02-13,-142.99,-507.6099999999999
1098,86655008,2023-02-14,115.38,-392.23
2580,86698396,2023-01-31,0.0,314.21
4527,86698396,2023-02-03,113.68,427.89
2581,86728138,2023-01-31,0.0,175.36
5678,86728138,2023-02-04,-214.78,-39.41999999999999
5679,86728138,2023-02-07,-113.6,-153.01999999999998
7379,86728138,2023-02-07,162.23,9.210000000000008
5680,86728138,2023-02-08,-157.76,-148.54999999999995
2582,86737119,2023-01-31,0.0,432.69
5636,86737119,2023-02-04,-158.98,273.71000000000004
5669,86737119,2023-02-04,244.13,517.84
5637,86737119,2023-02-05,-772.5,-254.66000000000003
5638,86737119,2023-02-06,-193.27,-447.93
5639,86737119,2023-02-07,-152.63,-600.56
5671,86737119,2023-02-07,76.84,-523.72
5670,86737119,2023-02-07,123.68,-400.04
5672,86737119,2023-02-07,197.12,-202.92000000000002
5673,86737119,2023-02-09,176.56,-26.360000000000014
5674,86737119,2023-02-13,148.57,122.20999999999998
5675,86737119,2023-02-14,73.77,195.97999999999996
2583,86765156,2023-01-31,0.0,290.53
3208,86765156,2023-02-02,118.87,409.4
6656,86765156,2023-02-05,-65.68,343.71999999999997
3210,86765156,2023-02-09,97.79,441.51
3209,86765156,2023-02-09,176.29,617.8
2584,86785126,2023-01-31,0.0,148.21
2957,86785126,2023-02-02,-225.34,-77.13
4003,86785126,2023-02-03,104.95,27.820000000000007
2958,86785126,2023-02-04,-103.81,-75.98999999999998
2959,86785126,2023-02-05,-80.83,-156.81999999999996
4004,86785126,2023-02-07,147.04,-9.780000000000001
2960,86785126,2023-02-11,-47.98,-57.75999999999999
2961,86785126,2023-02-14,-412.8,-470.55999999999995
4005,86785126,2023-02-14,643.9,173.3399999999999
2585,86788651,2023-01-31,0.0,593.38
615,86788651,2023-02-01,152.04,745.42
614,86788651,2023-02-01,218.14,963.56
5871,86788651,2023-02-04,-85.5,878.06
5872,86788651,2023-02-07,-283.4,594.66
5873,86788651,2023-02-07,-101.07,493.59
616,86788651,2023-02-13,128.76,622.3499999999999
5874,86788651,2023-02-14,-162.35,460.0
5875,86788651,2023-02-14,-90.79,369.21
2586,86795912,2023-01-31,0.0,295.95
6578,86795912,2023-02-05,-119.75,176.2
6579,86795912,2023-02-08,-98.0,78.19999999999999
8117,86795912,2023-02-09,132.48,210.67999999999998
6580,86795912,2023-02-12,-877.5,-666.8199999999999
8118,86795912,2023-02-14,170.78,-496.04
2587,86816054,2023-01-31,0.0,391.59
4748,86816054,2023-02-03,109.86,501.45
6744,86816054,2023-02-06,-83.26,418.18999999999994
6745,86816054,2023-02-07,-1255.9,-837.7100000000003
4749,86816054,2023-02-09,69.0,-768.7100000000003
4750,86816054,2023-02-09,164.72,-603.9900000000002
4751,86816054,2023-02-12,80.44,-523.5500000000002
2588,86864320,2023-01-31,0.0,611.14
1449,86864320,2023-02-01,-103.58,507.56
6352,86864320,2023-02-05,183.42,690.98
1450,86864320,2023-02-06,-63.43,627.55
6353,86864320,2023-02-06,138.14,765.6899999999999
6354,86864320,2023-02-13,99.8,865.49
6355,86864320,2023-02-14,126.71,992.1999999999999
2589,86870860,2023-01-31,0.0,987.14
2962,86870860,2023-02-02,-1556.9,-569.7600000000001
3481,86870860,2023-02-02,130.93,-438.83000000000004
2963,86870860,2023-02-05,-146.29,-585.12
2964,86870860,2023-02-06,-187.58,-772.7000000000002
3482,86870860,2023-02-07,78.9,-693.8000000000001
2965,86870860,2023-02-10,-98.63,-792.4300000000002
3483,86870860,2023-02-12,228.38,-564.0500000000001
2966,86870860,2023-02-13,-133.35,-697.4
2967,86870860,2023-02-14,-131.53,-828.9300000000002
2590,86893452,2023-01-31,0.0,641.84
59,86893452,2023-02-01,-1152.9,-511.06000000000006
883,86893452,2023-02-01,108.17,-402.89
60,86893452,2023-02-04,-46.13,-449.0200000000001
884,86893452,2023-02-06,119.58,-329.44000000000005
885,86893452,2023-02-07,152.63,-176.81000000000006
886,86893452,2023-02-08,92.25,-84.56000000000006
61,86893452,2023-02-09,-96.28,-180.84000000000003
62,86893452,2023-02-10,-46.29,-227.1300000000001
887,86893452,2023-02-10,79.77,-147.36
63,86893452,2023-02-12,-94.03,-241.3900000000001
64,86893452,2023-02-14,-124.48,-365.8700000000001
2591,86941058,2023-01-31,0.0,337.99
1119,86941058,2023-02-01,-92.85,245.14000000000001
522,86941058,2023-02-01,148.96,394.1
523,86941058,2023-02-01,150.96,545.0600000000001
521,86941058,2023-02-01,466.7,1011.76
1120,86941058,2023-02-03,-21.03,990.73
524,86941058,2023-02-05,1233.7,2224.4300000000003
1122,86941058,2023-02-07,-64.02,2160.41
1121,86941058,2023-02-07,-53.6,2106.8100000000004
525,86941058,2023-02-07,110.05,2216.86
1123,86941058,2023-02-08,-1800.8,416.0600000000002
1124,86941058,2023-02-09,-102.59,313.47000000000014
1125,86941058,2023-02-09,-85.04,228.43000000000018
526,86941058,2023-02-09,105.33,333.76000000000016
527,86941058,2023-02-11,173.15,506.9100000000002
528,86941058,2023-02-13,159.64,666.5500000000002
1126,86941058,2023-02-14,-148.07,518.4800000000001
529,86941058,2023-02-14,505.6,1024.0800000000002
2592,86995846,2023-01-31,0.0,956.26
5470,86995846,2023-02-04,-50.69,905.5699999999999
7164,86995846,2023-02-06,132.29,1037.86
7165,86995846,2023-02-07,96.08,1133.94
5471,86995846,2023-02-09,-88.73,1045.21
7166,86995846,2023-02-09,45.7,1090.9099999999999
5472,86995846,2023-02-10,-126.15,964.76
2593,87010556,2023-01-31,0.0,175.33
4322,87010556,2023-02-03,41.04,216.37
4324,87010556,2023-02-07,105.53,321.9
4323,87010556,2023-02-07,112.22,434.12
4325,87010556,2023-02-11,90.36,524.48
4326,87010556,2023-02-12,99.56,624.04
8630,87010556,2023-02-13,-0.58,623.46
2594,87101816,2023-01-31,0.0,862.87
1836,87101816,2023-02-01,-150.96,711.91
1837,87101816,2023-02-04,-567.7,144.20999999999992
7322,87101816,2023-02-07,164.85,309.05999999999995
7323,87101816,2023-02-08,7.94,316.9999999999999
7324,87101816,2023-02-10,182.87,499.8699999999999
7325,87101816,2023-02-11,77.75,577.6199999999999
1839,87101816,2023-02-14,-99.95,477.6699999999999
1838,87101816,2023-02-14,-81.74,395.92999999999995
2595,87121270,2023-01-31,0.0,122.09
5517,87121270,2023-02-04,-94.72,27.370000000000005
5516,87121270,2023-02-04,-86.9,-59.53
5518,87121270,2023-02-08,-175.97,-235.50000000000003
5519,87121270,2023-02-12,-109.65,-345.15
2596,87133080,2023-01-31,0.0,947.42
6515,87133080,2023-02-05,-197.22,750.1999999999999
6516,87133080,2023-02-07,-1151.1,-400.9
6517,87133080,2023-02-08,-85.98,-486.88
8290,87133080,2023-02-10,127.34,-359.5400000000001
6518,87133080,2023-02-14,-67.47,-427.0099999999999
2597,87171530,2023-01-31,0.0,705.41
1656,87171530,2023-02-01,-102.91,602.5
4400,87171530,2023-02-03,107.8,710.3
1657,87171530,2023-02-05,-55.38,654.92
1658,87171530,2023-02-06,-784.3,-129.38
4401,87171530,2023-02-06,21.12,-108.25999999999999
1659,87171530,2023-02-10,-39.48,-147.74
4402,87171530,2023-02-10,112.36,-35.379999999999995
4403,87171530,2023-02-11,182.68,147.30000000000007
1660,87171530,2023-02-13,-36.43,110.87
1661,87171530,2023-02-14,-113.78,-2.909999999999968
2598,87179572,2023-01-31,0.0,527.23
1298,87179572,2023-02-01,1292.5,1819.73
3329,87179572,2023-02-02,-107.47,1712.26
1299,87179572,2023-02-03,74.5,1786.76
1300,87179572,2023-02-04,185.63,1972.39
3330,87179572,2023-02-05,-69.93,1902.46
3331,87179572,2023-02-07,-109.43,1793.03
3332,87179572,2023-02-07,-43.28,1749.75
1301,87179572,2023-02-13,91.43,1841.18
1302,87179572,2023-02-13,223.88,2065.06
2599,87195449,2023-01-31,0.0,493.58
8007,87195449,2023-02-09,126.81,620.39
8008,87195449,2023-02-10,110.9,731.29
8612,87195449,2023-02-13,-445.8,285.49
2600,87231063,2023-01-31,0.0,305.69
5570,87231063,2023-02-04,83.95,389.64
7589,87231063,2023-02-07,-96.86,292.78
2601,87261089,2023-01-31,0.0,613.62
8647,87261089,2023-02-13,152.6,766.22
2602,87261106,2023-01-31,0.0,203.16
6758,87261106,2023-02-06,-57.88,145.28
6759,87261106,2023-02-08,-24.94,120.33999999999999
6760,87261106,2023-02-09,-126.81,-6.469999999999999
6761,87261106,2023-02-09,-55.42,-61.890000000000015
8017,87261106,2023-02-09,187.78,125.88999999999999
6762,87261106,2023-02-11,-149.28,-23.390000000000015
6763,87261106,2023-02-13,-18.04,-41.43000000000001
2603,87276000,2023-01-31,0.0,826.21
997,87276000,2023-02-01,119.88,946.09
996,87276000,2023-02-01,179.6,1125.69
6068,87276000,2023-02-05,-74.37,1051.32
998,87276000,2023-02-09,46.3,1097.62
6069,87276000,2023-02-10,-40.2,1057.42
999,87276000,2023-02-13,90.4,1147.8200000000002
2604,87297577,2023-01-31,0.0,351.06
4628,87297577,2023-02-03,-101.75,249.31
3772,87297577,2023-02-03,109.74,359.05
4629,87297577,2023-02-04,-155.57,203.48000000000002
3773,87297577,2023-02-05,117.54,321.02000000000004
4630,87297577,2023-02-14,-49.4,271.62
2605,87325576,2023-01-31,0.0,354.27
1653,87325576,2023-02-01,-185.45,168.82
3727,87325576,2023-02-03,134.13,302.95
1654,87325576,2023-02-07,-79.32,223.63
1655,87325576,2023-02-10,-196.24,27.389999999999986
3728,87325576,2023-02-11,116.37,143.76
3729,87325576,2023-02-13,2.26,146.01999999999998
2606,87356428,2023-01-31,0.0,705.05
7233,87356428,2023-02-06,42.19,747.24
7234,87356428,2023-02-08,79.16,826.4
7235,87356428,2023-02-10,101.74,928.1399999999999
7236,87356428,2023-02-10,213.8,1141.94
2607,87373821,2023-01-31,0.0,945.0
2,87373821,2023-02-01,-163.82,781.1800000000001
3,87373821,2023-02-01,-69.91,711.27
4474,87373821,2023-02-03,27.88,739.15
4475,87373821,2023-02-06,999.1,1738.25
4,87373821,2023-02-07,-54.28,1683.97
5,87373821,2023-02-08,-111.05,1572.92
4476,87373821,2023-02-08,133.65,1706.57
4477,87373821,2023-02-14,175.48,1882.05
2608,87433733,2023-01-31,0.0,34.77
2859,87433733,2023-02-02,-139.25,-104.47999999999999
2953,87433733,2023-02-02,104.72,0.240000000000002
2860,87433733,2023-02-05,-71.17,-70.93
2861,87433733,2023-02-06,-83.76,-154.69
2862,87433733,2023-02-08,-158.67,-313.36
2954,87433733,2023-02-09,239.1,-74.25999999999999
2863,87433733,2023-02-12,-139.75,-214.01
2864,87433733,2023-02-13,-159.64,-373.65
2609,87456121,2023-01-31,0.0,257.5
1333,87456121,2023-02-01,76.69,334.19
6920,87456121,2023-02-06,-29.95,304.24
6921,87456121,2023-02-09,-82.14,222.1
6922,87456121,2023-02-09,-58.71,163.39
1334,87456121,2023-02-10,62.31,225.7
1335,87456121,2023-02-11,51.18,276.88
2610,87504607,2023-01-31,0.0,605.63
413,87504607,2023-02-01,86.21,691.84
414,87504607,2023-02-03,91.97,783.81
8404,87504607,2023-02-11,-83.49,700.3199999999999
415,87504607,2023-02-11,142.53,842.85
416,87504607,2023-02-13,162.05,1004.9
2611,87533652,2023-01-31,0.0,156.61
4649,87533652,2023-02-03,22.57,179.18
6854,87533652,2023-02-06,-176.4,2.780000000000001
6855,87533652,2023-02-07,-67.88,-65.1
4650,87533652,2023-02-07,199.97,134.87
4651,87533652,2023-02-10,153.19,288.06
4652,87533652,2023-02-14,81.26,369.32
2612,87543952,2023-01-31,0.0,14.85
7580,87543952,2023-02-07,-93.88,-79.03
7792,87543952,2023-02-08,77.04,-1.9899999999999896
7793,87543952,2023-02-09,125.94,123.95
7794,87543952,2023-02-11,112.24,236.19
2613,87556975,2023-01-31,0.0,657.17
3690,87556975,2023-02-02,-57.04,600.13
3691,87556975,2023-02-05,-200.2,399.92999999999995
3692,87556975,2023-02-06,-173.27,226.65999999999997
7330,87556975,2023-02-07,1372.5,1599.1599999999999
7331,87556975,2023-02-13,99.78,1698.94
7332,87556975,2023-02-14,1469.3,3168.24
2614,87726203,2023-01-31,0.0,55.92
6649,87726203,2023-02-06,152.16,208.07999999999998
7596,87726203,2023-02-07,-21.61,186.47000000000003
7597,87726203,2023-02-09,-124.33,62.14
7598,87726203,2023-02-10,-57.63,4.509999999999998
7599,87726203,2023-02-12,-28.57,-24.060000000000002
2615,87735660,2023-01-31,0.0,990.25
4877,87735660,2023-02-03,28.0,1018.25
5261,87735660,2023-02-04,-82.87,935.38
5263,87735660,2023-02-11,-138.99,796.39
5262,87735660,2023-02-11,-64.84,731.55
4878,87735660,2023-02-12,101.83,833.38
4879,87735660,2023-02-13,79.81,913.1899999999999
4880,87735660,2023-02-13,152.92,1066.11
2616,87746071,2023-01-31,0.0,215.91
1662,87746071,2023-02-01,-106.3,109.61
7143,87746071,2023-02-06,135.04,244.64999999999998
7144,87746071,2023-02-14,259.3,503.95000000000005
2617,87801896,2023-01-31,0.0,181.56
4136,87801896,2023-02-03,1632.0,1813.56
4137,87801896,2023-02-05,118.55,1932.11
4138,87801896,2023-02-06,108.14,2040.25
8517,87801896,2023-02-12,-171.12,1869.1299999999999
2618,87807990,2023-01-31,0.0,317.4
1721,87807990,2023-02-01,72.79,390.19
2873,87807990,2023-02-02,-97.47,292.71999999999997
1722,87807990,2023-02-04,957.5,1250.22
1723,87807990,2023-02-06,178.88,1429.1
1724,87807990,2023-02-08,57.32,1486.42
1725,87807990,2023-02-10,38.88,1525.3000000000002
2619,87817645,2023-01-31,0.0,983.36
1697,87817645,2023-02-01,181.11,1164.47
4434,87817645,2023-02-03,-17.26,1147.21
1698,87817645,2023-02-04,64.93,1212.14
4435,87817645,2023-02-05,-141.51,1070.63
4436,87817645,2023-02-05,-114.48,956.1500000000001
4437,87817645,2023-02-06,-660.3,295.85000000000014
4438,87817645,2023-02-08,-103.89,191.96000000000015
4439,87817645,2023-02-09,-155.76,36.20000000000016
1699,87817645,2023-02-10,80.91,117.11000000000013
1700,87817645,2023-02-10,616.1,733.2100000000002
2620,87827496,2023-01-31,0.0,935.66
3285,87827496,2023-02-02,-103.39,832.27
3286,87827496,2023-02-05,-107.8,724.47
8621,87827496,2023-02-13,72.65,797.12
2621,87836000,2023-01-31,0.0,937.46
7358,87836000,2023-02-07,-115.15,822.3100000000001
7359,87836000,2023-02-13,-93.97,728.34
2622,87876065,2023-01-31,0.0,627.15
479,87876065,2023-02-01,123.29,750.4399999999999
478,87876065,2023-02-01,1821.6,2572.04
8456,87876065,2023-02-11,-75.65,2496.39
480,87876065,2023-02-11,140.15,2636.54
8457,87876065,2023-02-12,-84.4,2552.14
8458,87876065,2023-02-14,-64.45,2487.69
2623,87906438,2023-01-31,0.0,196.99
6199,87906438,2023-02-05,-144.67,52.32000000000002
7371,87906438,2023-02-07,0.83,53.150000000000034
7372,87906438,2023-02-09,136.48,189.63000000000002
6200,87906438,2023-02-10,-75.98,113.65000000000002
7374,87906438,2023-02-10,40.2,153.85000000000002
7373,87906438,2023-02-10,174.95,328.8
6201,87906438,2023-02-12,-99.99,228.81
7375,87906438,2023-02-12,159.82,388.63
2624,87911550,2023-01-31,0.0,149.29
2682,87911550,2023-02-02,-91.54,57.749999999999986
5709,87911550,2023-02-04,74.75,132.5
2683,87911550,2023-02-11,-72.76,59.73999999999998
5710,87911550,2023-02-13,24.32,84.05999999999997
2625,87913244,2023-01-31,0.0,730.48
1342,87913244,2023-02-01,136.95,867.4300000000001
2388,87913244,2023-02-02,-237.02,630.41
2389,87913244,2023-02-06,-123.31,507.1
2390,87913244,2023-02-08,-54.56,452.53999999999996
1343,87913244,2023-02-08,104.55,557.0899999999999
2391,87913244,2023-02-10,-210.07,347.02
2392,87913244,2023-02-11,-139.07,207.95000000000005
2393,87913244,2023-02-12,-131.58,76.37
2626,87967388,2023-01-31,0.0,682.7
4481,87967388,2023-02-03,-114.6,568.1
6240,87967388,2023-02-05,77.0,645.1
6241,87967388,2023-02-05,135.04,780.1400000000001
6242,87967388,2023-02-10,932.3,1712.44
4482,87967388,2023-02-12,-882.7,829.74
4483,87967388,2023-02-13,-2359.1,-1529.36
6244,87967388,2023-02-13,89.23,-1440.1299999999999
6243,87967388,2023-02-13,1393.1,-47.02999999999997
4484,87967388,2023-02-14,-137.37,-184.39999999999998
2627,88033693,2023-01-31,0.0,917.7
7130,88033693,2023-02-06,-114.15,803.5500000000001
7131,88033693,2023-02-07,-109.39,694.1600000000001
7335,88033693,2023-02-07,19.21,713.37
7336,88033693,2023-02-09,81.22,794.59
7132,88033693,2023-02-12,-19.56,775.03
2628,88040274,2023-01-31,0.0,550.79
4610,88040274,2023-02-03,-89.14,461.65
6528,88040274,2023-02-05,158.27,619.92
6529,88040274,2023-02-06,1743.5,2363.42
6530,88040274,2023-02-14,76.31,2439.73
2629,88074391,2023-01-31,0.0,851.54
3555,88074391,2023-02-02,-111.21,740.3299999999999
3556,88074391,2023-02-05,-127.52,612.81
6708,88074391,2023-02-06,115.19,728.0
3557,88074391,2023-02-09,-83.26,644.74
3558,88074391,2023-02-10,-121.44,523.3
2630,88106566,2023-01-31,0.0,477.78
2648,88106566,2023-02-02,93.52,571.3
2649,88106566,2023-02-02,211.27,782.5699999999999
4905,88106566,2023-02-03,-221.11,561.4599999999999
2650,88106566,2023-02-05,12.23,573.6899999999999
2651,88106566,2023-02-09,140.26,713.9499999999999
4906,88106566,2023-02-14,-134.69,579.26
2631,88160468,2023-01-31,0.0,640.07
180,88160468,2023-02-01,-1041.9,-401.83000000000004
179,88160468,2023-02-01,-84.03,-485.86
5130,88160468,2023-02-04,127.8,-358.06000000000006
5131,88160468,2023-02-07,46.31,-311.75
181,88160468,2023-02-08,-103.69,-415.43999999999994
5132,88160468,2023-02-09,142.59,-272.85
182,88160468,2023-02-12,-143.47,-416.32000000000005
5133,88160468,2023-02-13,44.17,-372.15
183,88160468,2023-02-14,-151.02,-523.17
2632,88229109,2023-01-31,0.0,730.76
6519,88229109,2023-02-05,-65.1,665.66
8380,88229109,2023-02-10,182.81,848.47
8383,88229109,2023-02-12,67.02,915.49
8382,88229109,2023-02-12,76.6,992.0899999999999
8381,88229109,2023-02-12,140.82,1132.9099999999999
8384,88229109,2023-02-14,115.32,1248.23
2633,88235115,2023-01-31,0.0,150.58
2729,88235115,2023-02-02,-137.17,13.410000000000025
2730,88235115,2023-02-02,-51.28,-37.869999999999976
5924,88235115,2023-02-05,167.85,129.98000000000002
2731,88235115,2023-02-07,-74.11,55.87000000000002
2732,88235115,2023-02-08,-118.94,-63.069999999999965
5925,88235115,2023-02-08,89.97,26.90000000000002
5926,88235115,2023-02-09,98.98,125.88000000000002
2733,88235115,2023-02-12,-797.7,-671.82
5927,88235115,2023-02-12,154.56,-517.2600000000001
2734,88235115,2023-02-14,-643.9,-1161.16
2634,88285378,2023-01-31,0.0,473.79
3817,88285378,2023-02-03,94.79,568.58
3818,88285378,2023-02-06,887.9,1456.48
3819,88285378,2023-02-08,180.39,1636.87
8215,88285378,2023-02-09,-230.97,1405.8999999999999
8216,88285378,2023-02-14,-104.53,1301.37
2635,88293767,2023-01-31,0.0,487.22
5306,88293767,2023-02-04,-102.71,384.51000000000005
5307,88293767,2023-02-07,-82.79,301.72
5308,88293767,2023-02-09,-65.38,236.34000000000003
2636,88306714,2023-01-31,0.0,808.0
7864,88306714,2023-02-08,36.71,844.71
8586,88306714,2023-02-13,-114.54,730.17
8587,88306714,2023-02-14,-112.72,617.45
2637,88343796,2023-01-31,0.0,338.0
3443,88343796,2023-02-02,-224.12,113.88
3444,88343796,2023-02-08,-30.57,83.31
8495,88343796,2023-02-11,66.07,149.38
2638,88381437,2023-01-31,0.0,472.65
5901,88381437,2023-02-04,-100.94,371.71
5903,88381437,2023-02-05,-74.21,297.5
5902,88381437,2023-02-05,-65.54,231.95999999999998
2639,88399132,2023-01-31,0.0,751.13
2143,88399132,2023-02-02,56.02,807.15
4608,88399132,2023-02-03,-83.69,723.46
2144,88399132,2023-02-08,195.95,919.41
2146,88399132,2023-02-10,69.69,989.1
2145,88399132,2023-02-10,151.6,1140.7
2147,88399132,2023-02-11,32.0,1172.7
4609,88399132,2023-02-14,-159.09,1013.61
2640,88436283,2023-01-31,0.0,689.71
8128,88436283,2023-02-09,-233.91,455.80000000000007
2641,88466448,2023-01-31,0.0,920.61
4242,88466448,2023-02-03,-1453.5,-532.89
4243,88466448,2023-02-03,-640.4,-1173.29
4244,88466448,2023-02-04,-79.47,-1252.7599999999998
5635,88466448,2023-02-04,131.11,-1121.65
4245,88466448,2023-02-05,-51.26,-1172.9099999999999
5636,88466448,2023-02-05,627.1,-545.8100000000001
4246,88466448,2023-02-07,-143.04,-688.85
4247,88466448,2023-02-08,-58.82,-747.67
5637,88466448,2023-02-09,11.47,-736.1999999999999
4248,88466448,2023-02-10,-121.97,-858.17
5638,88466448,2023-02-12,112.58,-745.59
2642,88476961,2023-01-31,0.0,524.76
900,88476961,2023-02-01,75.85,600.61
901,88476961,2023-02-04,86.15,686.76
902,88476961,2023-02-05,138.66,825.42
903,88476961,2023-02-07,75.95,901.37
8247,88476961,2023-02-10,-55.13,846.24
8248,88476961,2023-02-11,-133.78,712.46
2643,88482062,2023-01-31,0.0,149.31
919,88482062,2023-02-01,-321.2,-171.89
7619,88482062,2023-02-07,85.25,-86.63999999999999
7618,88482062,2023-02-07,130.23,43.59
920,88482062,2023-02-08,-1096.2,-1052.6100000000001
921,88482062,2023-02-10,-87.07,-1139.68
2644,88489173,2023-01-31,0.0,476.26
242,88489173,2023-02-01,169.18,645.44
3029,88489173,2023-02-02,-115.09,530.35
3030,88489173,2023-02-08,-0.47,529.88
3031,88489173,2023-02-09,-145.71,384.16999999999996
3032,88489173,2023-02-13,-133.97,250.2
2645,88538200,2023-01-31,0.0,518.77
2421,88538200,2023-02-02,-83.89,434.88
7115,88538200,2023-02-06,40.91,475.78999999999996
7116,88538200,2023-02-10,1394.1,1869.8899999999999
7117,88538200,2023-02-12,127.83,1997.7199999999998
7118,88538200,2023-02-12,1077.3,3075.02
7119,88538200,2023-02-13,76.09,3151.1099999999997
2646,88551691,2023-01-31,0.0,979.24
1708,88551691,2023-02-01,89.41,1068.65
1709,88551691,2023-02-05,1136.4,2205.05
7400,88551691,2023-02-07,-75.03,2130.0200000000004
7401,88551691,2023-02-08,-118.77,2011.2500000000002
2647,88558016,2023-01-31,0.0,156.64
5826,88558016,2023-02-04,84.53,241.17
8026,88558016,2023-02-09,-37.65,203.51999999999998
5827,88558016,2023-02-12,76.51,280.03
5828,88558016,2023-02-12,84.83,364.86
5829,88558016,2023-02-14,76.93,441.78999999999996
2648,88568543,2023-01-31,0.0,472.83
1467,88568543,2023-02-01,-168.34,304.49
1468,88568543,2023-02-02,-723.0,-418.51000000000005
1469,88568543,2023-02-02,-86.62,-505.13000000000005
1470,88568543,2023-02-03,-102.35,-607.48
7415,88568543,2023-02-07,126.03,-481.45
1471,88568543,2023-02-10,-65.54,-546.99
7416,88568543,2023-02-11,1215.8,668.81
7417,88568543,2023-02-13,26.24,695.05
1472,88568543,2023-02-14,-17.11,677.9399999999998
2649,88570753,2023-01-31,0.0,62.48
7472,88570753,2023-02-07,-99.56,-37.080000000000005
7620,88570753,2023-02-07,1440.9,1403.8200000000002
7473,88570753,2023-02-09,-127.53,1276.2900000000002
7474,88570753,2023-02-12,-90.66,1185.63
7621,88570753,2023-02-14,89.9,1275.5300000000002
2650,88580402,2023-01-31,0.0,118.18
587,88580402,2023-02-01,104.47,222.65
588,88580402,2023-02-03,59.01,281.65999999999997
589,88580402,2023-02-06,143.3,424.96
8068,88580402,2023-02-09,-83.99,340.97
8069,88580402,2023-02-14,-175.7,165.27000000000004
2651,88646863,2023-01-31,0.0,250.52
4233,88646863,2023-02-03,35.32,285.84000000000003
4234,88646863,2023-02-08,947.8,1233.64
2652,88657589,2023-01-31,0.0,712.85
4558,88657589,2023-02-03,-97.96,614.89
5886,88657589,2023-02-04,94.72,709.61
5887,88657589,2023-02-05,98.03,807.64
5888,88657589,2023-02-07,50.49,858.13
5890,88657589,2023-02-09,11.2,869.33
5889,88657589,2023-02-09,163.99,1033.3200000000002
4559,88657589,2023-02-10,-129.33,903.99
5891,88657589,2023-02-13,26.71,930.7
5892,88657589,2023-02-14,77.4,1008.1
2653,88676459,2023-01-31,0.0,285.95
476,88676459,2023-02-01,94.56,380.51
3826,88676459,2023-02-03,-493.5,-112.99000000000001
3827,88676459,2023-02-09,-113.5,-226.49000000000007
3828,88676459,2023-02-12,-183.53,-410.02000000000004
3829,88676459,2023-02-14,-42.94,-452.96
2654,88681540,2023-01-31,0.0,531.01
2111,88681540,2023-02-01,-158.59,372.41999999999996
185,88681540,2023-02-01,122.46,494.88
2112,88681540,2023-02-03,-11.36,483.52
2113,88681540,2023-02-08,-96.66,386.86
186,88681540,2023-02-13,144.82,531.68
2655,88710457,2023-01-31,0.0,818.28
4612,88710457,2023-02-03,-70.8,747.48
4611,88710457,2023-02-03,-49.28,698.1999999999999
8011,88710457,2023-02-09,156.03,854.23
4613,88710457,2023-02-11,-128.07,726.16
4614,88710457,2023-02-14,-137.37,588.79
2656,88732093,2023-01-31,0.0,57.56
2117,88732093,2023-02-01,-132.52,-74.96000000000001
1590,88732093,2023-02-01,81.49,6.529999999999987
1591,88732093,2023-02-06,878.3,884.8299999999999
1592,88732093,2023-02-06,1502.6,2387.43
2118,88732093,2023-02-08,-88.5,2298.93
2119,88732093,2023-02-12,-164.29,2134.64
2657,88824263,2023-01-31,0.0,295.9
430,88824263,2023-02-01,-28.95,266.95
431,88824263,2023-02-02,-38.78,228.16999999999996
432,88824263,2023-02-09,-132.11,96.05999999999995
8551,88824263,2023-02-12,31.2,127.25999999999993
8550,88824263,2023-02-12,133.13,260.38999999999993
2658,88831746,2023-01-31,0.0,565.27
4242,88831746,2023-02-03,128.25,693.52
5536,88831746,2023-02-04,-101.49,592.03
4243,88831746,2023-02-07,64.68,656.71
5537,88831746,2023-02-08,-179.3,477.40999999999997
4244,88831746,2023-02-10,204.71,682.12
2659,88834465,2023-01-31,0.0,18.3
6088,88834465,2023-02-05,-87.06,-68.76
6726,88834465,2023-02-06,26.04,-42.72
6089,88834465,2023-02-10,-400.1,-442.82
2660,88837750,2023-01-31,0.0,269.14
4563,88837750,2023-02-03,116.84,385.98
4564,88837750,2023-02-04,111.74,497.71999999999997
6328,88837750,2023-02-05,-61.25,436.46999999999997
6329,88837750,2023-02-06,-127.59,308.88
6330,88837750,2023-02-07,-26.09,282.78999999999996
6331,88837750,2023-02-09,-38.34,244.45
6332,88837750,2023-02-10,-149.53,94.91999999999999
4565,88837750,2023-02-10,187.69,282.61
4566,88837750,2023-02-12,76.82,359.42999999999995
2661,88857879,2023-01-31,0.0,601.01
4006,88857879,2023-02-03,-16.43,584.58
7844,88857879,2023-02-08,86.36,670.94
4007,88857879,2023-02-11,-85.41,585.53
7845,88857879,2023-02-11,181.25,766.78
2662,88926132,2023-01-31,0.0,275.1
3132,88926132,2023-02-02,12.65,287.75
5420,88926132,2023-02-04,-381.6,-93.85000000000002
3133,88926132,2023-02-04,1031.4,937.5500000000001
3134,88926132,2023-02-04,1618.2,2555.75
5421,88926132,2023-02-07,-64.68,2491.07
3135,88926132,2023-02-08,113.38,2604.45
5422,88926132,2023-02-10,-75.67,2528.78
5423,88926132,2023-02-13,-2264.3,264.48000000000013
5424,88926132,2023-02-13,-116.52,147.96000000000015
3136,88926132,2023-02-13,152.58,300.54000000000013
3137,88926132,2023-02-14,175.7,476.2400000000001
2663,88933315,2023-01-31,0.0,289.79
822,88933315,2023-02-01,101.08,390.87
821,88933315,2023-02-01,115.4,506.27000000000004
6892,88933315,2023-02-06,-114.74,391.53000000000003
6893,88933315,2023-02-09,-82.08,309.45000000000005
823,88933315,2023-02-09,108.34,417.79
6895,88933315,2023-02-11,-1828.9,-1411.1100000000001
6894,88933315,2023-02-11,-150.26,-1561.3700000000001
6896,88933315,2023-02-13,-61.19,-1622.5600000000002
6897,88933315,2023-02-14,-157.43,-1779.9900000000002
824,88933315,2023-02-14,87.23,-1692.7600000000002
2664,88968006,2023-01-31,0.0,952.66
3655,88968006,2023-02-02,57.04,1009.6999999999999
5277,88968006,2023-02-04,-129.7,880.0
5278,88968006,2023-02-04,-89.95,790.05
3656,88968006,2023-02-08,176.94,966.99
2665,88974311,2023-01-31,0.0,501.47
571,88974311,2023-02-01,-152.59,348.88
572,88974311,2023-02-02,-153.2,195.68000000000006
2666,89065134,2023-01-31,0.0,447.32
2717,89065134,2023-02-02,-119.89,327.43
2718,89065134,2023-02-02,-111.91,215.51999999999998
2716,89065134,2023-02-02,-93.52,122.0
2629,89065134,2023-02-02,153.04,275.03999999999996
2719,89065134,2023-02-14,-120.46,154.57999999999998
2667,89088715,2023-01-31,0.0,336.6
3631,89088715,2023-02-02,1180.2,1516.8000000000002
3632,89088715,2023-02-03,36.14,1552.94
3633,89088715,2023-02-04,104.24,1657.1799999999998
7477,89088715,2023-02-07,-65.96,1591.2200000000003
7478,89088715,2023-02-10,-63.35,1527.87
3634,89088715,2023-02-11,79.06,1606.9299999999998
3635,89088715,2023-02-12,77.54,1684.4700000000003
3636,89088715,2023-02-14,117.34,1801.81
2668,89117536,2023-01-31,0.0,123.22
2624,89117536,2023-02-02,74.5,197.72
2623,89117536,2023-02-02,150.57,348.28999999999996
2625,89117536,2023-02-06,27.56,375.85
2669,89194917,2023-01-31,0.0,332.56
7851,89194917,2023-02-08,61.4,393.96
8379,89194917,2023-02-10,-99.66,294.3
8380,89194917,2023-02-12,-122.32,171.98000000000002
8381,89194917,2023-02-13,-75.77,96.21000000000004
2670,89223056,2023-01-31,0.0,139.98
7929,89223056,2023-02-08,149.64,289.62
8116,89223056,2023-02-09,-141.4,148.21999999999997
8117,89223056,2023-02-09,-98.06,50.15999999999997
8115,89223056,2023-02-09,-39.08,11.079999999999956
7930,89223056,2023-02-11,48.78,59.85999999999997
7931,89223056,2023-02-14,1660.2,1720.06
2671,89225677,2023-01-31,0.0,660.05
5631,89225677,2023-02-04,-52.76,607.29
5632,89225677,2023-02-05,-80.23,527.06
5633,89225677,2023-02-06,-141.06,385.99999999999994
7071,89225677,2023-02-06,24.38,410.37999999999994
7072,89225677,2023-02-07,1107.6,1517.9799999999998
5634,89225677,2023-02-09,-123.84,1394.1399999999999
7073,89225677,2023-02-11,90.85,1484.9899999999998
5635,89225677,2023-02-12,-104.9,1380.0899999999997
7074,89225677,2023-02-12,108.0,1488.0899999999997
2672,89244577,2023-01-31,0.0,706.67
3669,89244577,2023-02-02,555.5,1262.17
3670,89244577,2023-02-05,134.55,1396.7199999999998
6770,89244577,2023-02-06,-117.46,1279.26
6771,89244577,2023-02-06,-50.86,1228.4
6772,89244577,2023-02-08,-96.58,1131.82
3671,89244577,2023-02-09,103.8,1235.62
6773,89244577,2023-02-11,-122.21,1113.4099999999999
3672,89244577,2023-02-12,55.85,1169.26
2673,89309725,2023-01-31,0.0,858.68
3383,89309725,2023-02-02,-124.23,734.4499999999999
4247,89309725,2023-02-03,1453.5,2187.95
3384,89309725,2023-02-04,-135.89,2052.06
4248,89309725,2023-02-07,121.91,2173.97
4249,89309725,2023-02-08,63.8,2237.77
4250,89309725,2023-02-09,45.07,2282.84
4251,89309725,2023-02-12,146.24,2429.08
2674,89318229,2023-01-31,0.0,675.08
2606,89318229,2023-02-02,-98.51,576.57
2607,89318229,2023-02-02,-72.72,503.85
7339,89318229,2023-02-07,209.73,713.58
7340,89318229,2023-02-08,132.6,846.1800000000001
7341,89318229,2023-02-09,46.37,892.5500000000001
2608,89318229,2023-02-14,-85.66,806.8900000000001
2675,89353946,2023-01-31,0.0,809.48
6526,89353946,2023-02-05,142.19,951.6700000000001
7495,89353946,2023-02-07,-1.03,950.64
6527,89353946,2023-02-07,117.45,1068.0900000000001
7496,89353946,2023-02-08,-94.96,973.13
7497,89353946,2023-02-11,-161.25,811.88
2676,89369216,2023-01-31,0.0,404.56
747,89369216,2023-02-01,-99.09,305.47
2740,89369216,2023-02-02,57.51,362.98
748,89369216,2023-02-06,-87.82,275.15999999999997
749,89369216,2023-02-07,-141.99,133.17000000000002
2741,89369216,2023-02-07,93.19,226.35999999999999
2742,89369216,2023-02-08,80.72,307.08
750,89369216,2023-02-10,-107.56,199.51999999999998
2743,89369216,2023-02-10,61.16,260.67999999999995
2744,89369216,2023-02-10,100.23,360.90999999999997
2745,89369216,2023-02-11,1944.9,2305.81
2677,89406032,2023-01-31,0.0,453.31
6384,89406032,2023-02-05,-176.37,276.94
6383,89406032,2023-02-05,-123.79,153.14999999999998
6385,89406032,2023-02-11,-141.71,11.439999999999998
2678,89407337,2023-01-31,0.0,211.2
2679,89438779,2023-01-31,0.0,347.92
333,89438779,2023-02-01,-104.57,243.35000000000002
335,89438779,2023-02-02,-205.22,38.13000000000005
334,89438779,2023-02-02,-21.71,16.420000000000016
336,89438779,2023-02-07,-113.6,-97.18
7516,89438779,2023-02-07,125.71,28.53000000000003
7515,89438779,2023-02-07,140.14,168.67000000000002
337,89438779,2023-02-12,-69.44,99.23000000000002
7517,89438779,2023-02-12,198.2,297.43
7518,89438779,2023-02-13,1062.5,1359.93
2680,89471153,2023-01-31,0.0,52.29
8587,89471153,2023-02-12,153.64,205.92999999999998
8628,89471153,2023-02-13,-114.78,91.14999999999998
8588,89471153,2023-02-13,81.41,172.55999999999997
8629,89471153,2023-02-14,-68.12,104.43999999999997
2681,89497773,2023-01-31,0.0,637.02
2110,89497773,2023-02-02,131.02,768.04
4976,89497773,2023-02-03,-94.57,673.47
4977,89497773,2023-02-04,-100.39,573.08
4978,89497773,2023-02-06,-55.52,517.56
2112,89497773,2023-02-07,50.93,568.49
2111,89497773,2023-02-07,141.01,709.5
2113,89497773,2023-02-09,123.35,832.8499999999999
2114,89497773,2023-02-12,123.38,956.23
4979,89497773,2023-02-14,-172.96,783.27
2682,89503991,2023-01-31,0.0,204.52
2406,89503991,2023-02-02,95.08,299.6
2407,89503991,2023-02-09,72.3,371.9
2408,89503991,2023-02-12,1030.7,1402.6
2683,89608054,2023-01-31,0.0,495.15
5321,89608054,2023-02-04,80.37,575.52
5322,89608054,2023-02-11,92.62,668.14
8514,89608054,2023-02-12,-86.73,581.41
5323,89608054,2023-02-12,190.17,771.5799999999999
8515,89608054,2023-02-14,-116.09,655.49
2684,89629293,2023-01-31,0.0,292.31
8491,89629293,2023-02-11,-124.56,167.75
8492,89629293,2023-02-14,-191.52,-23.77000000000004
2685,89632856,2023-01-31,0.0,557.83
3687,89632856,2023-02-02,-126.16,431.6700000000001
3688,89632856,2023-02-03,-119.95,311.72
6841,89632856,2023-02-06,50.84,362.56000000000006
3689,89632856,2023-02-08,-1908.7,-1546.1400000000003
2686,89645445,2023-01-31,0.0,287.29
4829,89645445,2023-02-03,-112.15,175.14000000000001
8016,89645445,2023-02-09,1726.4,1901.54
2687,89650416,2023-01-31,0.0,146.17
138,89650416,2023-02-01,-205.89,-59.72
139,89650416,2023-02-04,-127.68,-187.4
8252,89650416,2023-02-10,71.44,-115.96000000000001
140,89650416,2023-02-12,-120.12,-236.08
8253,89650416,2023-02-12,55.39,-180.69000000000003
2688,89689059,2023-01-31,0.0,906.88
3586,89689059,2023-02-02,-173.89,732.99
3587,89689059,2023-02-03,-99.14,633.85
3588,89689059,2023-02-04,-76.44,557.4100000000001
3589,89689059,2023-02-06,-69.68,487.73
6688,89689059,2023-02-06,100.18,587.9100000000001
3590,89689059,2023-02-09,-1576.6,-988.6899999999999
6689,89689059,2023-02-14,103.89,-884.7999999999998
2689,89697097,2023-01-31,0.0,449.71
3413,89697097,2023-02-02,128.36,578.0699999999999
7729,89697097,2023-02-08,-1737.4,-1159.33
3414,89697097,2023-02-13,44.38,-1114.9499999999998
3415,89697097,2023-02-14,100.83,-1014.1199999999999
2690,89720252,2023-01-31,0.0,672.88
3832,89720252,2023-02-03,91.02,763.9
3833,89720252,2023-02-03,101.53,865.4300000000001
8476,89720252,2023-02-11,-55.02,810.41
3834,89720252,2023-02-12,192.75,1003.16
3835,89720252,2023-02-13,182.14,1185.3
3836,89720252,2023-02-14,40.13,1225.4299999999998
2691,89761152,2023-01-31,0.0,923.01
6377,89761152,2023-02-05,-166.03,756.98
6378,89761152,2023-02-06,-44.43,712.55
6379,89761152,2023-02-09,-1365.7,-653.1500000000001
6380,89761152,2023-02-11,-144.17,-797.3200000000002
6381,89761152,2023-02-11,-67.06,-864.3800000000001
8555,89761152,2023-02-12,85.04,-779.3400000000001
8556,89761152,2023-02-12,89.43,-689.9100000000001
6382,89761152,2023-02-14,-99.21,-789.1200000000001
2692,89905732,2023-01-31,0.0,883.38
3008,89905732,2023-02-02,-1921.4,-1038.02
3010,89905732,2023-02-05,-141.29,-1179.31
3009,89905732,2023-02-05,-128.78,-1308.0900000000001
8321,89905732,2023-02-10,1147.5,-160.59000000000003
8322,89905732,2023-02-14,156.56,-4.030000000000086
2693,89916489,2023-01-31,0.0,726.43
1612,89916489,2023-02-01,-174.0,552.43
4648,89916489,2023-02-03,101.75,654.18
1613,89916489,2023-02-06,-81.53,572.65
2694,89972805,2023-01-31,0.0,456.55
7921,89972805,2023-02-08,35.2,491.75
2695,89983842,2023-01-31,0.0,880.93
4921,89983842,2023-02-03,39.37,920.3
6342,89983842,2023-02-05,-80.89,839.41
4922,89983842,2023-02-07,60.4,899.81
6343,89983842,2023-02-11,-129.67,770.14
4923,89983842,2023-02-11,145.45,915.5899999999999
2696,90019913,2023-01-31,0.0,430.21
2415,90019913,2023-02-02,-69.49,360.71999999999997
2416,90019913,2023-02-08,-1693.2,-1332.48
8018,90019913,2023-02-09,156.34,-1176.14
8019,90019913,2023-02-10,72.21,-1103.93
2417,90019913,2023-02-12,-622.0,-1725.9300000000003
8020,90019913,2023-02-14,66.36,-1659.5700000000002
2697,90044139,2023-01-31,0.0,568.28
5890,90044139,2023-02-04,-72.06,496.21999999999997
5891,90044139,2023-02-05,-94.48,401.73999999999995
5892,90044139,2023-02-13,-138.94,262.79999999999995
2698,90054505,2023-01-31,0.0,586.12
375,90054505,2023-02-01,-129.54,456.58000000000004
7796,90054505,2023-02-08,88.44,545.02
7797,90054505,2023-02-10,108.6,653.62
2699,90090889,2023-01-31,0.0,836.85
5831,90090889,2023-02-04,-105.37,731.48
6428,90090889,2023-02-05,142.54,874.02
5832,90090889,2023-02-10,-1499.1,-625.0799999999998
5833,90090889,2023-02-12,-190.9,-815.9799999999999
5834,90090889,2023-02-14,-136.43,-952.4099999999997
2700,90118682,2023-01-31,0.0,58.16
3306,90118682,2023-02-02,-129.77,-71.61000000000001
4364,90118682,2023-02-03,69.26,-2.3500000000000085
4363,90118682,2023-02-03,149.58,147.23000000000002
3307,90118682,2023-02-05,-62.8,84.43
4365,90118682,2023-02-07,105.38,189.81
4366,90118682,2023-02-08,143.57,333.38
3308,90118682,2023-02-09,-203.24,130.14
3309,90118682,2023-02-10,-123.94,6.199999999999989
3310,90118682,2023-02-13,-4.66,1.539999999999992
2701,90168031,2023-01-31,0.0,196.48
1301,90168031,2023-02-01,-170.35,26.129999999999995
5789,90168031,2023-02-04,157.26,183.39
1302,90168031,2023-02-09,-156.34,27.049999999999983
1303,90168031,2023-02-09,-74.6,-47.55000000000001
2702,90203948,2023-01-31,0.0,689.49
3842,90203948,2023-02-03,103.32,792.81
3843,90203948,2023-02-03,133.06,925.87
3844,90203948,2023-02-06,110.71,1036.58
3845,90203948,2023-02-08,1608.4,2644.98
8448,90203948,2023-02-11,-116.37,2528.6099999999997
3846,90203948,2023-02-13,63.14,2591.75
2703,90233696,2023-01-31,0.0,628.02
1203,90233696,2023-02-01,73.14,701.16
3348,90233696,2023-02-02,-197.62,503.53999999999996
1204,90233696,2023-02-05,138.32,641.86
1205,90233696,2023-02-08,62.15,704.01
3349,90233696,2023-02-11,-40.3,663.7099999999999
3350,90233696,2023-02-13,-38.7,625.01
2704,90287712,2023-01-31,0.0,316.17
1415,90287712,2023-02-01,105.25,421.42
4953,90287712,2023-02-03,-46.33,375.09000000000003
4954,90287712,2023-02-05,-108.31,266.78000000000003
1416,90287712,2023-02-08,115.99,382.77
4955,90287712,2023-02-10,-65.52,317.25
1417,90287712,2023-02-14,59.8,377.05
2705,90313378,2023-01-31,0.0,743.7
3926,90313378,2023-02-03,-99.93,643.77
4357,90313378,2023-02-03,622.9,1266.67
4358,90313378,2023-02-06,169.47,1436.1399999999999
4359,90313378,2023-02-07,57.59,1493.73
4360,90313378,2023-02-08,24.38,1518.1100000000001
3927,90313378,2023-02-11,-27.58,1490.53
3928,90313378,2023-02-12,-103.79,1386.74
4361,90313378,2023-02-13,74.74,1461.48
2706,90336689,2023-01-31,0.0,847.88
2951,90336689,2023-02-02,169.64,1017.52
3806,90336689,2023-02-03,-120.88,896.64
2952,90336689,2023-02-04,973.3,1869.94
3807,90336689,2023-02-07,-48.04,1821.9
3808,90336689,2023-02-09,-69.33,1752.57
3809,90336689,2023-02-11,-954.4,798.17
2707,90338454,2023-01-31,0.0,748.63
1086,90338454,2023-02-01,-162.02,586.61
6984,90338454,2023-02-06,57.25,643.86
6985,90338454,2023-02-08,72.15,716.01
1087,90338454,2023-02-10,-105.08,610.9300000000001
2708,90349791,2023-01-31,0.0,568.63
6945,90349791,2023-02-06,93.16,661.79
2709,90446254,2023-01-31,0.0,930.0
4880,90446254,2023-02-03,-372.2,557.8
4881,90446254,2023-02-12,-100.81,456.99
4882,90446254,2023-02-13,-92.53,364.46000000000004
4883,90446254,2023-02-14,-50.66,313.79999999999995
2710,90480183,2023-01-31,0.0,465.06
3863,90480183,2023-02-03,-34.72,430.34000000000003
4239,90480183,2023-02-03,72.03,502.37
3864,90480183,2023-02-05,-167.77,334.6
4240,90480183,2023-02-05,94.53,429.13
3865,90480183,2023-02-06,-140.76,288.37
4241,90480183,2023-02-07,74.75,363.12
2711,90549616,2023-01-31,0.0,37.69
740,90549616,2023-02-01,-787.2,-749.51
739,90549616,2023-02-01,-169.68,-919.19
741,90549616,2023-02-04,-99.93,-1019.1199999999999
5448,90549616,2023-02-04,27.43,-991.69
742,90549616,2023-02-06,-1338.0,-2329.69
743,90549616,2023-02-07,-165.34,-2495.03
5449,90549616,2023-02-08,34.93,-2460.1
5450,90549616,2023-02-10,69.64,-2390.46
744,90549616,2023-02-12,-133.13,-2523.59
5451,90549616,2023-02-14,136.43,-2387.16
2712,90589761,2023-01-31,0.0,535.28
3166,90589761,2023-02-02,82.9,618.18
3167,90589761,2023-02-05,108.08,726.26
3168,90589761,2023-02-06,118.48,844.74
8417,90589761,2023-02-11,-166.8,677.9399999999999
3169,90589761,2023-02-12,158.31,836.25
2713,90625637,2023-01-31,0.0,477.46
4224,90625637,2023-02-03,-110.66,366.79999999999995
7439,90625637,2023-02-07,39.59,406.39
4225,90625637,2023-02-10,-90.09,316.29999999999995
7440,90625637,2023-02-11,107.06,423.36
4226,90625637,2023-02-13,-186.35,237.01
7441,90625637,2023-02-13,60.63,297.64
2714,90717656,2023-01-31,0.0,409.99
2932,90717656,2023-02-02,224.91,634.9
2933,90717656,2023-02-04,668.8,1303.6999999999998
8085,90717656,2023-02-09,-39.39,1264.31
8086,90717656,2023-02-12,-98.81,1165.5
2934,90717656,2023-02-12,114.27,1279.77
2715,90745743,2023-01-31,0.0,375.07
1240,90745743,2023-02-01,-142.99,232.07999999999998
3358,90745743,2023-02-02,111.9,343.98
1241,90745743,2023-02-03,-113.54,230.44
3359,90745743,2023-02-06,98.92,329.36
3360,90745743,2023-02-10,104.75,434.11
1242,90745743,2023-02-11,-9.21,424.9
3361,90745743,2023-02-13,49.9,474.79999999999995
2716,90824896,2023-01-31,0.0,484.11
2945,90824896,2023-02-02,92.36,576.47
2946,90824896,2023-02-04,104.15,680.62
6983,90824896,2023-02-06,-74.25,606.37
6984,90824896,2023-02-08,-10.05,596.32
2717,90851200,2023-01-31,0.0,361.43
3127,90851200,2023-02-02,-755.8,-394.36999999999995
6693,90851200,2023-02-06,83.26,-311.10999999999996
6694,90851200,2023-02-07,46.27,-264.84
3128,90851200,2023-02-10,-81.71,-346.5499999999999
6695,90851200,2023-02-10,150.77,-195.77999999999992
6696,90851200,2023-02-13,98.19,-97.58999999999992
3129,90851200,2023-02-14,-86.1,-183.68999999999988
2718,90871147,2023-01-31,0.0,362.86
7781,90871147,2023-02-08,-76.59,286.27
7807,90871147,2023-02-08,64.27,350.54
7782,90871147,2023-02-09,-484.0,-133.45999999999998
7783,90871147,2023-02-10,-59.42,-192.88
7808,90871147,2023-02-10,58.45,-134.42999999999995
2719,90894195,2023-01-31,0.0,157.01
3064,90894195,2023-02-02,90.49,247.5
3065,90894195,2023-02-03,40.13,287.63
5707,90894195,2023-02-04,-150.38,137.25
5708,90894195,2023-02-05,-112.34,24.909999999999997
3066,90894195,2023-02-07,45.83,70.74
2720,90932350,2023-01-31,0.0,480.51
2609,90932350,2023-02-02,98.11,578.62
2610,90932350,2023-02-06,189.84,768.46
7255,90932350,2023-02-07,-65.9,702.56
7256,90932350,2023-02-08,-837.3,-134.74
7257,90932350,2023-02-08,-24.76,-159.5
2612,90932350,2023-02-09,67.99,-91.50999999999999
2611,90932350,2023-02-09,126.46,34.94999999999999
7258,90932350,2023-02-10,-121.71,-86.75999999999999
2721,90951743,2023-01-31,0.0,220.81
3370,90951743,2023-02-02,-64.9,155.91
2971,90951743,2023-02-02,1559.2,1715.11
3371,90951743,2023-02-03,-83.25,1631.86
3372,90951743,2023-02-04,-1548.2,83.65999999999991
2972,90951743,2023-02-05,74.55,158.20999999999992
2973,90951743,2023-02-08,81.17,239.3799999999999
2974,90951743,2023-02-09,112.31,351.68999999999994
3373,90951743,2023-02-11,-96.88,254.80999999999992
2975,90951743,2023-02-11,26.95,281.75999999999993
2722,90982016,2023-01-31,0.0,776.15
7329,90982016,2023-02-07,-92.8,683.35
8052,90982016,2023-02-09,142.5,825.85
8053,90982016,2023-02-13,124.37,950.22
7330,90982016,2023-02-14,-97.59,852.63
2723,91020929,2023-01-31,0.0,348.12
958,91020929,2023-02-01,-107.56,240.56
959,91020929,2023-02-05,-111.54,129.01999999999998
6130,91020929,2023-02-05,99.91,228.93
960,91020929,2023-02-08,-40.13,188.79999999999998
961,91020929,2023-02-10,-165.41,23.389999999999986
6131,91020929,2023-02-11,39.39,62.77999999999997
6132,91020929,2023-02-13,102.35,165.13
962,91020929,2023-02-14,-115.38,49.75
2724,91062192,2023-01-31,0.0,211.52
2266,91062192,2023-02-02,-170.79,40.73000000000002
2267,91062192,2023-02-03,-130.7,-89.97
6980,91062192,2023-02-06,981.9,891.93
2725,91142310,2023-01-31,0.0,363.08
6967,91142310,2023-02-06,162.13,525.21
7403,91142310,2023-02-07,-1225.0,-699.79
7404,91142310,2023-02-14,-666.1,-1365.8899999999999
2726,91184544,2023-01-31,0.0,64.05
2798,91184544,2023-02-02,12.35,76.39999999999999
7500,91184544,2023-02-07,-91.56,-15.16000000000001
2799,91184544,2023-02-08,159.35,144.19
2800,91184544,2023-02-09,71.26,215.45
2801,91184544,2023-02-11,1207.7,1423.1499999999999
7501,91184544,2023-02-13,-105.4,1317.75
2727,91246568,2023-01-31,0.0,147.43
3109,91246568,2023-02-02,-189.79,-42.359999999999985
3110,91246568,2023-02-02,-111.58,-153.94
3606,91246568,2023-02-02,88.8,-65.13999999999999
3112,91246568,2023-02-06,-120.78,-185.92000000000002
3111,91246568,2023-02-06,-88.91,-274.83
3607,91246568,2023-02-06,86.91,-187.92000000000002
3608,91246568,2023-02-09,94.78,-93.13999999999999
3609,91246568,2023-02-13,55.07,-38.06999999999999
3610,91246568,2023-02-14,79.76,41.690000000000026
2728,91251995,2023-01-31,0.0,244.0
6151,91251995,2023-02-05,-135.59,108.41
6152,91251995,2023-02-07,-181.11,-72.70000000000005
8549,91251995,2023-02-12,92.56,19.859999999999985
2729,91259453,2023-01-31,0.0,816.68
3242,91259453,2023-02-02,224.1,1040.78
3243,91259453,2023-02-11,6.19,1046.97
3244,91259453,2023-02-12,1801.4,2848.37
8646,91259453,2023-02-13,-52.26,2796.11
2730,91305080,2023-01-31,0.0,123.21
683,91305080,2023-02-01,105.63,228.83999999999997
7240,91305080,2023-02-07,-66.78,162.06
7241,91305080,2023-02-11,-125.91,36.14999999999999
7242,91305080,2023-02-11,-29.76,6.389999999999986
684,91305080,2023-02-14,111.08,117.46999999999998
685,91305080,2023-02-14,1288.0,1405.47
2731,91349198,2023-01-31,0.0,669.58
7146,91349198,2023-02-06,-1.46,668.12
7147,91349198,2023-02-09,-54.69,613.4300000000001
8287,91349198,2023-02-10,123.66,737.09
7148,91349198,2023-02-11,-101.75,635.34
7149,91349198,2023-02-12,-1149.0,-513.66
2732,91373446,2023-01-31,0.0,561.42
32,91373446,2023-02-01,-87.59,473.8299999999999
33,91373446,2023-02-03,-126.64,347.18999999999994
34,91373446,2023-02-05,-112.73,234.45999999999992
6347,91373446,2023-02-05,55.81,290.27
35,91373446,2023-02-06,-137.1,153.16999999999996
36,91373446,2023-02-09,-64.96,88.20999999999998
6348,91373446,2023-02-09,165.46,253.66999999999996
37,91373446,2023-02-11,-510.2,-256.5300000000001
6349,91373446,2023-02-14,64.61,-191.92000000000007
2733,91382872,2023-01-31,0.0,782.62
8388,91382872,2023-02-10,96.17,878.79
8525,91382872,2023-02-12,-96.6,782.19
2734,91423814,2023-01-31,0.0,957.99
6970,91423814,2023-02-06,-113.54,844.45
6971,91423814,2023-02-06,-59.52,784.9300000000001
2735,91445572,2023-01-31,0.0,405.88
2246,91445572,2023-02-02,58.4,464.28
2247,91445572,2023-02-03,156.41,620.69
2736,91576212,2023-01-31,0.0,824.71
2306,91576212,2023-02-02,-120.45,704.26
2307,91576212,2023-02-03,-117.46,586.8000000000001
5941,91576212,2023-02-05,53.81,640.61
2308,91576212,2023-02-08,-85.9,554.71
5942,91576212,2023-02-08,1254.7,1809.41
2309,91576212,2023-02-09,-1301.5,507.9100000000001
5943,91576212,2023-02-12,989.2,1497.1100000000001
2737,91605034,2023-01-31,0.0,560.96
3250,91605034,2023-02-02,162.1,723.0600000000001
3251,91605034,2023-02-09,91.82,814.88
8508,91605034,2023-02-12,-1030.7,-215.82000000000005
2738,91621026,2023-01-31,0.0,834.74
6931,91621026,2023-02-06,96.79,931.53
8236,91621026,2023-02-10,-739.5,192.02999999999997
6934,91621026,2023-02-12,65.91,257.93999999999994
6935,91621026,2023-02-12,129.73,387.66999999999996
6932,91621026,2023-02-12,142.86,530.53
6933,91621026,2023-02-12,145.55,676.0799999999999
2739,91658755,2023-01-31,0.0,347.59
2030,91658755,2023-02-01,126.06,473.65
4040,91658755,2023-02-03,-1016.9,-543.25
2031,91658755,2023-02-03,59.28,-483.9700000000001
4042,91658755,2023-02-08,-189.28,-673.25
4041,91658755,2023-02-08,-69.56,-742.8100000000002
2032,91658755,2023-02-10,882.0,139.18999999999988
4043,91658755,2023-02-11,-112.56,26.62999999999988
2033,91658755,2023-02-14,166.87,193.4999999999999
2740,91703213,2023-01-31,0.0,891.67
590,91703213,2023-02-01,54.25,945.92
591,91703213,2023-02-06,43.89,989.81
592,91703213,2023-02-07,104.21,1094.02
7707,91703213,2023-02-08,-62.19,1031.83
7709,91703213,2023-02-09,-780.7,251.12999999999988
7708,91703213,2023-02-09,-201.62,49.50999999999988
593,91703213,2023-02-10,132.35,181.8599999999999
2741,91747441,2023-01-31,0.0,356.85
4753,91747441,2023-02-03,87.05,443.90000000000003
6275,91747441,2023-02-05,-103.17,340.73
4754,91747441,2023-02-05,202.11,542.84
4755,91747441,2023-02-09,76.74,619.58
6276,91747441,2023-02-11,-129.66,489.92
4756,91747441,2023-02-11,108.78,598.7
6277,91747441,2023-02-13,-151.93,446.77
2742,91819341,2023-01-31,0.0,701.61
2321,91819341,2023-02-02,-99.58,602.03
2323,91819341,2023-02-07,-90.26,511.77
2322,91819341,2023-02-07,-44.98,466.79
2324,91819341,2023-02-09,-103.88,362.91
8153,91819341,2023-02-09,115.89,478.8
2325,91819341,2023-02-10,-170.55,308.25
2743,91829198,2023-01-31,0.0,103.19
8113,91829198,2023-02-09,-1156.9,-1053.71
8185,91829198,2023-02-10,1585.0,531.29
8186,91829198,2023-02-12,90.34,621.6299999999999
8114,91829198,2023-02-13,-138.85,482.7799999999999
2744,91834926,2023-01-31,0.0,793.19
4666,91834926,2023-02-03,53.42,846.61
5961,91834926,2023-02-04,-8.63,837.98
5962,91834926,2023-02-09,-121.5,716.48
5963,91834926,2023-02-11,-143.86,572.62
4667,91834926,2023-02-12,75.44,648.0600000000001
4668,91834926,2023-02-14,89.16,737.22
2745,91859090,2023-01-31,0.0,10.38
2334,91859090,2023-02-02,231.9,242.28
2335,91859090,2023-02-04,97.84,340.12
2336,91859090,2023-02-06,114.75,454.87
2337,91859090,2023-02-08,206.07,660.9399999999999
2338,91859090,2023-02-09,160.06,821.0
2339,91859090,2023-02-14,52.73,873.73
2746,91885907,2023-01-31,0.0,652.65
4966,91885907,2023-02-03,610.8,1263.4499999999998
6632,91885907,2023-02-05,-125.05,1138.3999999999999
4967,91885907,2023-02-05,107.87,1246.27
6633,91885907,2023-02-06,-70.1,1176.17
6634,91885907,2023-02-08,-110.64,1065.53
6635,91885907,2023-02-13,-114.36,951.17
2747,91939298,2023-01-31,0.0,61.59
1496,91939298,2023-02-01,-121.69,-60.099999999999994
1497,91939298,2023-02-02,-122.81,-182.91
1498,91939298,2023-02-04,-110.99,-293.9
7602,91939298,2023-02-07,86.83,-207.06999999999996
1499,91939298,2023-02-12,-91.62,-298.68999999999994
7603,91939298,2023-02-14,126.03,-172.66
2748,91943555,2023-01-31,0.0,438.21
5083,91943555,2023-02-04,-119.74,318.46999999999997
7422,91943555,2023-02-07,201.7,520.17
5084,91943555,2023-02-13,-112.0,408.16999999999996
2749,91944915,2023-01-31,0.0,601.21
888,91944915,2023-02-01,100.12,701.33
889,91944915,2023-02-10,192.08,893.4100000000001
8523,91944915,2023-02-12,-68.26,825.1500000000001
2750,91957838,2023-01-31,0.0,587.57
4900,91957838,2023-02-03,80.26,667.83
6086,91957838,2023-02-05,-152.02,515.8100000000001
6085,91957838,2023-02-05,-100.87,414.94000000000005
4901,91957838,2023-02-05,81.6,496.54
6087,91957838,2023-02-10,-209.84,286.70000000000005
4902,91957838,2023-02-11,169.33,456.03000000000003
2751,91971494,2023-01-31,0.0,74.37
3580,91971494,2023-02-02,-787.6,-713.23
6910,91971494,2023-02-06,1053.5,340.27
3581,91971494,2023-02-09,-645.9,-305.63
3582,91971494,2023-02-10,-168.19,-473.82000000000005
2752,91972687,2023-01-31,0.0,463.97
7342,91972687,2023-02-07,93.03,557.0
7343,91972687,2023-02-10,1128.4,1685.4
8677,91972687,2023-02-14,-144.57,1540.8300000000002
2753,92001688,2023-01-31,0.0,339.08
6055,92001688,2023-02-05,-100.23,238.84999999999997
7311,92001688,2023-02-07,60.76,299.60999999999996
6056,92001688,2023-02-08,-72.05,227.55999999999997
7313,92001688,2023-02-08,94.91,322.46999999999997
7312,92001688,2023-02-08,203.33,525.8
7314,92001688,2023-02-11,62.36,588.16
6057,92001688,2023-02-14,-207.36,380.79999999999995
2754,92015508,2023-01-31,0.0,457.52
5454,92015508,2023-02-04,-76.06,381.46
5455,92015508,2023-02-05,-52.36,329.09999999999997
7186,92015508,2023-02-06,171.67,500.77
5456,92015508,2023-02-07,-119.25,381.52
5457,92015508,2023-02-10,-83.79,297.72999999999996
5458,92015508,2023-02-11,-29.25,268.47999999999996
5459,92015508,2023-02-14,-150.24,118.23999999999995
2755,92037264,2023-01-31,0.0,252.95
4993,92037264,2023-02-03,1131.6,1384.55
6455,92037264,2023-02-05,-109.6,1274.9499999999998
4994,92037264,2023-02-05,81.8,1356.75
6456,92037264,2023-02-09,-128.74,1228.01
4995,92037264,2023-02-09,7.4,1235.4099999999999
6457,92037264,2023-02-10,-56.59,1178.82
4996,92037264,2023-02-11,126.5,1305.32
6458,92037264,2023-02-12,-151.48,1153.84
6460,92037264,2023-02-14,-128.56,1025.28
6459,92037264,2023-02-14,-73.4,951.8799999999999
2756,92052516,2023-01-31,0.0,466.43
3274,92052516,2023-02-02,1082.7,1549.13
3275,92052516,2023-02-06,368.9,1918.03
3276,92052516,2023-02-07,56.32,1974.3500000000001
8521,92052516,2023-02-12,-27.9,1946.45
8522,92052516,2023-02-14,-68.7,1877.75
2757,92145159,2023-01-31,0.0,61.65
303,92145159,2023-02-01,105.36,167.01
304,92145159,2023-02-01,105.61,272.62
305,92145159,2023-02-01,122.63,395.25
7014,92145159,2023-02-06,-104.1,291.15
7015,92145159,2023-02-07,-134.99,156.16
306,92145159,2023-02-10,136.31,292.46999999999997
7016,92145159,2023-02-12,-2208.4,-1915.93
307,92145159,2023-02-13,1370.8,-545.1300000000002
7017,92145159,2023-02-14,-615.6,-1160.73
2758,92155262,2023-01-31,0.0,501.67
4252,92155262,2023-02-03,-95.71,405.96000000000004
7706,92155262,2023-02-08,1051.3,1457.26
7707,92155262,2023-02-09,1060.0,2517.2599999999998
7708,92155262,2023-02-10,134.54,2651.8
7709,92155262,2023-02-11,175.16,2826.96
4253,92155262,2023-02-12,-39.42,2787.54
7710,92155262,2023-02-12,58.39,2845.93
2759,92195724,2023-01-31,0.0,726.92
259,92195724,2023-02-01,-124.27,602.65
1091,92195724,2023-02-01,98.75,701.4
260,92195724,2023-02-04,-1579.8,-878.4
261,92195724,2023-02-07,-78.1,-956.4999999999999
262,92195724,2023-02-08,-221.0,-1177.5
2760,92212099,2023-01-31,0.0,584.21
8034,92212099,2023-02-09,-120.47,463.74
8035,92212099,2023-02-12,-7.59,456.15000000000003
8547,92212099,2023-02-12,68.21,524.36
8036,92212099,2023-02-13,-59.45,464.91
8037,92212099,2023-02-14,-122.94,341.97
2761,92214557,2023-01-31,0.0,258.42
1072,92214557,2023-02-01,173.01,431.43
2340,92214557,2023-02-02,-80.13,351.3
1073,92214557,2023-02-04,158.56,509.86
1074,92214557,2023-02-05,98.2,608.06
1075,92214557,2023-02-07,123.67,731.73
1076,92214557,2023-02-07,1567.0,2298.73
1077,92214557,2023-02-12,113.72,2412.45
1078,92214557,2023-02-13,95.71,2508.16
2762,92221411,2023-01-31,0.0,849.46
160,92221411,2023-02-01,-122.46,727.0
161,92221411,2023-02-02,-23.22,703.78
5813,92221411,2023-02-04,72.06,775.84
5814,92221411,2023-02-06,96.4,872.24
162,92221411,2023-02-08,-89.97,782.2700000000001
5815,92221411,2023-02-08,122.18,904.45
163,92221411,2023-02-12,-123.13,781.32
164,92221411,2023-02-14,-78.83,702.49
2763,92232319,2023-01-31,0.0,416.11
3198,92232319,2023-02-02,165.3,581.4100000000001
5605,92232319,2023-02-04,-126.98,454.43
5606,92232319,2023-02-05,-212.21,242.22000000000003
5607,92232319,2023-02-08,-114.69,127.52999999999997
3199,92232319,2023-02-10,67.69,195.22
3200,92232319,2023-02-11,96.88,292.1
2764,92234913,2023-01-31,0.0,613.18
7405,92234913,2023-02-07,-142.6,470.5799999999999
8533,92234913,2023-02-12,803.9,1274.48
7406,92234913,2023-02-13,-40.95,1233.5299999999997
2765,92287463,2023-01-31,0.0,257.14
70,92287463,2023-02-01,-84.96,172.18
71,92287463,2023-02-03,-85.62,86.56
72,92287463,2023-02-06,-109.51,-22.950000000000045
7207,92287463,2023-02-06,110.26,87.31
73,92287463,2023-02-07,-102.22,-14.910000000000025
7208,92287463,2023-02-09,111.55,96.63999999999999
7209,92287463,2023-02-11,31.41,128.04999999999998
7210,92287463,2023-02-12,79.05,207.09999999999997
2766,92319358,2023-01-31,0.0,116.51
804,92319358,2023-02-01,94.06,210.57
805,92319358,2023-02-05,700.4,910.97
806,92319358,2023-02-06,143.57,1054.54
7247,92319358,2023-02-07,-135.69,918.8499999999999
7248,92319358,2023-02-07,-96.55,822.3
7249,92319358,2023-02-09,-625.1,197.19999999999993
807,92319358,2023-02-09,1877.3,2074.5
7251,92319358,2023-02-10,-137.56,1936.94
7250,92319358,2023-02-10,-47.75,1889.19
808,92319358,2023-02-11,157.6,2046.79
7252,92319358,2023-02-13,-126.66,1920.1299999999999
2767,92338537,2023-01-31,0.0,316.24
505,92338537,2023-02-01,-75.36,240.88
506,92338537,2023-02-05,-403.6,-162.72000000000003
6433,92338537,2023-02-05,170.82,8.099999999999966
6434,92338537,2023-02-08,30.21,38.309999999999945
507,92338537,2023-02-13,-22.49,15.819999999999993
6435,92338537,2023-02-13,262.4,278.21999999999997
2768,92340721,2023-01-31,0.0,844.79
6476,92340721,2023-02-05,1168.4,2013.19
7164,92340721,2023-02-06,-163.65,1849.54
6478,92340721,2023-02-07,34.65,1884.19
6477,92340721,2023-02-07,744.0,2628.19
6479,92340721,2023-02-08,110.64,2738.83
7166,92340721,2023-02-11,-187.8,2551.0299999999997
7165,92340721,2023-02-11,-58.37,2492.66
7167,92340721,2023-02-12,-112.23,2380.4300000000003
2769,92376825,2023-01-31,0.0,323.68
2011,92376825,2023-02-01,158.59,482.27
2012,92376825,2023-02-04,100.39,582.6600000000001
2013,92376825,2023-02-05,197.01,779.6700000000001
2014,92376825,2023-02-10,145.53,925.2
2015,92376825,2023-02-11,1214.6,2139.7999999999997
2016,92376825,2023-02-12,120.9,2260.7
2017,92376825,2023-02-13,103.99,2364.69
2770,92390334,2023-01-31,0.0,602.62
2002,92390334,2023-02-01,-136.22,466.4
2003,92390334,2023-02-04,-68.87,397.53
2771,92423759,2023-01-31,0.0,475.1
5085,92423759,2023-02-04,-664.6,-189.5
5308,92423759,2023-02-04,131.28,-58.22000000000003
5309,92423759,2023-02-06,90.64,32.420000000000016
2772,92437489,2023-01-31,0.0,24.19
5092,92437489,2023-02-04,-40.15,-15.959999999999997
6784,92437489,2023-02-06,176.4,160.44
5093,92437489,2023-02-10,-89.99,70.45
5094,92437489,2023-02-10,-73.65,-3.1999999999999993
2773,92551293,2023-01-31,0.0,252.3
4206,92551293,2023-02-03,55.02,307.32
8643,92551293,2023-02-13,-122.87,184.45000000000002
2774,92563438,2023-01-31,0.0,965.81
1745,92563438,2023-02-01,-164.94,800.8699999999999
991,92563438,2023-02-01,107.56,908.43
992,92563438,2023-02-04,139.7,1048.1299999999999
1746,92563438,2023-02-09,-99.18,948.9499999999999
1747,92563438,2023-02-10,-118.13,830.8199999999999
1748,92563438,2023-02-13,-76.58,754.24
1749,92563438,2023-02-14,-66.88,687.3599999999999
2775,92684055,2023-01-31,0.0,430.86
4865,92684055,2023-02-03,-165.51,265.35
8437,92684055,2023-02-11,59.3,324.65000000000003
8436,92684055,2023-02-11,121.16,445.81
4866,92684055,2023-02-13,-63.47,382.34000000000003
2776,92750088,2023-01-31,0.0,560.4
1669,92750088,2023-02-01,-1069.7,-509.30000000000007
5184,92750088,2023-02-04,199.36,-309.94000000000005
5185,92750088,2023-02-05,149.93,-160.0100000000001
5186,92750088,2023-02-06,66.17,-93.84000000000003
5187,92750088,2023-02-07,104.75,10.909999999999968
2777,92770567,2023-01-31,0.0,949.66
1551,92770567,2023-02-01,-120.09,829.5699999999999
1552,92770567,2023-02-04,-68.76,760.81
1553,92770567,2023-02-05,-39.31,721.5
1554,92770567,2023-02-06,-162.2,559.3
1555,92770567,2023-02-07,-102.52,456.78
7666,92770567,2023-02-07,135.62,592.4
1557,92770567,2023-02-13,-144.25,448.15
1556,92770567,2023-02-13,-33.75,414.4
7667,92770567,2023-02-13,136.98,551.38
2778,92840827,2023-01-31,0.0,403.77
4746,92840827,2023-02-03,106.35,510.12
4747,92840827,2023-02-10,82.0,592.12
8620,92840827,2023-02-13,-157.41,434.71
8619,92840827,2023-02-13,-78.01,356.7
2779,92872571,2023-01-31,0.0,933.03
933,92872571,2023-02-01,96.06,1029.09
934,92872571,2023-02-05,89.62,1118.71
8027,92872571,2023-02-09,-50.78,1067.93
935,92872571,2023-02-12,233.91,1301.84
936,92872571,2023-02-14,124.26,1426.1
2780,92898446,2023-01-31,0.0,64.49
7492,92898446,2023-02-07,1.77,66.25999999999999
7490,92898446,2023-02-07,41.35,107.61
7491,92898446,2023-02-07,184.29,291.9
7826,92898446,2023-02-08,-46.43,245.46999999999997
7827,92898446,2023-02-09,-132.58,112.88999999999997
7493,92898446,2023-02-09,6.95,119.83999999999997
7494,92898446,2023-02-12,81.83,201.66999999999996
2781,92910876,2023-01-31,0.0,643.19
5681,92910876,2023-02-04,-8.85,634.34
5682,92910876,2023-02-05,-59.2,575.1400000000001
7682,92910876,2023-02-07,173.79,748.9300000000001
5683,92910876,2023-02-11,-85.36,663.57
5684,92910876,2023-02-14,-86.73,576.84
7683,92910876,2023-02-14,100.7,677.5400000000001
2782,92920645,2023-01-31,0.0,644.88
8335,92920645,2023-02-10,-35.64,609.24
8336,92920645,2023-02-12,-157.87,451.37
2783,92931020,2023-01-31,0.0,754.11
2684,92931020,2023-02-02,-153.04,601.07
2685,92931020,2023-02-04,-34.82,566.25
2686,92931020,2023-02-05,-815.7,-249.45000000000005
7021,92931020,2023-02-06,48.31,-201.14
7022,92931020,2023-02-09,73.42,-127.72000000000003
7023,92931020,2023-02-10,136.1,8.379999999999995
2687,92931020,2023-02-11,-1742.7,-1734.3200000000002
2688,92931020,2023-02-12,-120.86,-1855.1799999999998
2689,92931020,2023-02-13,-77.95,-1933.13
2784,92943637,2023-01-31,0.0,28.23
2543,92943637,2023-02-02,-140.57,-112.33999999999999
3981,92943637,2023-02-03,88.94,-23.399999999999995
2544,92943637,2023-02-05,-76.04,-99.44
2545,92943637,2023-02-08,-76.65,-176.09
2546,92943637,2023-02-10,-110.9,-286.99
2785,92944470,2023-01-31,0.0,445.48
1011,92944470,2023-02-01,152.59,598.07
1012,92944470,2023-02-06,100.9,698.97
8220,92944470,2023-02-10,-103.91,595.0600000000001
1013,92944470,2023-02-12,110.14,705.2
2786,92963966,2023-01-31,0.0,983.65
1948,92963966,2023-02-01,3.04,986.6899999999999
1949,92963966,2023-02-06,90.05,1076.74
2787,93009261,2023-01-31,0.0,675.04
3350,93009261,2023-02-02,100.36,775.4
3352,93009261,2023-02-05,65.1,840.5
3351,93009261,2023-02-05,119.42,959.92
3353,93009261,2023-02-06,1695.0,2654.92
7626,93009261,2023-02-07,-108.88,2546.04
3354,93009261,2023-02-08,1169.6,3715.64
7628,93009261,2023-02-09,-97.8,3617.8399999999997
7627,93009261,2023-02-09,-76.74,3541.1
7629,93009261,2023-02-10,-213.83,3327.27
3355,93009261,2023-02-10,93.3,3420.5699999999997
3356,93009261,2023-02-10,147.51,3568.08
3357,93009261,2023-02-13,125.85,3693.93
2788,93039862,2023-01-31,0.0,806.99
3438,93039862,2023-02-02,61.2,868.19
3439,93039862,2023-02-03,27.83,896.02
7431,93039862,2023-02-07,-66.88,829.14
7432,93039862,2023-02-09,-132.48,696.6600000000001
3440,93039862,2023-02-10,118.13,814.79
3441,93039862,2023-02-14,82.7,897.49
2789,93076057,2023-01-31,0.0,218.56
3331,93076057,2023-02-02,143.82,362.38
3332,93076057,2023-02-04,87.35,449.73
2790,93128216,2023-01-31,0.0,834.73
3900,93128216,2023-02-03,-144.61,690.12
3901,93128216,2023-02-03,-10.64,679.48
3902,93128216,2023-02-10,-44.74,634.74
8422,93128216,2023-02-11,168.92,803.66
3903,93128216,2023-02-14,-136.93,666.73
2791,93147630,2023-01-31,0.0,403.93
7541,93147630,2023-02-07,148.81,552.74
8496,93147630,2023-02-11,-116.92,435.82
8497,93147630,2023-02-13,-136.72,299.1
7542,93147630,2023-02-13,130.18,429.28000000000003
2792,93192347,2023-01-31,0.0,298.01
612,93192347,2023-02-01,-1277.2,-979.19
613,93192347,2023-02-04,-126.02,-1105.21
5398,93192347,2023-02-04,158.04,-947.1700000000001
5399,93192347,2023-02-05,51.72,-895.45
5400,93192347,2023-02-08,92.59,-802.8600000000001
5401,93192347,2023-02-09,1325.7,522.8399999999999
614,93192347,2023-02-12,-2147.9,-1625.0600000000002
615,93192347,2023-02-14,-626.8,-2251.8599999999997
616,93192347,2023-02-14,-171.25,-2423.1099999999997
2793,93248179,2023-01-31,0.0,376.57
369,93248179,2023-02-01,-130.11,246.45999999999998
368,93248179,2023-02-01,-27.36,219.09999999999997
5381,93248179,2023-02-04,182.66,401.76
2794,93306742,2023-01-31,0.0,388.54
8404,93306742,2023-02-11,181.51,570.05
8405,93306742,2023-02-13,43.87,613.9200000000001
8406,93306742,2023-02-13,61.83,675.75
2795,93325549,2023-01-31,0.0,161.45
559,93325549,2023-02-01,177.63,339.08
560,93325549,2023-02-05,790.5,1129.58
561,93325549,2023-02-08,168.29,1297.8700000000001
562,93325549,2023-02-10,106.29,1404.16
8461,93325549,2023-02-11,-68.2,1335.96
563,93325549,2023-02-14,79.28,1415.24
2796,93346040,2023-01-31,0.0,816.07
1193,93346040,2023-02-01,-69.18,746.8900000000001
1194,93346040,2023-02-06,-12.77,734.12
1196,93346040,2023-02-07,-814.4,-80.27999999999997
1195,93346040,2023-02-07,-135.7,-215.9799999999999
7345,93346040,2023-02-07,10.31,-205.66999999999996
7346,93346040,2023-02-08,153.79,-51.879999999999995
7347,93346040,2023-02-09,118.46,66.58000000000004
7348,93346040,2023-02-10,118.13,184.71000000000004
2797,93349543,2023-01-31,0.0,329.45
1878,93349543,2023-02-01,-122.63,206.82
1879,93349543,2023-02-03,-103.43,103.38999999999999
1880,93349543,2023-02-04,-118.6,-15.20999999999998
1881,93349543,2023-02-05,-86.14,-101.35000000000002
6514,93349543,2023-02-05,66.8,-34.55000000000001
2798,93355755,2023-01-31,0.0,753.84
4093,93355755,2023-02-03,-49.54,704.3000000000001
8080,93355755,2023-02-09,104.28,808.58
4094,93355755,2023-02-10,-11.73,796.85
2799,93388304,2023-01-31,0.0,73.0
5270,93388304,2023-02-04,66.05,139.05
5269,93388304,2023-02-04,162.79,301.84
5271,93388304,2023-02-08,38.91,340.75
5272,93388304,2023-02-09,157.3,498.05
8474,93388304,2023-02-11,-3.02,495.03000000000003
5273,93388304,2023-02-13,142.04,637.0699999999999
2800,93409343,2023-01-31,0.0,748.45
1079,93409343,2023-02-01,830.7,1579.15
6163,93409343,2023-02-05,-81.2,1497.95
6164,93409343,2023-02-06,-66.17,1431.7800000000002
1080,93409343,2023-02-08,94.16,1525.94
6165,93409343,2023-02-12,-110.2,1415.7400000000002
2801,93429066,2023-01-31,0.0,652.04
5789,93429066,2023-02-04,-146.82,505.21999999999997
5790,93429066,2023-02-05,-149.41,355.80999999999995
6444,93429066,2023-02-05,131.36,487.16999999999996
5791,93429066,2023-02-12,-96.27,390.9
2802,93443317,2023-01-31,0.0,305.29
1487,93443317,2023-02-01,124.69,429.98
1488,93443317,2023-02-02,94.47,524.45
4294,93443317,2023-02-03,-141.16,383.29
1489,93443317,2023-02-04,87.13,470.42
2803,93446276,2023-01-31,0.0,184.74
715,93446276,2023-02-01,-142.15,42.59
29,93446276,2023-02-01,89.8,132.39
28,93446276,2023-02-01,187.15,319.54
716,93446276,2023-02-02,-95.1,224.44
30,93446276,2023-02-02,162.35,386.78999999999996
31,93446276,2023-02-02,701.1,1087.8899999999999
717,93446276,2023-02-05,-106.71,981.18
718,93446276,2023-02-07,-141.05,840.13
32,93446276,2023-02-09,1679.2,2519.33
33,93446276,2023-02-10,154.12,2673.45
2804,93529019,2023-01-31,0.0,463.32
5617,93529019,2023-02-04,157.05,620.37
5618,93529019,2023-02-05,94.84,715.21
5620,93529019,2023-02-06,65.08,780.29
5619,93529019,2023-02-06,160.08,940.37
5621,93529019,2023-02-07,184.95,1125.32
7990,93529019,2023-02-08,-59.4,1065.92
7991,93529019,2023-02-09,-111.83,954.0899999999999
7992,93529019,2023-02-10,-82.73,871.36
5622,93529019,2023-02-11,1507.4,2378.76
7993,93529019,2023-02-14,-157.14,2221.6200000000003
2805,93559470,2023-01-31,0.0,210.7
1691,93559470,2023-02-01,-126.64,84.05999999999999
1692,93559470,2023-02-05,-749.9,-665.8399999999999
6255,93559470,2023-02-05,64.51,-601.3299999999999
1693,93559470,2023-02-08,-107.7,-709.03
6256,93559470,2023-02-08,162.59,-546.44
1694,93559470,2023-02-09,-150.22,-696.6599999999999
1695,93559470,2023-02-10,-86.61,-783.27
6257,93559470,2023-02-10,73.99,-709.28
2806,93564856,2023-01-31,0.0,234.66
491,93564856,2023-02-01,117.24,351.9
492,93564856,2023-02-06,93.76,445.65999999999997
493,93564856,2023-02-09,97.55,543.21
494,93564856,2023-02-10,67.2,610.41
495,93564856,2023-02-11,119.87,730.28
496,93564856,2023-02-12,1690.9,2421.18
8688,93564856,2023-02-14,-96.41,2324.77
2807,93569124,2023-01-31,0.0,221.11
8323,93569124,2023-02-10,156.63,377.74
8324,93569124,2023-02-11,3.02,380.76
8683,93569124,2023-02-14,-80.98,299.78
2808,93624474,2023-01-31,0.0,622.14
3368,93624474,2023-02-02,114.87,737.01
3369,93624474,2023-02-03,85.3,822.31
5473,93624474,2023-02-04,-31.94,790.37
3370,93624474,2023-02-04,80.51,870.88
5474,93624474,2023-02-09,-940.9,-70.01999999999998
5475,93624474,2023-02-10,-57.04,-127.05999999999995
3371,93624474,2023-02-11,1058.7,931.6400000000001
3372,93624474,2023-02-14,93.52,1025.16
2809,93630048,2023-01-31,0.0,317.95
2452,93630048,2023-02-02,35.9,353.84999999999997
3929,93630048,2023-02-03,-61.29,292.56
3930,93630048,2023-02-03,-56.07,236.48999999999998
3931,93630048,2023-02-14,-66.36,170.13
2453,93630048,2023-02-14,34.96,205.09
2810,93707181,2023-01-31,0.0,321.91
2049,93707181,2023-02-01,99.63,421.54
2050,93707181,2023-02-03,144.82,566.36
2051,93707181,2023-02-05,87.06,653.4200000000001
2811,93745446,2023-01-31,0.0,574.89
3530,93745446,2023-02-02,787.6,1362.49
3531,93745446,2023-02-05,177.67,1540.1599999999999
3532,93745446,2023-02-08,136.68,1676.8400000000001
3533,93745446,2023-02-09,50.28,1727.12
8363,93745446,2023-02-10,-1275.3,451.82000000000005
8364,93745446,2023-02-12,-91.07,360.75000000000006
8365,93745446,2023-02-12,-64.01,296.74000000000007
3534,93745446,2023-02-12,94.0,390.74000000000007
8366,93745446,2023-02-13,-185.27,205.47000000000003
2812,93747938,2023-01-31,0.0,724.31
7661,93747938,2023-02-07,-1076.8,-352.49
7775,93747938,2023-02-08,55.57,-296.91999999999996
7662,93747938,2023-02-09,-158.5,-455.4200000000001
7663,93747938,2023-02-10,-59.31,-514.73
2813,93840154,2023-01-31,0.0,159.7
6581,93840154,2023-02-05,-94.38,65.32
7924,93840154,2023-02-08,114.36,179.68
6582,93840154,2023-02-10,-90.78,88.89999999999999
6583,93840154,2023-02-14,-22.59,66.30999999999999
7925,93840154,2023-02-14,99.95,166.26
2814,93932516,2023-01-31,0.0,575.82
3089,93932516,2023-02-02,-110.52,465.30000000000007
3090,93932516,2023-02-05,-859.9,-394.5999999999999
3091,93932516,2023-02-07,-36.15,-430.7499999999999
7624,93932516,2023-02-07,132.98,-297.76999999999987
3092,93932516,2023-02-08,-15.71,-313.4799999999999
7625,93932516,2023-02-08,217.58,-95.89999999999998
7626,93932516,2023-02-09,105.71,9.81000000000006
3093,93932516,2023-02-11,-62.36,-52.549999999999955
3094,93932516,2023-02-13,-153.14,-205.68999999999994
2815,93981472,2023-01-31,0.0,175.68
2884,93981472,2023-02-02,1298.8,1474.48
2885,93981472,2023-02-05,178.08,1652.56
7677,93981472,2023-02-08,-597.4,1055.16
2886,93981472,2023-02-08,114.16,1169.32
7678,93981472,2023-02-10,-82.23,1087.09
2887,93981472,2023-02-10,108.85,1195.94
2888,93981472,2023-02-10,131.62,1327.5600000000002
7679,93981472,2023-02-12,-190.17,1137.39
7680,93981472,2023-02-13,-104.7,1032.69
7681,93981472,2023-02-14,-135.14,897.55
2816,94044891,2023-01-31,0.0,367.77
3762,94044891,2023-02-03,123.6,491.37
6090,94044891,2023-02-05,-102.47,388.9
3763,94044891,2023-02-06,57.47,446.37
6091,94044891,2023-02-13,-112.88,333.49
2817,94060198,2023-01-31,0.0,309.9
730,94060198,2023-02-01,-1663.4,-1353.5
731,94060198,2023-02-02,-166.1,-1519.6
732,94060198,2023-02-03,-103.32,-1622.92
6594,94060198,2023-02-05,1317.7,-305.22000000000014
733,94060198,2023-02-09,-82.05,-387.2700000000001
6595,94060198,2023-02-10,59.66,-327.6100000000001
6596,94060198,2023-02-10,145.86,-181.7500000000001
6597,94060198,2023-02-13,47.89,-133.86000000000013
2818,94082779,2023-01-31,0.0,49.87
4666,94082779,2023-02-03,-76.42,-26.550000000000004
7068,94082779,2023-02-06,89.28,62.73
7069,94082779,2023-02-13,127.51,190.24
2819,94096082,2023-01-31,0.0,342.2
5922,94096082,2023-02-05,159.46,501.65999999999997
8062,94096082,2023-02-09,-134.28,367.38
5923,94096082,2023-02-13,445.8,813.1800000000001
2820,94106013,2023-01-31,0.0,844.86
5718,94106013,2023-02-04,58.55,903.41
5717,94106013,2023-02-04,87.65,991.06
5719,94106013,2023-02-07,119.45,1110.51
8577,94106013,2023-02-12,-94.08,1016.4300000000001
5720,94106013,2023-02-14,148.07,1164.5
2821,94163785,2023-01-31,0.0,953.91
4980,94163785,2023-02-03,886.3,1840.21
5026,94163785,2023-02-04,-100.25,1739.96
5027,94163785,2023-02-06,-115.81,1624.15
5028,94163785,2023-02-07,-118.34,1505.81
5029,94163785,2023-02-12,-100.49,1405.32
5030,94163785,2023-02-14,-166.87,1238.4499999999998
2822,94171142,2023-01-31,0.0,261.94
1533,94171142,2023-02-01,-123.08,138.86
1534,94171142,2023-02-02,-133.09,5.769999999999982
2659,94171142,2023-02-02,148.35,154.12
1535,94171142,2023-02-08,-522.3,-368.1799999999999
1536,94171142,2023-02-09,-65.15,-433.32999999999987
1537,94171142,2023-02-11,-149.19,-582.52
2660,94171142,2023-02-11,17.89,-564.6299999999999
1538,94171142,2023-02-14,-483.2,-1047.83
2823,94200289,2023-01-31,0.0,207.5
6366,94200289,2023-02-05,-123.78,83.72
6365,94200289,2023-02-05,-27.36,56.360000000000014
6367,94200289,2023-02-06,-15.22,41.139999999999986
6986,94200289,2023-02-06,178.95,220.08999999999997
6368,94200289,2023-02-07,-70.76,149.32999999999998
6987,94200289,2023-02-12,153.75,303.08
6369,94200289,2023-02-14,-131.36,171.71999999999997
2824,94208888,2023-01-31,0.0,97.84
4390,94208888,2023-02-03,-164.94,-67.1
5414,94208888,2023-02-04,109.5,42.400000000000006
4391,94208888,2023-02-11,-1944.9,-1902.5000000000002
4392,94208888,2023-02-12,-109.26,-2011.7600000000004
2825,94212460,2023-01-31,0.0,215.27
2826,94228831,2023-01-31,0.0,277.02
2847,94228831,2023-02-02,140.61,417.63
4544,94228831,2023-02-03,-131.74,285.89
4545,94228831,2023-02-06,-110.54,175.34999999999997
2848,94228831,2023-02-06,109.48,284.83
2849,94228831,2023-02-12,176.03,460.86
2827,94247629,2023-01-31,0.0,308.63
5711,94247629,2023-02-04,39.76,348.39
5712,94247629,2023-02-05,105.91,454.29999999999995
7549,94247629,2023-02-07,-1738.7,-1284.4
5713,94247629,2023-02-12,110.2,-1174.1999999999998
2828,94331180,2023-01-31,0.0,89.31
1994,94331180,2023-02-01,-54.98,34.330000000000005
7399,94331180,2023-02-07,101.44,135.77
1995,94331180,2023-02-11,-105.42,30.35
1996,94331180,2023-02-13,-70.85,-40.5
2829,94342965,2023-01-31,0.0,282.51
3079,94342965,2023-02-02,107.51,390.02
6565,94342965,2023-02-05,-159.07,230.95
3080,94342965,2023-02-09,1208.0,1438.95
6566,94342965,2023-02-12,-133.51,1305.44
2830,94365401,2023-01-31,0.0,81.28
2409,94365401,2023-02-02,37.62,118.9
4931,94365401,2023-02-03,-101.25,17.65
2410,94365401,2023-02-08,93.77,111.41999999999999
2411,94365401,2023-02-11,122.21,233.63
4932,94365401,2023-02-12,-31.2,202.42999999999998
2831,94409941,2023-01-31,0.0,642.83
1108,94409941,2023-02-01,-92.51,550.32
5346,94409941,2023-02-04,629.0,1179.3200000000002
5347,94409941,2023-02-12,66.55,1245.87
1109,94409941,2023-02-14,-867.5,378.37
1110,94409941,2023-02-14,-152.69,225.68
2832,94437482,2023-01-31,0.0,415.91
6931,94437482,2023-02-06,-143.44,272.47
6655,94437482,2023-02-06,94.32,366.79
6932,94437482,2023-02-09,-53.97,312.82000000000005
6933,94437482,2023-02-10,-46.55,266.27000000000004
6656,94437482,2023-02-14,950.7,1216.97
2833,94457332,2023-01-31,0.0,764.02
6530,94457332,2023-02-05,-107.79,656.23
7114,94457332,2023-02-06,146.96,803.1899999999999
6531,94457332,2023-02-14,-33.66,769.53
2834,94493359,2023-01-31,0.0,17.96
4531,94493359,2023-02-03,-133.41,-115.44999999999999
4532,94493359,2023-02-06,-112.02,-227.47
4533,94493359,2023-02-07,-171.17,-398.64
4534,94493359,2023-02-10,-83.93,-482.57
4535,94493359,2023-02-11,-102.91,-585.4799999999999
8456,94493359,2023-02-11,129.35,-456.13
4536,94493359,2023-02-12,-106.86,-562.9899999999999
2835,94525216,2023-01-31,0.0,635.22
3148,94525216,2023-02-02,44.56,679.78
6401,94525216,2023-02-05,-115.1,564.6800000000001
6402,94525216,2023-02-07,-183.44,381.24
3149,94525216,2023-02-07,97.95,479.19000000000005
3150,94525216,2023-02-07,132.14,611.33
3151,94525216,2023-02-09,190.82,802.1500000000001
3152,94525216,2023-02-10,139.51,941.6600000000001
2836,94566140,2023-01-31,0.0,31.61
5897,94566140,2023-02-04,-54.15,-22.54
5898,94566140,2023-02-06,-128.91,-151.45
5899,94566140,2023-02-07,-152.23,-303.67999999999995
7480,94566140,2023-02-07,38.88,-264.79999999999995
7481,94566140,2023-02-09,44.94,-219.86
5900,94566140,2023-02-13,-104.5,-324.36
7482,94566140,2023-02-14,38.12,-286.24
2837,94615411,2023-01-31,0.0,147.21
2693,94615411,2023-02-02,-1015.8,-868.5899999999999
5261,94615411,2023-02-04,151.32,-717.27
5262,94615411,2023-02-08,71.98,-645.29
2694,94615411,2023-02-09,-109.51,-754.8
5263,94615411,2023-02-09,176.97,-577.8299999999999
2695,94615411,2023-02-10,-79.77,-657.5999999999999
2696,94615411,2023-02-12,-93.78,-751.3799999999999
5264,94615411,2023-02-12,138.36,-613.02
2838,94629877,2023-01-31,0.0,908.69
4478,94629877,2023-02-03,65.94,974.6300000000001
5395,94629877,2023-02-04,-1031.4,-56.76999999999998
5394,94629877,2023-02-04,-686.5,-743.27
4479,94629877,2023-02-04,884.9,141.63
5396,94629877,2023-02-05,-112.93,28.700000000000045
4480,94629877,2023-02-09,899.8,928.5
4481,94629877,2023-02-10,181.71,1110.21
4482,94629877,2023-02-12,72.46,1182.67
2839,94635297,2023-01-31,0.0,353.43
2175,94635297,2023-02-02,-25.81,327.62
4076,94635297,2023-02-03,115.87,443.49
2176,94635297,2023-02-04,-92.27,351.22
4077,94635297,2023-02-05,82.64,433.86
2177,94635297,2023-02-08,-76.81,357.05
2840,94645169,2023-01-31,0.0,854.22
2050,94645169,2023-02-01,-98.05,756.1700000000001
2051,94645169,2023-02-03,-12.0,744.1700000000001
2053,94645169,2023-02-07,-133.96,610.21
2052,94645169,2023-02-07,-74.77,535.44
7525,94645169,2023-02-07,125.24,660.6800000000001
2054,94645169,2023-02-11,-173.97,486.71000000000004
7526,94645169,2023-02-12,128.94,615.65
2055,94645169,2023-02-13,-127.51,488.14
2056,94645169,2023-02-14,-0.73,487.41
2841,94660017,2023-01-31,0.0,107.29
281,94660017,2023-02-01,-115.14,-7.849999999999994
8272,94660017,2023-02-10,86.75,78.9
8273,94660017,2023-02-12,41.61,120.51
8275,94660017,2023-02-13,47.03,167.54000000000002
8274,94660017,2023-02-13,123.64,291.18
2842,94677908,2023-01-31,0.0,343.33
1901,94677908,2023-02-01,115.41,458.74
1903,94677908,2023-02-03,88.14,546.88
1902,94677908,2023-02-03,117.22,664.0999999999999
5640,94677908,2023-02-04,-106.07,558.03
5641,94677908,2023-02-07,-121.46,436.57
5642,94677908,2023-02-08,-143.85,292.72
1904,94677908,2023-02-09,138.19,430.90999999999997
5643,94677908,2023-02-12,-1534.6,-1103.69
1905,94677908,2023-02-13,170.79,-932.9000000000001
2843,94716844,2023-01-31,0.0,605.84
1670,94716844,2023-02-01,-102.9,502.94000000000005
1671,94716844,2023-02-04,-90.09,412.85
5467,94716844,2023-02-04,168.29,581.14
1672,94716844,2023-02-06,-58.17,522.97
5468,94716844,2023-02-08,123.06,646.03
5469,94716844,2023-02-10,62.94,708.97
1673,94716844,2023-02-11,-62.9,646.07
1674,94716844,2023-02-13,-101.87,544.2
5470,94716844,2023-02-13,80.74,624.94
5472,94716844,2023-02-14,94.45,719.39
5471,94716844,2023-02-14,198.2,917.59
2844,94729530,2023-01-31,0.0,635.76
699,94729530,2023-02-01,58.96,694.72
698,94729530,2023-02-01,62.95,757.67
700,94729530,2023-02-01,136.75,894.42
8237,94729530,2023-02-10,-142.57,751.85
702,94729530,2023-02-13,104.5,856.35
701,94729530,2023-02-13,163.99,1020.34
2845,94732589,2023-01-31,0.0,697.54
2902,94732589,2023-02-02,-90.91,606.63
2903,94732589,2023-02-03,-180.87,425.76
2904,94732589,2023-02-03,-139.6,286.15999999999997
5527,94732589,2023-02-04,102.44,388.59999999999997
5529,94732589,2023-02-06,47.78,436.38
5528,94732589,2023-02-06,124.22,560.5999999999999
2905,94732589,2023-02-14,-120.42,440.17999999999995
2846,94748860,2023-01-31,0.0,630.6
5866,94748860,2023-02-04,44.05,674.65
5867,94748860,2023-02-08,31.3,705.95
5868,94748860,2023-02-08,119.07,825.02
2847,94796578,2023-01-31,0.0,700.49
769,94796578,2023-02-01,-1057.7,-357.21000000000004
4142,94796578,2023-02-03,40.39,-316.82000000000005
4143,94796578,2023-02-03,65.14,-251.68000000000006
4144,94796578,2023-02-05,112.69,-138.99
4145,94796578,2023-02-06,84.58,-54.41000000000008
4146,94796578,2023-02-06,110.83,56.41999999999996
770,94796578,2023-02-07,-169.36,-112.94000000000005
771,94796578,2023-02-08,-167.11,-280.05000000000007
4147,94796578,2023-02-10,249.81,-30.24000000000001
4148,94796578,2023-02-12,48.09,17.84999999999991
4149,94796578,2023-02-13,34.3,52.14999999999998
4151,94796578,2023-02-14,68.12,120.26999999999998
4150,94796578,2023-02-14,79.54,199.80999999999995
2848,94814824,2023-01-31,0.0,716.75
6019,94814824,2023-02-05,159.3,876.05
6020,94814824,2023-02-07,11.37,887.4200000000001
8145,94814824,2023-02-09,-87.99,799.4300000000001
8146,94814824,2023-02-13,-119.69,679.74
6021,94814824,2023-02-14,60.02,739.76
2849,94893604,2023-01-31,0.0,289.19
1842,94893604,2023-02-01,122.07,411.26
2268,94893604,2023-02-02,-140.27,270.99
1843,94893604,2023-02-04,150.79,421.78
1844,94893604,2023-02-08,90.52,512.3
1845,94893604,2023-02-12,104.51,616.81
2850,94935991,2023-01-31,0.0,645.53
3804,94935991,2023-02-03,-109.74,535.79
5162,94935991,2023-02-04,7.06,542.85
5163,94935991,2023-02-04,118.19,661.04
5164,94935991,2023-02-09,84.03,745.0699999999999
5165,94935991,2023-02-10,116.72,861.79
5166,94935991,2023-02-12,1015.8,1877.59
3805,94935991,2023-02-14,-36.6,1840.99
2851,94973297,2023-01-31,0.0,761.68
5714,94973297,2023-02-04,-112.13,649.55
5715,94973297,2023-02-06,-81.6,567.9499999999999
5716,94973297,2023-02-09,-69.64,498.30999999999995
5717,94973297,2023-02-10,-73.16,425.15
8368,94973297,2023-02-10,1275.3,1700.4499999999998
5718,94973297,2023-02-14,-1365.0,335.44999999999993
2852,95009921,2023-01-31,0.0,658.77
269,95009921,2023-02-01,124.27,783.04
270,95009921,2023-02-02,103.03,886.0699999999999
271,95009921,2023-02-04,153.28,1039.35
272,95009921,2023-02-05,158.54,1197.8899999999999
273,95009921,2023-02-06,87.21,1285.1
274,95009921,2023-02-08,94.29,1379.3899999999999
8058,95009921,2023-02-09,-144.93,1234.46
275,95009921,2023-02-12,87.73,1322.19
8059,95009921,2023-02-14,-111.08,1211.11
276,95009921,2023-02-14,110.66,1321.77
277,95009921,2023-02-14,188.3,1510.07
2853,95060122,2023-01-31,0.0,771.61
4548,95060122,2023-02-03,-119.68,651.9300000000001
4547,95060122,2023-02-03,-116.84,535.09
5499,95060122,2023-02-04,152.03,687.12
4549,95060122,2023-02-06,-633.0,54.120000000000005
4551,95060122,2023-02-10,-163.3,-109.17999999999995
4550,95060122,2023-02-10,-65.02,-174.20000000000005
5500,95060122,2023-02-10,70.94,-103.25999999999999
4552,95060122,2023-02-14,-29.41,-132.66999999999996
2854,95081571,2023-01-31,0.0,712.07
878,95081571,2023-02-01,-76.26,635.8100000000001
880,95081571,2023-02-02,-125.99,509.82000000000005
879,95081571,2023-02-02,-88.57,421.25000000000006
881,95081571,2023-02-07,-168.17,253.08000000000004
7608,95081571,2023-02-07,17.58,270.6600000000001
7609,95081571,2023-02-08,60.7,331.36000000000007
7610,95081571,2023-02-08,1330.7,1662.06
7611,95081571,2023-02-09,156.71,1818.77
7612,95081571,2023-02-13,104.02,1922.79
2855,95113741,2023-01-31,0.0,102.12
2507,95113741,2023-02-02,113.73,215.85000000000002
2508,95113741,2023-02-03,189.03,404.88
2509,95113741,2023-02-07,171.53,576.4100000000001
2510,95113741,2023-02-08,63.41,639.82
2856,95213279,2023-01-31,0.0,441.59
5140,95213279,2023-02-04,-85.93,355.65999999999997
5139,95213279,2023-02-04,-7.06,348.59999999999997
5141,95213279,2023-02-05,-33.85,314.75
5142,95213279,2023-02-07,-50.49,264.26
5143,95213279,2023-02-08,-2591.7,-2327.4399999999996
5144,95213279,2023-02-11,-96.92,-2424.3599999999997
2857,95258436,2023-01-31,0.0,59.55
2233,95258436,2023-02-02,-158.32,-98.77
2234,95258436,2023-02-02,-89.87,-188.64
2802,95258436,2023-02-02,139.25,-49.39
2803,95258436,2023-02-06,75.55,26.159999999999997
2804,95258436,2023-02-09,112.05,138.20999999999998
2805,95258436,2023-02-09,141.82,280.03
2806,95258436,2023-02-10,121.81,401.84
2235,95258436,2023-02-14,-105.98,295.86
2236,95258436,2023-02-14,-101.59,194.26999999999998
2807,95258436,2023-02-14,963.5,1157.77
2858,95274344,2023-01-31,0.0,990.84
6212,95274344,2023-02-05,-962.0,28.840000000000032
6211,95274344,2023-02-05,-165.04,-136.19999999999993
6245,95274344,2023-02-05,159.79,23.590000000000032
6213,95274344,2023-02-06,-99.03,-75.43999999999994
6246,95274344,2023-02-08,123.12,47.680000000000064
6214,95274344,2023-02-14,-85.48,-37.80000000000007
2859,95277712,2023-01-31,0.0,235.91
4637,95277712,2023-02-03,83.69,319.6
5079,95277712,2023-02-04,-88.83,230.76999999999998
4638,95277712,2023-02-05,99.25,330.02
5080,95277712,2023-02-07,-123.68,206.33999999999997
5081,95277712,2023-02-11,-133.67,72.66999999999999
5082,95277712,2023-02-12,-934.7,-862.0300000000001
2860,95307629,2023-01-31,0.0,502.48
193,95307629,2023-02-01,89.15,591.63
194,95307629,2023-02-05,41.65,633.28
8030,95307629,2023-02-09,-1324.2,-690.9200000000001
8031,95307629,2023-02-12,-68.37,-759.29
196,95307629,2023-02-14,31.7,-727.5900000000001
195,95307629,2023-02-14,171.69,-555.9000000000001
2861,95309911,2023-01-31,0.0,171.61
967,95309911,2023-02-01,-82.42,89.19000000000001
3550,95309911,2023-02-02,110.35,199.54000000000002
3551,95309911,2023-02-05,39.2,238.74
3553,95309911,2023-02-06,32.34,271.08000000000004
3552,95309911,2023-02-06,154.75,425.83000000000004
968,95309911,2023-02-09,-97.89,327.94
3554,95309911,2023-02-09,363.8,691.74
3555,95309911,2023-02-12,109.26,801.0
2862,95356167,2023-01-31,0.0,170.2
7736,95356167,2023-02-08,-38.77,131.42999999999998
8338,95356167,2023-02-10,28.58,160.01
8339,95356167,2023-02-12,103.79,263.79999999999995
8340,95356167,2023-02-14,123.85,387.65
2863,95367755,2023-01-31,0.0,926.51
5219,95367755,2023-02-04,-622.4,304.11
7365,95367755,2023-02-07,70.62,374.73
5220,95367755,2023-02-08,-130.71,244.01999999999998
5221,95367755,2023-02-13,-101.66,142.36
7366,95367755,2023-02-13,63.17,205.52999999999997
2864,95390412,2023-01-31,0.0,553.04
1215,95390412,2023-02-01,-149.8,403.23999999999995
1216,95390412,2023-02-02,-52.25,350.98999999999995
3962,95390412,2023-02-03,79.35,430.3399999999999
3963,95390412,2023-02-07,98.57,528.91
1217,95390412,2023-02-09,-1176.8,-647.8900000000001
1218,95390412,2023-02-11,-100.23,-748.1200000000001
2865,95412973,2023-01-31,0.0,892.85
3420,95412973,2023-02-02,-200.43,692.4200000000001
3421,95412973,2023-02-10,-163.93,528.49
3422,95412973,2023-02-13,-33.78,494.71000000000004
2866,95446510,2023-01-31,0.0,581.43
5520,95446510,2023-02-04,-200.42,381.01
5153,95446510,2023-02-04,88.15,469.15999999999997
5154,95446510,2023-02-04,121.95,591.11
5521,95446510,2023-02-06,-45.01,546.1
5522,95446510,2023-02-08,-129.87,416.22999999999996
5523,95446510,2023-02-13,-96.41,319.81999999999994
2867,95452518,2023-01-31,0.0,390.37
6681,95452518,2023-02-06,172.27,562.64
7727,95452518,2023-02-08,-110.07,452.57000000000005
7728,95452518,2023-02-12,-86.17,366.40000000000003
2868,95467370,2023-01-31,0.0,307.45
2721,95467370,2023-02-02,1273.1,1580.55
2722,95467370,2023-02-03,31.0,1611.55
2723,95467370,2023-02-04,50.69,1662.24
6636,95467370,2023-02-05,-20.31,1641.93
6637,95467370,2023-02-06,-124.17,1517.76
6638,95467370,2023-02-09,-73.6,1444.1599999999999
2724,95467370,2023-02-10,162.32,1606.48
2869,95527674,2023-01-31,0.0,688.37
1710,95527674,2023-02-01,164.94,853.31
4396,95527674,2023-02-03,-145.97,707.34
4397,95527674,2023-02-07,-86.51,620.83
4398,95527674,2023-02-09,-102.14,518.69
1711,95527674,2023-02-09,123.88,642.5699999999999
1714,95527674,2023-02-11,106.62,749.19
1712,95527674,2023-02-11,107.57,856.76
1713,95527674,2023-02-11,133.59,990.35
4399,95527674,2023-02-14,-167.84,822.51
2870,95564462,2023-01-31,0.0,643.45
5396,95564462,2023-02-04,165.42,808.87
7107,95564462,2023-02-06,-22.99,785.88
5397,95564462,2023-02-12,78.89,864.77
2871,95600095,2023-01-31,0.0,400.05
7659,95600095,2023-02-07,125.12,525.1700000000001
7660,95600095,2023-02-12,91.81,616.98
8618,95600095,2023-02-13,-125.16,491.82000000000005
2872,95642341,2023-01-31,0.0,695.88
1440,95642341,2023-02-01,546.3,1242.1799999999998
6346,95642341,2023-02-05,-97.45,1144.73
6347,95642341,2023-02-07,-56.49,1088.24
6348,95642341,2023-02-10,-1375.3,-287.06000000000006
1441,95642341,2023-02-12,134.41,-152.6500000000001
1442,95642341,2023-02-13,42.26,-110.3900000000001
1443,95642341,2023-02-13,104.51,-5.8799999999999955
6349,95642341,2023-02-14,-175.48,-181.36
2873,95645055,2023-01-31,0.0,645.58
7240,95645055,2023-02-06,78.61,724.19
7241,95645055,2023-02-10,99.28,823.47
8467,95645055,2023-02-11,-40.71,782.76
7242,95645055,2023-02-11,24.18,806.94
2874,95674888,2023-01-31,0.0,838.92
1056,95674888,2023-02-01,124.86,963.78
7839,95674888,2023-02-08,-19.59,944.1899999999999
7840,95674888,2023-02-13,-49.89,894.3
1058,95674888,2023-02-13,4.66,898.9599999999999
1057,95674888,2023-02-13,77.47,976.43
1059,95674888,2023-02-13,1258.1,2234.5299999999997
1060,95674888,2023-02-14,178.46,2412.99
2875,95710324,2023-01-31,0.0,978.16
2510,95710324,2023-02-02,-82.72,895.4399999999999
2509,95710324,2023-02-02,-30.01,865.43
2511,95710324,2023-02-09,-188.14,677.29
2512,95710324,2023-02-10,-142.13,535.16
8312,95710324,2023-02-10,73.65,608.81
8313,95710324,2023-02-10,1484.2,2093.0099999999998
2876,95723006,2023-01-31,0.0,861.2
5332,95723006,2023-02-04,1084.8,1946.0
6989,95723006,2023-02-06,-83.83,1862.17
6990,95723006,2023-02-09,-96.82,1765.35
5334,95723006,2023-02-10,91.88,1857.23
5333,95723006,2023-02-10,128.96,1986.19
6991,95723006,2023-02-11,-73.66,1912.53
2877,95743658,2023-01-31,0.0,586.9
867,95743658,2023-02-01,58.18,645.0799999999999
2807,95743658,2023-02-02,-86.69,558.39
2808,95743658,2023-02-03,-147.01,411.38
869,95743658,2023-02-07,54.63,466.01
868,95743658,2023-02-07,107.79,573.8
870,95743658,2023-02-07,934.2,1508.0
2809,95743658,2023-02-09,-121.16,1386.8400000000001
2810,95743658,2023-02-09,-96.52,1290.3200000000002
871,95743658,2023-02-11,96.16,1386.48
872,95743658,2023-02-12,27.74,1414.2200000000003
873,95743658,2023-02-13,81.01,1495.23
2878,95759022,2023-01-31,0.0,78.02
617,95759022,2023-02-01,76.39,154.41
3263,95759022,2023-02-02,-28.18,126.22999999999999
618,95759022,2023-02-05,33.85,160.07999999999998
619,95759022,2023-02-06,179.08,339.15999999999997
3264,95759022,2023-02-09,-156.08,183.07999999999998
620,95759022,2023-02-09,484.0,667.0799999999999
2879,95868007,2023-01-31,0.0,974.32
1201,95868007,2023-02-01,-89.15,885.1700000000001
1202,95868007,2023-02-02,-69.41,815.76
1203,95868007,2023-02-03,-267.7,548.0600000000001
1204,95868007,2023-02-05,-134.55,413.5100000000001
1205,95868007,2023-02-06,-95.31,318.20000000000005
1206,95868007,2023-02-06,-92.7,225.5
7082,95868007,2023-02-06,56.08,281.58000000000004
7083,95868007,2023-02-07,79.32,360.9
1207,95868007,2023-02-11,-134.5,226.39999999999998
2880,95898143,2023-01-31,0.0,197.65
6038,95898143,2023-02-05,97.37,295.02
8177,95898143,2023-02-09,-50.63,244.39000000000001
8178,95898143,2023-02-10,-782.2,-537.8100000000001
6039,95898143,2023-02-12,109.9,-427.9100000000001
2881,95993993,2023-01-31,0.0,95.41
4279,95993993,2023-02-03,-1266.7,-1171.29
7361,95993993,2023-02-07,113.79,-1057.5
7362,95993993,2023-02-13,38.7,-1018.8000000000001
7363,95993993,2023-02-14,1137.7,118.9
2882,96050548,2023-01-31,0.0,299.46
5974,96050548,2023-02-04,-72.83,226.63
7787,96050548,2023-02-08,125.91,352.53999999999996
5975,96050548,2023-02-09,-84.55,267.99
7788,96050548,2023-02-09,102.32,370.30999999999995
5976,96050548,2023-02-11,-107.86,262.45
2883,96051784,2023-01-31,0.0,21.7
1705,96051784,2023-02-01,111.89,133.59
6652,96051784,2023-02-05,-1121.5,-987.91
1706,96051784,2023-02-06,99.31,-888.5999999999999
1707,96051784,2023-02-07,77.46,-811.14
6653,96051784,2023-02-13,-141.46,-952.5999999999999
2884,96121732,2023-01-31,0.0,771.81
1391,96121732,2023-02-01,-101.68,670.1299999999999
1433,96121732,2023-02-01,84.68,754.81
1392,96121732,2023-02-04,-81.94,672.8699999999999
1434,96121732,2023-02-04,70.76,743.63
1394,96121732,2023-02-05,-99.15,644.4799999999999
1393,96121732,2023-02-05,-98.3,546.18
1435,96121732,2023-02-05,98.3,644.4799999999999
1436,96121732,2023-02-10,102.74,747.2199999999999
1395,96121732,2023-02-11,-75.16,672.06
1437,96121732,2023-02-11,1669.7,2341.76
1439,96121732,2023-02-13,99.06,2440.8199999999997
1438,96121732,2023-02-13,164.0,2604.8199999999997
1396,96121732,2023-02-14,-164.38,2440.44
2885,96153427,2023-01-31,0.0,24.33
983,96153427,2023-02-01,84.08,108.41
984,96153427,2023-02-03,120.56,228.96999999999997
985,96153427,2023-02-07,85.35,314.32
2886,96197628,2023-01-31,0.0,829.37
5709,96197628,2023-02-04,-104.91,724.46
5710,96197628,2023-02-08,-27.53,696.9300000000001
8646,96197628,2023-02-13,134.97,831.9
2887,96200049,2023-01-31,0.0,959.58
1597,96200049,2023-02-01,61.23,1020.8100000000001
1599,96200049,2023-02-02,28.18,1048.99
1598,96200049,2023-02-02,94.5,1143.49
1600,96200049,2023-02-03,43.6,1187.0900000000001
1601,96200049,2023-02-03,141.04,1328.13
1602,96200049,2023-02-13,23.37,1351.5
2888,96208050,2023-01-31,0.0,171.46
530,96208050,2023-02-01,-139.18,32.28
531,96208050,2023-02-01,-48.99,-16.710000000000008
532,96208050,2023-02-08,-100.19,-116.9
8119,96208050,2023-02-09,99.18,-17.72
533,96208050,2023-02-10,-115.74,-133.46
8120,96208050,2023-02-11,89.22,-44.23999999999998
8121,96208050,2023-02-12,92.93,48.69000000000001
2889,96224831,2023-01-31,0.0,926.76
3159,96224831,2023-02-02,-46.46,880.3
4502,96224831,2023-02-03,107.3,987.6
3160,96224831,2023-02-06,-66.16,921.4399999999999
3161,96224831,2023-02-09,-108.36,813.0799999999999
4503,96224831,2023-02-10,168.64,981.72
4504,96224831,2023-02-11,91.93,1073.65
4505,96224831,2023-02-12,1265.1,2338.75
3162,96224831,2023-02-14,-113.07,2225.68
2890,96227490,2023-01-31,0.0,242.11
6192,96227490,2023-02-05,118.23,360.34000000000003
7610,96227490,2023-02-07,-162.51,197.83000000000004
6193,96227490,2023-02-07,945.2,1143.0300000000002
7611,96227490,2023-02-12,-1291.9,-148.87
7612,96227490,2023-02-13,-48.77,-197.64
7613,96227490,2023-02-14,-76.93,-274.57000000000005
2891,96236719,2023-01-31,0.0,999.32
2631,96236719,2023-02-02,1015.8,2015.12
4423,96236719,2023-02-03,-177.67,1837.45
2632,96236719,2023-02-09,55.83,1893.28
2633,96236719,2023-02-13,1370.1,3263.38
2892,96278865,2023-01-31,0.0,930.45
7011,96278865,2023-02-06,100.71,1031.16
7012,96278865,2023-02-06,1069.0,2100.16
7556,96278865,2023-02-07,-1298.9,801.26
7013,96278865,2023-02-07,69.22,870.48
7014,96278865,2023-02-09,37.9,908.38
2893,96281358,2023-01-31,0.0,463.07
6940,96281358,2023-02-06,49.54,512.61
6941,96281358,2023-02-08,163.93,676.54
8468,96281358,2023-02-11,-56.16,620.38
2894,96291927,2023-01-31,0.0,227.22
550,96291927,2023-02-01,79.4,306.62
4830,96291927,2023-02-03,-84.7,221.92000000000002
4831,96291927,2023-02-07,-146.76,75.16
4833,96291927,2023-02-09,-123.88,-48.72
4832,96291927,2023-02-09,-99.44,-148.16
551,96291927,2023-02-12,148.17,0.009999999999990905
552,96291927,2023-02-14,38.4,38.41
2895,96319450,2023-01-31,0.0,779.16
1109,96319450,2023-02-01,186.45,965.6099999999999
1110,96319450,2023-02-09,16.12,981.73
8275,96319450,2023-02-10,-38.95,942.78
8276,96319450,2023-02-11,-207.88,734.9
1111,96319450,2023-02-13,119.69,854.5899999999999
2896,96367781,2023-01-31,0.0,880.44
2897,96367914,2023-01-31,0.0,528.67
7982,96367914,2023-02-09,155.69,684.3599999999999
8533,96367914,2023-02-12,-18.96,665.4
2898,96401230,2023-01-31,0.0,21.44
766,96401230,2023-02-01,1663.4,1684.8400000000001
2469,96401230,2023-02-02,-198.28,1486.5600000000002
2470,96401230,2023-02-03,-85.24,1401.3200000000002
2471,96401230,2023-02-03,-44.59,1356.7300000000002
2472,96401230,2023-02-07,-24.41,1332.3200000000002
2473,96401230,2023-02-08,-797.2,535.1200000000001
767,96401230,2023-02-08,96.33,631.4500000000002
2474,96401230,2023-02-11,-1813.6,-1182.1499999999996
2899,96510893,2023-01-31,0.0,396.83
3235,96510893,2023-02-02,185.26,582.0899999999999
3236,96510893,2023-02-09,74.41,656.5
8422,96510893,2023-02-11,-782.2,-125.7000000000001
8423,96510893,2023-02-14,-108.65,-234.35000000000008
2900,96605778,2023-01-31,0.0,70.72
2004,96605778,2023-02-01,-112.98,-42.260000000000005
2006,96605778,2023-02-02,-158.28,-200.54
2005,96605778,2023-02-02,-116.89,-317.43000000000006
2007,96605778,2023-02-04,-303.4,-620.8299999999999
7953,96605778,2023-02-08,697.8,76.97
2008,96605778,2023-02-09,-226.54,-149.57
7955,96605778,2023-02-09,51.97,-97.6
7954,96605778,2023-02-09,75.39,-22.209999999999994
2901,96649120,2023-01-31,0.0,307.91
5274,96649120,2023-02-04,105.93,413.84000000000003
6133,96649120,2023-02-05,-126.99,286.85
6132,96649120,2023-02-05,-46.34,240.51000000000005
5276,96649120,2023-02-07,79.53,320.04
5275,96649120,2023-02-07,98.77,418.81000000000006
6134,96649120,2023-02-08,-135.91,282.90000000000003
6135,96649120,2023-02-12,-36.33,246.57000000000005
5277,96649120,2023-02-13,53.33,299.90000000000003
2902,96689242,2023-01-31,0.0,896.22
1087,96689242,2023-02-01,45.7,941.9200000000001
1088,96689242,2023-02-03,85.62,1027.54
1089,96689242,2023-02-05,142.12,1169.66
7098,96689242,2023-02-06,-1253.1,-83.43999999999983
1090,96689242,2023-02-11,82.15,-1.28999999999985
2903,96719450,2023-01-31,0.0,633.74
7220,96719450,2023-02-07,-744.0,-110.25999999999999
7221,96719450,2023-02-08,-104.01,-214.26999999999998
7918,96719450,2023-02-08,118.94,-95.33000000000004
7919,96719450,2023-02-10,82.33,-13.0
7920,96719450,2023-02-10,1362.1,1349.1
7223,96719450,2023-02-11,-754.3,594.8
7224,96719450,2023-02-11,-86.86,507.93999999999994
7222,96719450,2023-02-11,-59.16,448.78
2904,96756719,2023-01-31,0.0,601.68
5377,96756719,2023-02-04,-69.05,532.63
5378,96756719,2023-02-05,-49.84,482.78999999999996
5379,96756719,2023-02-06,-887.9,-405.11
5380,96756719,2023-02-06,-64.62,-469.7299999999999
5381,96756719,2023-02-07,-155.69,-625.42
7656,96756719,2023-02-07,113.6,-511.82000000000005
5382,96756719,2023-02-08,-104.55,-616.37
7657,96756719,2023-02-10,871.2,254.83000000000004
7658,96756719,2023-02-12,61.95,316.78000000000003
5383,96756719,2023-02-13,-154.58,162.20000000000005
2905,96837696,2023-01-31,0.0,889.9
6196,96837696,2023-02-05,-1131.8,-241.89999999999998
6197,96837696,2023-02-07,-164.7,-406.6
7879,96837696,2023-02-08,19.11,-387.4899999999999
6198,96837696,2023-02-11,-173.7,-561.1899999999999
2906,96847078,2023-01-31,0.0,412.48
1323,96847078,2023-02-01,105.94,518.4200000000001
2648,96847078,2023-02-02,-179.67,338.75
2649,96847078,2023-02-08,-24.38,314.37
1324,96847078,2023-02-08,105.67,420.04
2650,96847078,2023-02-10,-118.13,301.91
1325,96847078,2023-02-10,121.67,423.58000000000004
1326,96847078,2023-02-13,20.17,443.75000000000006
2907,96948178,2023-01-31,0.0,217.26
7380,96948178,2023-02-07,-71.18,146.07999999999998
7499,96948178,2023-02-07,86.52,232.59999999999997
7500,96948178,2023-02-08,103.89,336.49
7381,96948178,2023-02-10,-80.58,255.90999999999997
7501,96948178,2023-02-12,134.36,390.27
2908,97010482,2023-01-31,0.0,542.39
1909,97010482,2023-02-01,83.77,626.16
1910,97010482,2023-02-05,103.38,729.54
8214,97010482,2023-02-09,-41.77,687.77
1911,97010482,2023-02-13,78.01,765.78
2909,97036090,2023-01-31,0.0,349.78
4546,97036090,2023-02-03,-161.37,188.40999999999997
5417,97036090,2023-02-04,118.37,306.78
5418,97036090,2023-02-06,86.95,393.72999999999996
5419,97036090,2023-02-09,65.76,459.49
5420,97036090,2023-02-09,951.0,1410.49
2910,97048058,2023-01-31,0.0,977.42
4805,97048058,2023-02-03,96.94,1074.36
4806,97048058,2023-02-03,584.3,1658.6599999999999
7774,97048058,2023-02-08,-77.23,1581.4299999999998
7775,97048058,2023-02-09,-121.34,1460.09
4807,97048058,2023-02-10,103.59,1563.6799999999998
2911,97098684,2023-01-31,0.0,463.91
1920,97098684,2023-02-01,-0.96,462.95000000000005
4739,97098684,2023-02-03,72.77,535.72
4740,97098684,2023-02-04,76.94,612.6600000000001
4741,97098684,2023-02-05,144.38,757.04
1921,97098684,2023-02-07,-68.86,688.1800000000001
4742,97098684,2023-02-08,204.91,893.09
2912,97187999,2023-01-31,0.0,170.66
1652,97187999,2023-02-01,43.65,214.31
4384,97187999,2023-02-03,-94.5,119.81
4385,97187999,2023-02-05,-27.88,91.92999999999999
4386,97187999,2023-02-10,-70.11,21.819999999999993
4387,97187999,2023-02-11,-9.25,12.569999999999993
1653,97187999,2023-02-13,518.3,530.8699999999999
4388,97187999,2023-02-14,-725.0,-194.13000000000008
4389,97187999,2023-02-14,-60.02,-254.15000000000006
2913,97258853,2023-01-31,0.0,348.49
220,97258853,2023-02-01,106.33,454.82
221,97258853,2023-02-02,1157.4,1612.22
222,97258853,2023-02-03,78.66,1690.88
6876,97258853,2023-02-06,-833.9,856.98
223,97258853,2023-02-06,1912.9,2769.88
224,97258853,2023-02-11,157.05,2926.9300000000003
6877,97258853,2023-02-12,-81.63,2845.3
6878,97258853,2023-02-14,-47.84,2797.46
2914,97265555,2023-01-31,0.0,73.24
505,97265555,2023-02-01,137.25,210.49
506,97265555,2023-02-03,99.42,309.91
5619,97265555,2023-02-04,-77.66,232.25
5620,97265555,2023-02-09,-159.05,73.19999999999997
5621,97265555,2023-02-13,-158.03,-84.83000000000003
2915,97294152,2023-01-31,0.0,700.06
266,97294152,2023-02-01,3.55,703.6099999999999
267,97294152,2023-02-01,120.93,824.54
265,97294152,2023-02-01,1194.4,2018.94
4142,97294152,2023-02-03,-240.55,1778.39
4143,97294152,2023-02-04,-153.31,1625.08
268,97294152,2023-02-07,162.51,1787.5900000000001
4144,97294152,2023-02-11,-159.09,1628.5
4145,97294152,2023-02-12,-95.61,1532.8899999999999
4146,97294152,2023-02-13,-111.96,1420.93
4147,97294152,2023-02-14,-149.9,1271.03
2916,97305293,2023-01-31,0.0,241.02
4245,97305293,2023-02-03,196.95,437.97
4246,97305293,2023-02-09,145.02,582.99
8233,97305293,2023-02-10,-158.94,424.05
8234,97305293,2023-02-11,-99.56,324.49
8235,97305293,2023-02-14,-65.5,258.99
2917,97328154,2023-01-31,0.0,535.51
4175,97328154,2023-02-03,-90.64,444.87
4176,97328154,2023-02-07,-78.9,365.96999999999997
4177,97328154,2023-02-08,-143.22,222.75
8063,97328154,2023-02-09,135.18,357.93
4178,97328154,2023-02-11,-107.57,250.36
8064,97328154,2023-02-11,55.67,306.03000000000003
2918,97405607,2023-01-31,0.0,981.02
3116,97405607,2023-02-02,93.09,1074.11
3118,97405607,2023-02-06,5.35,1079.46
3117,97405607,2023-02-06,527.4,1606.86
8007,97405607,2023-02-08,-147.08,1459.78
8008,97405607,2023-02-10,-98.32,1361.46
3119,97405607,2023-02-11,56.36,1417.82
8009,97405607,2023-02-12,-139.57,1278.25
3120,97405607,2023-02-12,122.13,1400.38
3121,97405607,2023-02-13,144.57,1544.95
2919,97426293,2023-01-31,0.0,771.74
4873,97426293,2023-02-03,-44.25,727.49
4874,97426293,2023-02-08,-4.84,722.65
4875,97426293,2023-02-10,-28.23,694.4200000000001
4876,97426293,2023-02-11,-116.14,578.28
4877,97426293,2023-02-12,-112.63,465.65
4878,97426293,2023-02-12,-26.9,438.75
4879,97426293,2023-02-14,-79.54,359.21000000000004
2920,97439311,2023-01-31,0.0,196.91
7128,97439311,2023-02-06,-43.59,153.32
6936,97439311,2023-02-06,74.25,227.57
6937,97439311,2023-02-07,218.5,446.07
6938,97439311,2023-02-10,705.9,1151.97
7129,97439311,2023-02-13,-2.0,1149.97
6939,97439311,2023-02-14,136.93,1286.9
2921,97445899,2023-01-31,0.0,195.42
2020,97445899,2023-02-01,-473.7,-278.28
2021,97445899,2023-02-04,-123.12,-401.4
5874,97445899,2023-02-04,94.61,-306.78999999999996
5875,97445899,2023-02-06,42.54,-264.25
2022,97445899,2023-02-08,-687.1,-951.35
2922,97487639,2023-01-31,0.0,403.96
197,97487639,2023-02-01,-119.97,283.99
1621,97487639,2023-02-01,110.45,394.44
1622,97487639,2023-02-02,151.59,546.03
1623,97487639,2023-02-03,48.79,594.8199999999999
1624,97487639,2023-02-08,157.04,751.8599999999999
198,97487639,2023-02-09,-1582.3,-830.44
1625,97487639,2023-02-10,200.96,-629.4799999999998
2923,97501557,2023-01-31,0.0,572.14
5962,97501557,2023-02-05,148.09,720.23
7956,97501557,2023-02-08,-114.12,606.11
7958,97501557,2023-02-10,-87.35,518.76
7957,97501557,2023-02-10,-66.98,451.78
5963,97501557,2023-02-10,41.65,493.42999999999995
5964,97501557,2023-02-10,144.36,637.79
2924,97521278,2023-01-31,0.0,833.78
6997,97521278,2023-02-06,-86.95,746.8299999999999
6998,97521278,2023-02-08,-165.57,581.26
8237,97521278,2023-02-10,121.92,703.1800000000001
6999,97521278,2023-02-13,-66.09,637.0899999999999
7000,97521278,2023-02-14,-120.16,516.9300000000001
2925,97526378,2023-01-31,0.0,540.88
3256,97526378,2023-02-02,-63.42,477.46
3257,97526378,2023-02-03,-769.3,-291.8399999999999
5480,97526378,2023-02-04,200.42,-91.41999999999996
3258,97526378,2023-02-07,-55.28,-146.69999999999993
3259,97526378,2023-02-12,-89.7,-236.39999999999998
2926,97541080,2023-01-31,0.0,677.34
4492,97541080,2023-02-03,102.16,779.5
8414,97541080,2023-02-11,-2361.6,-1582.1
2927,97542348,2023-01-31,0.0,768.87
565,97542348,2023-02-01,77.94,846.81
564,97542348,2023-02-01,97.36,944.1700000000001
566,97542348,2023-02-02,33.06,977.23
567,97542348,2023-02-03,89.38,1066.6100000000001
6677,97542348,2023-02-05,-897.5,169.11
6678,97542348,2023-02-06,-193.06,-23.949999999999932
568,97542348,2023-02-06,114.33,90.38
6679,97542348,2023-02-14,-187.3,-96.91999999999996
2928,97555037,2023-01-31,0.0,405.29
6558,97555037,2023-02-05,141.29,546.58
6559,97555037,2023-02-10,67.07,613.65
8685,97555037,2023-02-14,-77.4,536.25
6560,97555037,2023-02-14,175.06,711.31
2929,97558121,2023-01-31,0.0,699.28
6057,97558121,2023-02-05,135.59,834.87
7949,97558121,2023-02-08,-119.07,715.8
6058,97558121,2023-02-14,53.27,769.0699999999999
6059,97558121,2023-02-14,105.11,874.18
6060,97558121,2023-02-14,132.91,1007.0899999999999
2930,97571696,2023-01-31,0.0,622.92
1964,97571696,2023-02-01,1361.0,1983.92
1965,97571696,2023-02-08,15.71,1999.63
2931,97581232,2023-01-31,0.0,608.89
7419,97581232,2023-02-07,135.32,744.21
7420,97581232,2023-02-09,1166.4,1910.6100000000001
7421,97581232,2023-02-11,134.72,2045.33
8557,97581232,2023-02-12,-146.24,1899.0900000000001
8558,97581232,2023-02-12,-143.91,1755.1799999999998
2932,97624673,2023-01-31,0.0,481.09
7243,97624673,2023-02-07,-92.81,388.28
7910,97624673,2023-02-08,95.08,483.35999999999996
7911,97624673,2023-02-11,130.33,613.69
7912,97624673,2023-02-13,116.67,730.3599999999999
2933,97738591,2023-01-31,0.0,254.4
8167,97738591,2023-02-09,101.26,355.66
8544,97738591,2023-02-12,-88.41,267.25
8168,97738591,2023-02-14,81.15,348.40000000000003
2934,97762952,2023-01-31,0.0,411.87
514,97762952,2023-02-01,-38.91,372.96000000000004
515,97762952,2023-02-02,-15.44,357.52
516,97762952,2023-02-04,-97.94,259.58000000000004
7767,97762952,2023-02-08,128.28,387.86
517,97762952,2023-02-09,-101.53,286.33000000000004
7768,97762952,2023-02-11,471.8,758.13
518,97762952,2023-02-13,-113.3,644.83
2935,97773835,2023-01-31,0.0,165.51
4983,97773835,2023-02-03,-72.44,93.07
4984,97773835,2023-02-09,-134.52,-41.45000000000002
2936,97843608,2023-01-31,0.0,19.05
4757,97843608,2023-02-03,349.6,368.65000000000003
4758,97843608,2023-02-04,111.47,480.12000000000006
4759,97843608,2023-02-06,22.17,502.29
4760,97843608,2023-02-12,104.69,606.98
8634,97843608,2023-02-13,-187.8,419.18
2937,97844854,2023-01-31,0.0,547.15
3171,97844854,2023-02-02,-142.95,404.2
3172,97844854,2023-02-12,-133.45,270.75
3173,97844854,2023-02-14,-91.73,179.01999999999998
2938,97870414,2023-01-31,0.0,818.88
638,97870414,2023-02-01,-913.5,-94.62
639,97870414,2023-02-01,-160.61,-255.23000000000013
640,97870414,2023-02-03,-195.63,-450.86
641,97870414,2023-02-06,-374.5,-825.36
642,97870414,2023-02-07,-164.87,-990.2300000000001
643,97870414,2023-02-12,-81.53,-1071.7600000000002
2939,97913385,2023-01-31,0.0,498.49
425,97913385,2023-02-01,50.55,549.04
424,97913385,2023-02-01,98.26,647.3
426,97913385,2023-02-03,117.86,765.1600000000001
6279,97913385,2023-02-05,-78.62,686.54
6280,97913385,2023-02-08,-362.6,323.94
6281,97913385,2023-02-10,-27.72,296.22
427,97913385,2023-02-10,210.62,506.84000000000003
428,97913385,2023-02-13,74.3,581.14
2940,97935683,2023-01-31,0.0,40.96
6694,97935683,2023-02-06,-152.16,-111.19999999999999
6695,97935683,2023-02-14,-173.88,-285.08
2941,97939041,2023-01-31,0.0,320.97
5301,97939041,2023-02-04,66.17,387.14000000000004
7087,97939041,2023-02-06,-68.88,318.26000000000005
7088,97939041,2023-02-11,-18.39,299.87
5302,97939041,2023-02-11,792.4,1092.27
7089,97939041,2023-02-13,-145.1,947.17
5303,97939041,2023-02-13,80.1,1027.27
2942,97944124,2023-01-31,0.0,258.19
8686,97944124,2023-02-14,-100.16,158.03
2943,97954732,2023-01-31,0.0,506.16
5692,97954732,2023-02-04,-142.88,363.28000000000003
8508,97954732,2023-02-11,116.92,480.20000000000005
8509,97954732,2023-02-14,154.35,634.55
2944,97970258,2023-01-31,0.0,309.14
51,97970258,2023-02-01,-89.15,219.98999999999998
50,97970258,2023-02-01,-35.88,184.10999999999999
52,97970258,2023-02-03,-110.38,73.72999999999999
53,97970258,2023-02-08,-64.87,8.860000000000014
54,97970258,2023-02-11,-72.82,-63.960000000000036
55,97970258,2023-02-12,-94.05,-158.01
56,97970258,2023-02-13,-37.31,-195.32
2945,97983552,2023-01-31,0.0,584.92
1857,97983552,2023-02-01,670.1,1255.02
4854,97983552,2023-02-03,-214.53,1040.49
4855,97983552,2023-02-06,-1912.9,-872.41
4856,97983552,2023-02-10,-819.0,-1691.4099999999999
2946,97985291,2023-01-31,0.0,234.19
2535,97985291,2023-02-02,-53.0,181.19
4949,97985291,2023-02-03,79.51,260.7
4950,97985291,2023-02-05,131.72,392.42
2536,97985291,2023-02-08,-62.88,329.53999999999996
4951,97985291,2023-02-08,187.67,517.21
2537,97985291,2023-02-13,-123.05,394.15999999999997
2947,97988499,2023-01-31,0.0,344.28
1863,97988499,2023-02-01,-97.37,246.90999999999997
6371,97988499,2023-02-05,104.95,351.85999999999996
1864,97988499,2023-02-06,-160.17,191.69
6372,97988499,2023-02-08,1026.8,1218.49
1865,97988499,2023-02-12,-98.15,1120.3400000000001
6373,97988499,2023-02-12,127.05,1247.3899999999999
2948,98043237,2023-01-31,0.0,491.59
2745,98043237,2023-02-02,-99.34,392.25
2747,98043237,2023-02-08,-473.2,-80.94999999999999
2746,98043237,2023-02-08,-154.2,-235.15000000000003
2748,98043237,2023-02-13,-75.02,-310.17
8614,98043237,2023-02-13,78.91,-231.26000000000005
2949,98070849,2023-01-31,0.0,993.94
1213,98070849,2023-02-01,-106.8,887.1400000000001
1034,98070849,2023-02-01,54.98,942.12
1032,98070849,2023-02-01,125.14,1067.26
1033,98070849,2023-02-01,140.27,1207.5300000000002
1035,98070849,2023-02-04,132.93,1340.46
1214,98070849,2023-02-08,-110.55,1229.91
1036,98070849,2023-02-08,442.3,1672.21
1037,98070849,2023-02-11,68.2,1740.41
1038,98070849,2023-02-11,96.9,1837.31
1039,98070849,2023-02-14,120.46,1957.77
2950,98107200,2023-01-31,0.0,325.82
3172,98107200,2023-02-02,140.34,466.15999999999997
4179,98107200,2023-02-03,-66.9,399.26
4180,98107200,2023-02-03,-9.03,390.23
3173,98107200,2023-02-10,55.17,445.4
2951,98112233,2023-01-31,0.0,123.26
74,98112233,2023-02-01,-54.5,68.76
75,98112233,2023-02-04,-129.37,-60.61
5157,98112233,2023-02-04,74.95,14.340000000000003
5156,98112233,2023-02-04,111.88,126.22
5155,98112233,2023-02-04,163.03,289.25
76,98112233,2023-02-05,-44.78,244.46999999999997
5158,98112233,2023-02-05,146.29,390.76
77,98112233,2023-02-06,-739.3,-348.53999999999996
5159,98112233,2023-02-06,75.16,-273.38
78,98112233,2023-02-13,-101.49,-374.86999999999995
5161,98112233,2023-02-13,113.41,-261.46
5160,98112233,2023-02-13,114.36,-147.09999999999997
2952,98119030,2023-01-31,0.0,179.3
5135,98119030,2023-02-04,48.63,227.93
5134,98119030,2023-02-04,75.25,303.18
5136,98119030,2023-02-07,89.15,392.33000000000004
8660,98119030,2023-02-14,-81.37,310.96000000000004
2953,98138904,2023-01-31,0.0,885.18
7863,98138904,2023-02-08,-40.97,844.2099999999999
8266,98138904,2023-02-10,46.29,890.5
7864,98138904,2023-02-13,-126.07,764.43
7865,98138904,2023-02-14,-118.69,645.74
2954,98156945,2023-01-31,0.0,449.81
2354,98156945,2023-02-02,45.22,495.03
2355,98156945,2023-02-06,711.2,1206.23
7476,98156945,2023-02-07,-1567.0,-360.7699999999999
2356,98156945,2023-02-08,150.5,-210.26999999999992
2357,98156945,2023-02-12,44.88,-165.38999999999993
2358,98156945,2023-02-14,60.92,-104.46999999999997
2955,98159348,2023-01-31,0.0,703.62
2287,98159348,2023-02-02,-61.45,642.17
2288,98159348,2023-02-04,-503.6,138.56999999999994
8291,98159348,2023-02-10,128.06,266.63
8292,98159348,2023-02-11,63.01,329.64
8293,98159348,2023-02-14,92.59,422.23
2956,98221133,2023-01-31,0.0,596.52
1243,98221133,2023-02-01,97.92,694.4399999999999
4512,98221133,2023-02-03,-55.63,638.81
1244,98221133,2023-02-05,111.54,750.35
4513,98221133,2023-02-06,-28.71,721.64
1245,98221133,2023-02-06,33.32,754.96
1246,98221133,2023-02-08,1002.0,1756.96
4514,98221133,2023-02-09,-132.75,1624.21
1247,98221133,2023-02-09,89.48,1713.69
4515,98221133,2023-02-11,-557.0,1156.69
4516,98221133,2023-02-12,-62.63,1094.06
1248,98221133,2023-02-12,37.35,1131.41
1249,98221133,2023-02-14,40.73,1172.14
2957,98237008,2023-01-31,0.0,437.26
2987,98237008,2023-02-02,865.4,1302.6599999999999
2988,98237008,2023-02-04,61.06,1363.72
2989,98237008,2023-02-05,72.53,1436.25
2990,98237008,2023-02-08,61.29,1497.54
8182,98237008,2023-02-09,-1038.5,459.03999999999996
2991,98237008,2023-02-12,93.16,552.1999999999999
8183,98237008,2023-02-13,-162.05,390.15
2992,98237008,2023-02-13,199.57,589.7199999999999
2958,98336782,2023-01-31,0.0,266.46
7084,98336782,2023-02-06,-95.71,170.75
7085,98336782,2023-02-06,-34.2,136.54999999999998
7086,98336782,2023-02-08,-106.87,29.67999999999998
8432,98336782,2023-02-11,128.1,157.77999999999997
8433,98336782,2023-02-13,55.26,213.03999999999996
2959,98353764,2023-01-31,0.0,763.6
3910,98353764,2023-02-03,-179.54,584.0600000000001
3911,98353764,2023-02-04,-85.2,498.86
8643,98353764,2023-02-13,80.09,578.95
2960,98372749,2023-01-31,0.0,136.21
1111,98372749,2023-02-01,-45.11,91.10000000000001
467,98372749,2023-02-01,130.44,221.54000000000002
1112,98372749,2023-02-07,-101.79,119.75
1113,98372749,2023-02-09,-75.46,44.290000000000006
468,98372749,2023-02-10,72.61,116.9
1114,98372749,2023-02-12,-44.97,71.93
2961,98377332,2023-01-31,0.0,343.09
4231,98377332,2023-02-03,127.44,470.53
4232,98377332,2023-02-08,1779.2,2249.73
8687,98377332,2023-02-14,-132.91,2116.82
2962,98459176,2023-01-31,0.0,168.19
780,98459176,2023-02-01,-229.8,-61.610000000000014
781,98459176,2023-02-03,-88.58,-150.19
782,98459176,2023-02-03,-87.44,-237.63
783,98459176,2023-02-05,-135.88,-373.51000000000005
6981,98459176,2023-02-06,82.75,-290.76
784,98459176,2023-02-07,-737.4,-1028.1599999999999
785,98459176,2023-02-12,-155.17,-1183.33
786,98459176,2023-02-13,-63.98,-1247.31
2963,98517701,2023-01-31,0.0,277.91
7651,98517701,2023-02-07,54.52,332.43
8151,98517701,2023-02-09,-151.14,181.29000000000005
2964,98568929,2023-01-31,0.0,396.03
5803,98568929,2023-02-04,157.68,553.71
5804,98568929,2023-02-05,139.75,693.46
8083,98568929,2023-02-09,-83.47,609.99
5805,98568929,2023-02-13,1121.3,1731.29
8084,98568929,2023-02-14,-119.48,1611.81
2965,98575383,2023-01-31,0.0,937.72
980,98575383,2023-02-01,-152.59,785.13
981,98575383,2023-02-03,-10.53,774.6
982,98575383,2023-02-08,-87.34,687.26
983,98575383,2023-02-09,-24.12,663.1400000000001
984,98575383,2023-02-11,-99.42,563.72
986,98575383,2023-02-11,-83.01,480.71000000000004
985,98575383,2023-02-11,-33.32,447.39
987,98575383,2023-02-13,-144.57,302.82000000000005
988,98575383,2023-02-13,-139.76,163.06000000000006
2966,98596312,2023-01-31,0.0,768.92
4284,98596312,2023-02-03,-174.31,594.6099999999999
4285,98596312,2023-02-06,-158.11,436.49999999999994
4286,98596312,2023-02-07,-120.62,315.87999999999994
4287,98596312,2023-02-09,-33.68,282.19999999999993
8161,98596312,2023-02-09,88.39,370.5899999999999
2967,98611122,2023-01-31,0.0,595.22
1243,98611122,2023-02-01,-84.44,510.78000000000003
459,98611122,2023-02-01,12.21,522.99
460,98611122,2023-02-03,913.8,1436.79
461,98611122,2023-02-06,76.04,1512.83
1244,98611122,2023-02-07,-123.36,1389.47
1245,98611122,2023-02-09,-57.19,1332.28
462,98611122,2023-02-09,126.2,1458.48
1246,98611122,2023-02-13,-170.79,1287.69
463,98611122,2023-02-13,118.5,1406.19
1247,98611122,2023-02-14,-103.89,1302.3
2968,98620342,2023-01-31,0.0,976.13
6488,98620342,2023-02-05,1533.5,2509.63
6489,98620342,2023-02-10,39.48,2549.11
6491,98620342,2023-02-12,91.93,2641.04
6490,98620342,2023-02-12,1006.5,3647.54
6492,98620342,2023-02-14,152.69,3800.23
2969,98671410,2023-01-31,0.0,218.46
83,98671410,2023-02-01,-83.63,134.83
84,98671410,2023-02-01,-45.64,89.19000000000003
2635,98671410,2023-02-02,95.44,184.63
2634,98671410,2023-02-02,198.45,383.08000000000004
2636,98671410,2023-02-03,1016.9,1399.98
2637,98671410,2023-02-05,90.06,1490.04
85,98671410,2023-02-06,-32.37,1457.67
86,98671410,2023-02-13,-73.86,1383.81
2970,98717357,2023-01-31,0.0,183.63
4599,98717357,2023-02-03,-151.73,31.900000000000006
4600,98717357,2023-02-04,-1369.6,-1337.6999999999998
4602,98717357,2023-02-06,-104.0,-1441.6999999999998
4601,98717357,2023-02-06,-51.75,-1493.4499999999998
2971,98776498,2023-01-31,0.0,79.4
2972,98821521,2023-01-31,0.0,906.51
6,98821521,2023-02-01,-54.71,851.8
7,98821521,2023-02-02,-87.06,764.74
7527,98821521,2023-02-07,84.76,849.5
8,98821521,2023-02-08,-88.56,760.94
9,98821521,2023-02-13,-152.6,608.3399999999999
7528,98821521,2023-02-13,139.98,748.3199999999999
2973,98849007,2023-01-31,0.0,58.26
120,98849007,2023-02-01,4.45,62.71
121,98849007,2023-02-11,103.41,166.12
122,98849007,2023-02-12,183.53,349.65
2974,98882065,2023-01-31,0.0,630.68
861,98882065,2023-02-01,-75.85,554.8299999999999
661,98882065,2023-02-01,92.81,647.64
862,98882065,2023-02-06,-1065.6,-417.9599999999999
863,98882065,2023-02-07,-125.12,-543.0799999999998
662,98882065,2023-02-07,84.81,-458.26999999999987
663,98882065,2023-02-09,56.29,-401.9799999999999
864,98882065,2023-02-11,-45.84,-447.8199999999998
2975,98882225,2023-01-31,0.0,881.65
6052,98882225,2023-02-05,-1712.2,-830.5500000000001
6537,98882225,2023-02-05,153.59,-676.9600000000002
6538,98882225,2023-02-11,259.39,-417.57000000000005
6539,98882225,2023-02-13,56.85,-360.72000000000014
2976,98886699,2023-01-31,0.0,300.31
439,98886699,2023-02-01,152.86,453.17
5258,98886699,2023-02-04,-44.06,409.11
440,98886699,2023-02-04,80.75,489.86
5259,98886699,2023-02-10,-1124.9,-635.0400000000002
441,98886699,2023-02-11,32.04,-603.0000000000002
442,98886699,2023-02-12,180.44,-422.5600000000001
2977,98931016,2023-01-31,0.0,561.33
2715,98931016,2023-02-02,-755.3,-193.9699999999999
2537,98931016,2023-02-02,69.41,-124.55999999999995
2538,98931016,2023-02-02,89.8,-34.75999999999988
2539,98931016,2023-02-10,96.34,61.5800000000001
2540,98931016,2023-02-14,349.1,410.6800000000001
2978,98940578,2023-01-31,0.0,59.28
7037,98940578,2023-02-06,-94.25,-34.97
6957,98940578,2023-02-06,1032.3,997.3299999999999
6958,98940578,2023-02-07,99.74,1097.07
7038,98940578,2023-02-08,-44.49,1052.58
2979,99000939,2023-01-31,0.0,155.29
5283,99000939,2023-02-04,-58.31,96.97999999999999
5284,99000939,2023-02-06,-138.14,-41.16
5286,99000939,2023-02-07,-92.7,-133.85999999999999
5285,99000939,2023-02-07,-11.35,-145.21
5287,99000939,2023-02-09,-84.51,-229.72
2980,99015119,2023-01-31,0.0,443.55
3743,99015119,2023-02-03,-112.46,331.09000000000003
5020,99015119,2023-02-03,565.2,896.2900000000001
5021,99015119,2023-02-05,49.2,945.49
3744,99015119,2023-02-06,-76.0,869.49
5022,99015119,2023-02-09,147.12,1016.6100000000001
3745,99015119,2023-02-11,-125.31,891.3000000000001
3746,99015119,2023-02-12,-18.99,872.3100000000001
2981,99244906,2023-01-31,0.0,965.33
888,99244906,2023-02-01,-88.65,876.6800000000001
2177,99244906,2023-02-02,51.28,927.96
889,99244906,2023-02-04,-105.17,822.79
890,99244906,2023-02-08,-133.74,689.05
891,99244906,2023-02-10,-50.52,638.53
892,99244906,2023-02-13,-72.94,565.59
2982,99261094,2023-01-31,0.0,475.8
893,99261094,2023-02-01,-119.5,356.3
5757,99261094,2023-02-04,85.2,441.5
5758,99261094,2023-02-06,646.5,1088.0
894,99261094,2023-02-10,-25.17,1062.8300000000002
5760,99261094,2023-02-12,38.33,1101.16
5759,99261094,2023-02-12,209.98,1311.14
895,99261094,2023-02-14,-111.83,1199.31
896,99261094,2023-02-14,-98.11,1101.2
2983,99296816,2023-01-31,0.0,814.56
1678,99296816,2023-02-01,-246.14,568.42
1679,99296816,2023-02-02,-634.2,-65.78000000000009
1680,99296816,2023-02-05,-76.31,-142.09000000000015
1681,99296816,2023-02-06,-77.23,-219.32000000000016
7120,99296816,2023-02-06,56.09,-163.23000000000013
7121,99296816,2023-02-08,66.6,-96.63000000000011
7122,99296816,2023-02-10,178.01,81.37999999999988
1682,99296816,2023-02-14,-83.33,-1.9500000000001592
2984,99481977,2023-01-31,0.0,940.06
1137,99481977,2023-02-01,114.04,1054.1
1138,99481977,2023-02-02,1695.5,2749.6
7319,99481977,2023-02-07,-1808.5,941.0999999999999
7320,99481977,2023-02-07,-43.31,897.79
7321,99481977,2023-02-09,-89.48,808.31
7322,99481977,2023-02-13,-129.28,679.03
7323,99481977,2023-02-14,-40.82,638.2099999999999
2985,99496896,2023-01-31,0.0,431.32
7725,99496896,2023-02-08,65.82,497.14
2986,99514298,2023-01-31,0.0,154.78
1176,99514298,2023-02-01,-73.14,81.64
3594,99514298,2023-02-02,111.58,193.22
1177,99514298,2023-02-04,-62.25,130.97
1178,99514298,2023-02-05,-81.05,49.92
1179,99514298,2023-02-06,-75.9,-25.97999999999999
1180,99514298,2023-02-07,-104.21,-130.19000000000003
3595,99514298,2023-02-07,1121.9,991.71
1181,99514298,2023-02-10,-147.51,844.2
1182,99514298,2023-02-12,-148.17,696.0300000000001
1183,99514298,2023-02-14,-558.8,137.23000000000016
2987,99553778,2023-01-31,0.0,621.65
5939,99553778,2023-02-04,-141.33,480.31999999999994
5073,99553778,2023-02-04,104.91,585.23
5072,99553778,2023-02-04,163.96,749.1899999999999
5071,99553778,2023-02-04,180.29,929.48
5940,99553778,2023-02-05,-974.8,-45.32000000000005
5074,99553778,2023-02-10,97.9,52.57999999999993
5941,99553778,2023-02-12,-63.69,-11.110000000000014
5942,99553778,2023-02-13,-47.54,-58.65000000000009
5943,99553778,2023-02-14,-76.31,-134.96000000000004
2988,99611232,2023-01-31,0.0,849.72
1505,99611232,2023-02-01,-119.74,729.98
1506,99611232,2023-02-04,-117.6,612.3800000000001
7211,99611232,2023-02-06,69.84,682.22
1507,99611232,2023-02-09,-161.19,521.03
1508,99611232,2023-02-10,-38.38,482.65000000000003
7212,99611232,2023-02-14,49.55,532.2
2989,99657974,2023-01-31,0.0,263.32
1163,99657974,2023-02-01,-114.47,148.85
1164,99657974,2023-02-03,-157.43,-8.579999999999984
6856,99657974,2023-02-06,1.58,-7.0
6857,99657974,2023-02-08,160.99,153.99
6858,99657974,2023-02-09,82.14,236.13
6859,99657974,2023-02-10,57.04,293.17
6860,99657974,2023-02-14,134.42,427.59000000000003
2990,99678854,2023-01-31,0.0,664.0
6924,99678854,2023-02-06,128.13,792.13
6926,99678854,2023-02-07,76.35,868.48
6925,99678854,2023-02-07,199.41,1067.8899999999999
6927,99678854,2023-02-14,111.15,1179.04
2991,99685765,2023-01-31,0.0,43.01
2938,99685765,2023-02-02,10.1,53.11
2939,99685765,2023-02-04,91.11,144.22
6916,99685765,2023-02-06,-120.6,23.619999999999997
6917,99685765,2023-02-08,-957.8,-934.18
2940,99685765,2023-02-09,34.17,-900.01
6918,99685765,2023-02-10,-98.69,-998.7
2941,99685765,2023-02-11,1815.0,816.3
2992,99709741,2023-01-31,0.0,98.23
7604,99709741,2023-02-07,12.69,110.92
7605,99709741,2023-02-09,73.82,184.74
8593,99709741,2023-02-13,-138.4,46.33999999999999
2993,99729369,2023-01-31,0.0,751.01
254,99729369,2023-02-01,-1194.4,-443.3900000000001
3589,99729369,2023-02-02,124.21,-319.18000000000006
256,99729369,2023-02-03,-1619.6,-1938.78
255,99729369,2023-02-03,-240.26,-2179.04
3590,99729369,2023-02-04,127.68,-2051.3599999999997
257,99729369,2023-02-06,-89.63,-2140.99
3591,99729369,2023-02-07,138.38,-2002.61
258,99729369,2023-02-10,-144.33,-2146.9399999999996
2994,99730589,2023-01-31,0.0,988.44
4634,99730589,2023-02-03,58.23,1046.67
4635,99730589,2023-02-09,155.34,1202.01
4636,99730589,2023-02-10,62.26,1264.27
2995,99734848,2023-01-31,0.0,354.29
5783,99734848,2023-02-04,503.6,857.8900000000001
8550,99734848,2023-02-12,-1342.4,-484.51000000000005
8551,99734848,2023-02-14,-79.76,-564.27
2996,99760030,2023-01-31,0.0,988.0
2207,99760030,2023-02-02,-1028.8,-40.799999999999955
2753,99760030,2023-02-02,616.7,575.9000000000001
2208,99760030,2023-02-07,-173.55,402.35000000000014
2754,99760030,2023-02-08,80.13,482.4800000000001
2755,99760030,2023-02-11,118.35,600.83
2209,99760030,2023-02-12,-139.76,461.07000000000005
2756,99760030,2023-02-14,140.07,601.1400000000001
2997,99791709,2023-01-31,0.0,15.05
4771,99791709,2023-02-03,-89.38,-74.33
4772,99791709,2023-02-04,-2.86,-77.19
5640,99791709,2023-02-04,142.88,65.69
4773,99791709,2023-02-06,-1359.0,-1293.31
5641,99791709,2023-02-11,78.32,-1214.99
5642,99791709,2023-02-13,800.9,-414.08999999999986
2998,99877007,2023-01-31,0.0,582.0
579,99877007,2023-02-01,-103.16,478.84000000000003
3051,99877007,2023-02-02,189.79,668.63
580,99877007,2023-02-05,-72.33,596.3
3052,99877007,2023-02-07,154.41,750.71
3053,99877007,2023-02-11,84.59,835.3
2999,99937043,2023-01-31,0.0,918.42
282,99937043,2023-02-01,71.22,989.64
3213,99937043,2023-02-02,-142.45,847.1899999999999
3214,99937043,2023-02-03,-52.49,794.6999999999999
283,99937043,2023-02-04,123.12,917.8199999999999
284,99937043,2023-02-05,52.36,970.18
3215,99937043,2023-02-06,-92.42,877.76
3216,99937043,2023-02-09,-122.91,754.8499999999999
3217,99937043,2023-02-11,-125.33,629.52
285,99937043,2023-02-13,75.16,704.68
